FilePath, VideoName, SRate, Start, Stop, Duration
/Volumes/methlab_data/HBN/EEG-ET/NDARAA075AMK/NDARAA075AMK_Video1_Samples_ET.mat, Diary, 60, 2887191440, 3004584578, 117393138
/Volumes/methlab_data/HBN/EEG-ET/NDARAA075AMK/NDARAA075AMK_Video3_Samples_ET.mat, Despicable, 60, 3788400246, 3958945796, 170545550
/Volumes/methlab_data/HBN/EEG-ET/NDARAA117NEJ/NDARAA117NEJ_Video1_Samples_ET.mat, Diary, 60, 3333897971, 3451293101, 117395130
/Volumes/methlab_data/HBN/EEG-ET/NDARAA117NEJ/NDARAA117NEJ_Video3_Samples_ET.mat, Despicable, 60, 4710198376, 4880739124, 170540748
/Volumes/methlab_data/HBN/EEG-ET/NDARAA306NT2/NDARAA306NT2_Video-DM_Samples_ET.mat, Despicable, 60, 3125258026, 3295795728, 170537702
/Volumes/methlab_data/HBN/EEG-ET/NDARAA306NT2/NDARAA306NT2_Video-TP_Samples_ET.mat, Present, 60, 4109283332, 4312549198, 203265866
/Volumes/methlab_data/HBN/EEG-ET/NDARAA306NT2/NDARAA306NT2_Video-WK_Samples_ET.mat, Diary, 60, 2051158961, 2168549059, 117390098
/Volumes/methlab_data/HBN/EEG-ET/NDARAA504CRN/NDARAA504CRN_Video-DM_Samples_ET.mat, Despicable, 60, 7632766873, 7803315437, 170548564
/Volumes/methlab_data/HBN/EEG-ET/NDARAA504CRN/NDARAA504CRN_Video-TP_Samples_ET.mat, Present, 60, 7849789256, 8053051901, 203262645
/Volumes/methlab_data/HBN/EEG-ET/NDARAA948VFH/NDARAA948VFH_Video1_Samples_ET.mat, Diary, 60, 4234816662, 4352208604, 117391942
/Volumes/methlab_data/HBN/EEG-ET/NDARAA948VFH/NDARAA948VFH_Video3_Samples_ET.mat, Despicable, 60, 3774081250, 3944634792, 170553542
/Volumes/methlab_data/HBN/EEG-ET/NDARAB055BPR/NDARAB055BPR_Video1_Samples_ET.mat, Diary, 60, 3615751077, 3733147104, 117396027
/Volumes/methlab_data/HBN/EEG-ET/NDARAB055BPR/NDARAB055BPR_Video2_Samples_ET.mat, Fractals, 60, 2629793004, 2792782279, 162989275
/Volumes/methlab_data/HBN/EEG-ET/NDARAB055BPR/NDARAB055BPR_Video3_Samples_ET.mat, Despicable, 60, 3171254828, 3341804416, 170549588
/Volumes/methlab_data/HBN/EEG-ET/NDARAB055BPR/NDARAB055BPR_Video4_Samples_ET.mat, Present, 60, 4041751266, 4244819867, 203068601
/Volumes/methlab_data/HBN/EEG-ET/NDARAB348EWR/NDARAB348EWR_Video1_Samples_ET.mat, Diary, 60, 5274403519, 5391797545, 117394026
/Volumes/methlab_data/HBN/EEG-ET/NDARAB348EWR/NDARAB348EWR_Video2_Samples_ET.mat, Fractals, 60, 3975368126, 4138360410, 162992284
/Volumes/methlab_data/HBN/EEG-ET/NDARAB348EWR/NDARAB348EWR_Video3_Samples_ET.mat, Despicable, 60, 4839487053, 5010030644, 170543591
/Volumes/methlab_data/HBN/EEG-ET/NDARAB348EWR/NDARAB348EWR_Video4_Samples_ET.mat, Present, 60, 5696546985, 5899611586, 203064601
/Volumes/methlab_data/HBN/EEG-ET/NDARAB514MAJ/NDARAB514MAJ_Video-DM_Samples_ET.mat, Despicable, 60, 1083908948, 1083911918, 2970
/Volumes/methlab_data/HBN/EEG-ET/NDARAB514MAJ/NDARAB514MAJ_Video-TP_Samples_ET.mat, Present, 60, 1897477649, 2100758138, 203280489
/Volumes/methlab_data/HBN/EEG-ET/NDARAB514MAJ/NDARAB514MAJ_Video-WK_Samples_ET.mat, Diary, 60, 1445327775, 1445333787, 6012
/Volumes/methlab_data/HBN/EEG-ET/NDARAB793GL3/NDARAB793GL3_Video1_Samples_ET.mat, Diary, 120, 4807476118, 4924874667, 117398549
/Volumes/methlab_data/HBN/EEG-ET/NDARAB793GL3/NDARAB793GL3_Video2_Samples_ET.mat, Despicable, 120, 6286446471, 6456993355, 170546884
/Volumes/methlab_data/HBN/EEG-ET/NDARAB793GL3/NDARAB793GL3_Video3_Samples_ET.mat, Fractals, 120, 6823651662, 6986649270, 162997608
/Volumes/methlab_data/HBN/EEG-ET/NDARAB793GL3/NDARAB793GL3_Video4_Samples_ET.mat, Present, 120, 7461847648, 7664915249, 203067601
/Volumes/methlab_data/HBN/EEG-ET/NDARAB977GFB/NDARAB977GFB_Video-DM_Samples_ET.mat, Despicable, 60, 2897793358, 3068335902, 170542544
/Volumes/methlab_data/HBN/EEG-ET/NDARAB977GFB/NDARAB977GFB_Video-FF_Samples_ET.mat, Fractals, 60, 3338345675, 3501330881, 162985206
/Volumes/methlab_data/HBN/EEG-ET/NDARAB977GFB/NDARAB977GFB_Video-TP_Samples_ET.mat, Present, 60, 4015816404, 4218874919, 203058515
/Volumes/methlab_data/HBN/EEG-ET/NDARAB977GFB/NDARAB977GFB_Video-WK_Samples_ET.mat, Diary, 60, 2338892411, 2456285415, 117393004
/Volumes/methlab_data/HBN/EEG-ET/NDARAC349YUC/NDARAC349YUC_Video1_Samples_ET.mat, Diary, 60, 3469151139, 3586549174, 117398035
/Volumes/methlab_data/HBN/EEG-ET/NDARAC349YUC/NDARAC349YUC_Video3_Samples_ET.mat, Despicable, 60, 2979477944, 3150027537, 170549593
/Volumes/methlab_data/HBN/EEG-ET/NDARAC349YUC/NDARAC349YUC_Video4_Samples_ET.mat, Present, 60, 3885557553, 4088624152, 203066599
/Volumes/methlab_data/HBN/EEG-ET/NDARAC350BZ0/NDARAC350BZ0_Video1_Samples_ET.mat, Diary, 60, 3327190655, 3444574633, 117383978
/Volumes/methlab_data/HBN/EEG-ET/NDARAC350BZ0/NDARAC350BZ0_Video2_Samples_ET.mat, Fractals, 60, 2140761708, 2303754833, 162993125
/Volumes/methlab_data/HBN/EEG-ET/NDARAC350BZ0/NDARAC350BZ0_Video3_Samples_ET.mat, Despicable, 60, 2855799719, 3026339210, 170539491
/Volumes/methlab_data/HBN/EEG-ET/NDARAC350BZ0/NDARAC350BZ0_Video4_Samples_ET.mat, Present, 60, 3762508124, 3965566570, 203058446
/Volumes/methlab_data/HBN/EEG-ET/NDARAC350XUM/NDARAC350XUM_Video1_Samples_ET.mat, Diary, 120, 8629710926, 8747107946, 117397020
/Volumes/methlab_data/HBN/EEG-ET/NDARAC350XUM/NDARAC350XUM_Video2_Samples_ET.mat, Fractals, 120, 9278616276, 9441603319, 162987043
/Volumes/methlab_data/HBN/EEG-ET/NDARAC350XUM/NDARAC350XUM_Video3_Samples_ET.mat, Despicable, 120, 9700604108, 9871151283, 170547175
/Volumes/methlab_data/HBN/EEG-ET/NDARAC350XUM/NDARAC350XUM_Video4_Samples_ET.mat, Present, 120, 10393569750, 10596637487, 203067737
/Volumes/methlab_data/HBN/EEG-ET/NDARAC462DZH/NDARAC462DZH_Video-DM_Samples_ET.mat, Despicable, 60, 3060692640, 3231242265, 170549625
/Volumes/methlab_data/HBN/EEG-ET/NDARAC462DZH/NDARAC462DZH_Video-FF_Samples_ET.mat, Fractals, 60, 2631128836, 2794119129, 162990293
/Volumes/methlab_data/HBN/EEG-ET/NDARAC462DZH/NDARAC462DZH_Video-TP_Samples_ET.mat, Present, 60, 3558176487, 3761234133, 203057646
/Volumes/methlab_data/HBN/EEG-ET/NDARAC462DZH/NDARAC462DZH_Video-WK_Samples_ET.mat, Diary, 60, 1738025153, 1855416171, 117391018
/Volumes/methlab_data/HBN/EEG-ET/NDARAC589YMB/NDARAC589YMB_Video-DM_Samples_ET.mat, Despicable, 30, 5259935148, 5430472617, 170537469
/Volumes/methlab_data/HBN/EEG-ET/NDARAC589YMB/NDARAC589YMB_Video-TP_Samples_ET.mat, Present, 30, 5734721479, 5937989128, 203267649
/Volumes/methlab_data/HBN/EEG-ET/NDARAC589YMB/NDARAC589YMB_Video-WK_Samples_ET.mat, Diary, 30, 4274184923, 4391575863, 117390940
/Volumes/methlab_data/HBN/EEG-ET/NDARAC853CR6/NDARAC853CR6_Video-DM_Samples_ET.mat, Despicable, 30, 4189404425, 4359944000, 170539575
/Volumes/methlab_data/HBN/EEG-ET/NDARAC853CR6/NDARAC853CR6_Video-TP_Samples_ET.mat, Present, 30, 5042639651, 5245904375, 203264724
/Volumes/methlab_data/HBN/EEG-ET/NDARAC853CR6/NDARAC853CR6_Video-WK_Samples_ET.mat, Diary, 30, 4636870773, 4754259789, 117389016
/Volumes/methlab_data/HBN/EEG-ET/NDARAC853DTE/NDARAC853DTE_Video1_Samples_ET.mat, Diary, 60, 3279783839, 3397176815, 117392976
/Volumes/methlab_data/HBN/EEG-ET/NDARAC853DTE/NDARAC853DTE_Video3_Samples_ET.mat, Despicable, 60, 4257777965, 4428321456, 170543491
/Volumes/methlab_data/HBN/EEG-ET/NDARAC857HDB/NDARAC857HDB_Video1_Samples_ET.mat, Diary, 60, 3276726810, 3394121879, 117395069
/Volumes/methlab_data/HBN/EEG-ET/NDARAC857HDB/NDARAC857HDB_Video2_Samples_ET.mat, Fractals, 60, 2489366147, 2652357423, 162991276
/Volumes/methlab_data/HBN/EEG-ET/NDARAC857HDB/NDARAC857HDB_Video3_Samples_ET.mat, Despicable, 60, 3806230183, 3976771761, 170541578
/Volumes/methlab_data/HBN/EEG-ET/NDARAC857HDB/NDARAC857HDB_Video4_Samples_ET.mat, Present, 60, 4309803221, 4512873799, 203070578
/Volumes/methlab_data/HBN/EEG-ET/NDARAC904DMU/NDARAC904DMU_Video1_Samples_ET.mat, Diary, 60, 1925540576, 2042932462, 117391886
/Volumes/methlab_data/HBN/EEG-ET/NDARAC904DMU/NDARAC904DMU_Video3_Samples_ET.mat, Despicable, 60, 3088721040, 3259259501, 170538461
/Volumes/methlab_data/HBN/EEG-ET/NDARAD224CRB/NDARAD224CRB_Video1_Samples_ET.mat, Diary, 60, 3990439376, 4107827513, 117388137
/Volumes/methlab_data/HBN/EEG-ET/NDARAD224CRB/NDARAD224CRB_Video2_Samples_ET.mat, Fractals, 60, 2863108248, 3026098650, 162990402
/Volumes/methlab_data/HBN/EEG-ET/NDARAD224CRB/NDARAD224CRB_Video3_Samples_ET.mat, Despicable, 60, 3559163045, 3729711814, 170548769
/Volumes/methlab_data/HBN/EEG-ET/NDARAD224CRB/NDARAD224CRB_Video4_Samples_ET.mat, Present, 60, 4415670438, 4618739248, 203068810
/Volumes/methlab_data/HBN/EEG-ET/NDARAD481FXF/NDARAD481FXF_Video1_Samples_ET.mat, Diary, 60, 2224075023, 2341461996, 117386973
/Volumes/methlab_data/HBN/EEG-ET/NDARAD481FXF/NDARAD481FXF_Video3_Samples_ET.mat, Despicable, 60, 3355492547, 3526045072, 170552525
/Volumes/methlab_data/HBN/EEG-ET/NDARAD571FLB/NDARAD571FLB_Video-DM_Samples_ET.mat, Despicable, 60, 8677865827, 8848408407, 170542580
/Volumes/methlab_data/HBN/EEG-ET/NDARAD571FLB/NDARAD571FLB_Video-FF_Samples_ET.mat, Fractals, 60, 8179380399, 8342364649, 162984250
/Volumes/methlab_data/HBN/EEG-ET/NDARAD571FLB/NDARAD571FLB_Video-TP_Samples_ET.mat, Present, 60, 9250516733, 9453578280, 203061547
/Volumes/methlab_data/HBN/EEG-ET/NDARAD571FLB/NDARAD571FLB_Video-WK_Samples_ET.mat, Diary, 60, 7368443064, 7485835068, 117392004
/Volumes/methlab_data/HBN/EEG-ET/NDARAD615WLJ/NDARAD615WLJ_Video1_Samples_ET.mat, Diary, 60, 1617290115, 1734679124, 117389009
/Volumes/methlab_data/HBN/EEG-ET/NDARAD615WLJ/NDARAD615WLJ_Video2_Samples_ET.mat, Fractals, 60, 2247914975, 2410903211, 162988236
/Volumes/methlab_data/HBN/EEG-ET/NDARAD615WLJ/NDARAD615WLJ_Video3_Samples_ET.mat, Despicable, 60, 2726697449, 2895276677, 168579228
/Volumes/methlab_data/HBN/EEG-ET/NDARAD615WLJ/NDARAD615WLJ_Video4_Samples_ET.mat, Present, 60, 3289030037, 3492179678, 203149641
/Volumes/methlab_data/HBN/EEG-ET/NDARAD703XA2/NDARAD703XA2_Video-WK_Samples_ET.mat, Diary, 60, 5354042498, 5471429561, 117387063
/Volumes/methlab_data/HBN/EEG-ET/NDARAD774HAZ/NDARAD774HAZ_Video1_Samples_ET.mat, Diary, 60, 5043588044, 5160978943, 117390899
/Volumes/methlab_data/HBN/EEG-ET/NDARAD774HAZ/NDARAD774HAZ_Video3_Samples_ET.mat, Despicable, 60, 4592328323, 4762873777, 170545454
/Volumes/methlab_data/HBN/EEG-ET/NDARAE012DGA/NDARAE012DGA_Video1_Samples_ET.mat, Diary, 60, 3098018591, 3215417339, 117398748
/Volumes/methlab_data/HBN/EEG-ET/NDARAE012DGA/NDARAE012DGA_Video3_Samples_ET.mat, Despicable, 60, 2629640574, 2800184202, 170543628
/Volumes/methlab_data/HBN/EEG-ET/NDARAE199TDD/NDARAE199TDD_Video1_Samples_ET.mat, Diary, 60, 2548159347, 2665550477, 117391130
/Volumes/methlab_data/HBN/EEG-ET/NDARAE199TDD/NDARAE199TDD_Video3_Samples_ET.mat, Despicable, 60, 3300384905, 3470925671, 170540766
/Volumes/methlab_data/HBN/EEG-ET/NDARAE301XTM/NDARAE301XTM_Video1_Samples_ET.mat, Diary, 60, 3054792758, 3172187711, 117394953
/Volumes/methlab_data/HBN/EEG-ET/NDARAE301XTM/NDARAE301XTM_Video2_Samples_ET.mat, Fractals, 60, 3694092193, 3857085319, 162993126
/Volumes/methlab_data/HBN/EEG-ET/NDARAE301XTM/NDARAE301XTM_Video3_Samples_ET.mat, Despicable, 60, 4128306820, 4298851322, 170544502
/Volumes/methlab_data/HBN/EEG-ET/NDARAE301XTM/NDARAE301XTM_Video4_Samples_ET.mat, Present, 60, 4625412948, 4828475409, 203062461
/Volumes/methlab_data/HBN/EEG-ET/NDARAE828CML/NDARAE828CML_Video1_Samples_ET.mat, Diary, 60, 4818336548, 4935738342, 117401794
/Volumes/methlab_data/HBN/EEG-ET/NDARAE828CML/NDARAE828CML_Video3_Samples_ET.mat, Despicable, 60, 5199518270, 5370055508, 170537238
/Volumes/methlab_data/HBN/EEG-ET/NDARAE866UVF/NDARAE866UVF_Video-DM_Samples_ET.mat, Despicable, 120, 3812982954, 3983530278, 170547324
/Volumes/methlab_data/HBN/EEG-ET/NDARAE866UVF/NDARAE866UVF_Video-FF_Samples_ET.mat, Fractals, 120, 3279146269, 3442133217, 162986948
/Volumes/methlab_data/HBN/EEG-ET/NDARAE866UVF/NDARAE866UVF_Video-TP_Samples_ET.mat, Present, 120, 4557079204, 4760144961, 203065757
/Volumes/methlab_data/HBN/EEG-ET/NDARAE866UVF/NDARAE866UVF_Video-WK_Samples_ET.mat, Diary, 120, 2573519593, 2690908798, 117389205
/Volumes/methlab_data/HBN/EEG-ET/NDARAEZ493ZJ/NDARAEZ493ZJ_Video1_Samples_ET.mat, Diary, 60, 997025964, 1114417892, 117391928
/Volumes/methlab_data/HBN/EEG-ET/NDARAEZ493ZJ/NDARAEZ493ZJ_Video3_Samples_ET.mat, Despicable, 60, 783215960, 953756428, 170540468
/Volumes/methlab_data/HBN/EEG-ET/NDARAF003VCL/NDARAF003VCL_Video-DM_Samples_ET.mat, Despicable, 60, 5422628627, 5593168208, 170539581
/Volumes/methlab_data/HBN/EEG-ET/NDARAF003VCL/NDARAF003VCL_Video-TP_Samples_ET.mat, Present, 60, 5917605559, 6120881295, 203275736
/Volumes/methlab_data/HBN/EEG-ET/NDARAF003VCL/NDARAF003VCL_Video-WK_Samples_ET.mat, Diary, 60, 3883144198, 4000532237, 117388039
/Volumes/methlab_data/HBN/EEG-ET/NDARAF440XWG/NDARAF440XWG_Video-DM_Samples_ET.mat, Despicable, 120, 2572591505, 2743140293, 170548788
/Volumes/methlab_data/HBN/EEG-ET/NDARAF440XWG/NDARAF440XWG_Video-FF_Samples_ET.mat, Fractals, 120, 2843663969, 3006651201, 162987232
/Volumes/methlab_data/HBN/EEG-ET/NDARAF440XWG/NDARAF440XWG_Video-TP_Samples_ET.mat, Present, 120, 3257506315, 3460580364, 203074049
/Volumes/methlab_data/HBN/EEG-ET/NDARAF440XWG/NDARAF440XWG_Video-WK_Samples_ET.mat, Diary, 120, 3098274415, 3215664264, 117389849
/Volumes/methlab_data/HBN/EEG-ET/NDARAF535XK6/NDARAF535XK6_Video-DM_Samples_ET.mat, Despicable, 120, 3287990840, 3458537250, 170546410
/Volumes/methlab_data/HBN/EEG-ET/NDARAF535XK6/NDARAF535XK6_Video-FF_Samples_ET.mat, Fractals, 120, 3838935968, 4001933752, 162997784
/Volumes/methlab_data/HBN/EEG-ET/NDARAF535XK6/NDARAF535XK6_Video-TP_Samples_ET.mat, Present, 120, 4041974471, 4245038385, 203063914
/Volumes/methlab_data/HBN/EEG-ET/NDARAF535XK6/NDARAF535XK6_Video-WK_Samples_ET.mat, Diary, 120, 3668628917, 3786025919, 117397002
/Volumes/methlab_data/HBN/EEG-ET/NDARAG143ARJ/NDARAG143ARJ_Video1_Samples_ET.mat, Diary, 60, 2514158725, 2631547629, 117388904
/Volumes/methlab_data/HBN/EEG-ET/NDARAG143ARJ/NDARAG143ARJ_Video3_Samples_ET.mat, Despicable, 60, 3850544147, 4021087570, 170543423
/Volumes/methlab_data/HBN/EEG-ET/NDARAG191AE8/NDARAG191AE8_Video-DM_Samples_ET.mat, Despicable, 60, 2882698679, 3053247043, 170548364
/Volumes/methlab_data/HBN/EEG-ET/NDARAG191AE8/NDARAG191AE8_Video-TP_Samples_ET.mat, Present, 60, 3766158020, 3969424460, 203266440
/Volumes/methlab_data/HBN/EEG-ET/NDARAG191AE8/NDARAG191AE8_Video-WK_Samples_ET.mat, Diary, 60, 3350353652, 3467741497, 117387845
/Volumes/methlab_data/HBN/EEG-ET/NDARAG340ERT/NDARAG340ERT_Video1_Samples_ET.mat, Diary, 60, 5442919266, 5560317297, 117398031
/Volumes/methlab_data/HBN/EEG-ET/NDARAG340ERT/NDARAG340ERT_Video3_Samples_ET.mat, Despicable, 60, 4986585509, 5157127212, 170541703
/Volumes/methlab_data/HBN/EEG-ET/NDARAG584XLU/NDARAG584XLU_Video1_Samples_ET.mat, Fractals, 120, 4473380284, 4636366621, 162986337
/Volumes/methlab_data/HBN/EEG-ET/NDARAG584XLU/NDARAG584XLU_Video2_Samples_ET.mat, Despicable, 120, 5282524138, 5453081082, 170556944
/Volumes/methlab_data/HBN/EEG-ET/NDARAG584XLU/NDARAG584XLU_Video3_Samples_ET.mat, Diary, 120, 5761941730, 5879339346, 117397616
/Volumes/methlab_data/HBN/EEG-ET/NDARAG584XLU/NDARAG584XLU_Video4_Samples_ET.mat, Present, 120, 6374597757, 6577659172, 203061415
/Volumes/methlab_data/HBN/EEG-ET/NDARAG610XL4/NDARAG610XL4_Video-DM_Samples_ET.mat, Despicable, 60, 3687356313, 3857906020, 170549707
/Volumes/methlab_data/HBN/EEG-ET/NDARAG610XL4/NDARAG610XL4_Video-WK_Samples_ET.mat, Diary, 60, 4568518897, 4685906950, 117388053
/Volumes/methlab_data/HBN/EEG-ET/NDARAH239PGG/NDARAH239PGG_Video-DM_Samples_ET.mat, Despicable, 30, 2618596734, 2789132429, 170535695
/Volumes/methlab_data/HBN/EEG-ET/NDARAH239PGG/NDARAH239PGG_Video-TP_Samples_ET.mat, Present, 30, 3088312117, 3291578970, 203266853
/Volumes/methlab_data/HBN/EEG-ET/NDARAH239PGG/NDARAH239PGG_Video-WK_Samples_ET.mat, Diary, 30, 1585911981, 1703313081, 117401100
/Volumes/methlab_data/HBN/EEG-ET/NDARAH304ED7/NDARAH304ED7_Video1_Samples_ET.mat, Despicable, 120, 9151692680, 9322239128, 170546448
/Volumes/methlab_data/HBN/EEG-ET/NDARAH304ED7/NDARAH304ED7_Video2_Samples_ET.mat, Diary, 120, 9370310768, 9487707417, 117396649
/Volumes/methlab_data/HBN/EEG-ET/NDARAH304ED7/NDARAH304ED7_Video3_Samples_ET.mat, Fractals, 120, 9539239090, 9702226568, 162987478
/Volumes/methlab_data/HBN/EEG-ET/NDARAH304ED7/NDARAH304ED7_Video4_Samples_ET.mat, Present, 120, 9837367772, 10040434710, 203066938
/Volumes/methlab_data/HBN/EEG-ET/NDARAH503YG1/NDARAH503YG1_Video1_Samples_ET.mat, Diary, 60, 437036459, 554426245, 117389786
/Volumes/methlab_data/HBN/EEG-ET/NDARAH503YG1/NDARAH503YG1_Video4_Samples_ET.mat, Present, 60, 921247051, 1124307362, 203060311
/Volumes/methlab_data/HBN/EEG-ET/NDARAH793FBF/NDARAH793FBF_Video1_Samples_ET.mat, Diary, 120, 3165634177, 3283030490, 117396313
/Volumes/methlab_data/HBN/EEG-ET/NDARAH793FBF/NDARAH793FBF_Video2_Samples_ET.mat, Fractals, 120, 4446650385, 4609635437, 162985052
/Volumes/methlab_data/HBN/EEG-ET/NDARAH793FBF/NDARAH793FBF_Video3_Samples_ET.mat, Despicable, 120, 5028504290, 5199047896, 170543606
/Volumes/methlab_data/HBN/EEG-ET/NDARAH793FBF/NDARAH793FBF_Video4_Samples_ET.mat, Present, 120, 5833711085, 6036775274, 203064189
/Volumes/methlab_data/HBN/EEG-ET/NDARAH948UF0/NDARAH948UF0_Video1_Samples_ET.mat, Diary, 60, 2527312363, 2644701275, 117388912
/Volumes/methlab_data/HBN/EEG-ET/NDARAH948UF0/NDARAH948UF0_Video3_Samples_ET.mat, Despicable, 60, 2309639589, 2480183201, 170543612
/Volumes/methlab_data/HBN/EEG-ET/NDARAH976BND/NDARAH976BND_Video-DM_Samples_ET.mat, Despicable, 60, 4718547159, 4889084654, 170537495
/Volumes/methlab_data/HBN/EEG-ET/NDARAH976BND/NDARAH976BND_Video-TP_Samples_ET.mat, Present, 60, 5222792348, 5426060904, 203268556
/Volumes/methlab_data/HBN/EEG-ET/NDARAH976BND/NDARAH976BND_Video-WK_Samples_ET.mat, Diary, 60, 3556130173, 3673519106, 117388933
/Volumes/methlab_data/HBN/EEG-ET/NDARAJ366ZFA/NDARAJ366ZFA_Video1_Samples_ET.mat, Diary, 60, 4425006372, 4542400381, 117394009
/Volumes/methlab_data/HBN/EEG-ET/NDARAJ366ZFA/NDARAJ366ZFA_Video3_Samples_ET.mat, Despicable, 60, 3951900864, 4122441456, 170540592
/Volumes/methlab_data/HBN/EEG-ET/NDARAJ689BVN/NDARAJ689BVN_Video1_Samples_ET.mat, Diary, 60, 3224747049, 3342136925, 117389876
/Volumes/methlab_data/HBN/EEG-ET/NDARAJ689BVN/NDARAJ689BVN_Video2_Samples_ET.mat, Fractals, 60, 2089751216, 2252739226, 162988010
/Volumes/methlab_data/HBN/EEG-ET/NDARAJ689BVN/NDARAJ689BVN_Video3_Samples_ET.mat, Despicable, 60, 2784434374, 2954985758, 170551384
/Volumes/methlab_data/HBN/EEG-ET/NDARAJ689BVN/NDARAJ689BVN_Video4_Samples_ET.mat, Present, 60, 3658899360, 3861968673, 203069313
/Volumes/methlab_data/HBN/EEG-ET/NDARAJ768CF0/NDARAJ768CF0_Video-DM_Samples_ET.mat, Despicable, 60, 3304356299, 3474901582, 170545283
/Volumes/methlab_data/HBN/EEG-ET/NDARAJ768CF0/NDARAJ768CF0_Video-FF_Samples_ET.mat, Fractals, 60, 2637411977, 2800394915, 162982938
/Volumes/methlab_data/HBN/EEG-ET/NDARAJ768CF0/NDARAJ768CF0_Video-TP_Samples_ET.mat, Present, 60, 3794269801, 3997330020, 203060219
/Volumes/methlab_data/HBN/EEG-ET/NDARAJ768CF0/NDARAJ768CF0_Video-WK_Samples_ET.mat, Diary, 60, 2033925379, 2151321177, 117395798
/Volumes/methlab_data/HBN/EEG-ET/NDARAJ807UYR/NDARAJ807UYR_Video1_Samples_ET.mat, Diary, 60, 2287092097, 2404487124, 117395027
/Volumes/methlab_data/HBN/EEG-ET/NDARAJ807UYR/NDARAJ807UYR_Video3_Samples_ET.mat, Despicable, 60, 3217470098, 3388013745, 170543647
/Volumes/methlab_data/HBN/EEG-ET/NDARAJ977PRJ/NDARAJ977PRJ_Video-DM_Samples_ET.mat, Despicable, 60, 8042459827, 8213000361, 170540534
/Volumes/methlab_data/HBN/EEG-ET/NDARAJ977PRJ/NDARAJ977PRJ_Video-TP_Samples_ET.mat, Present, 60, 9255059711, 9458324376, 203264665
/Volumes/methlab_data/HBN/EEG-ET/NDARAJ977PRJ/NDARAJ977PRJ_Video-WK_Samples_ET.mat, Diary, 60, 7045100077, 7162492036, 117391959
/Volumes/methlab_data/HBN/EEG-ET/NDARAK187ZLP/NDARAK187ZLP_Video3_Samples_ET.mat, Despicable, 60, 4048837090, 4219381650, 170544560
/Volumes/methlab_data/HBN/EEG-ET/NDARAK653RYE/NDARAK653RYE_Video1_Samples_ET.mat, Diary, 120, 3403708171, 3521096342, 117388171
/Volumes/methlab_data/HBN/EEG-ET/NDARAK653RYE/NDARAK653RYE_Video2_Samples_ET.mat, Fractals, 120, 4462470574, 4625468253, 162997679
/Volumes/methlab_data/HBN/EEG-ET/NDARAK653RYE/NDARAK653RYE_Video3_Samples_ET.mat, Despicable, 120, 5024280350, 5194821657, 170541307
/Volumes/methlab_data/HBN/EEG-ET/NDARAK738BGC/NDARAK738BGC_Video1_Samples_ET.mat, Diary, 60, 4575328822, 4692723785, 117394963
/Volumes/methlab_data/HBN/EEG-ET/NDARAK738BGC/NDARAK738BGC_Video2_Samples_ET.mat, Fractals, 60, 3252645643, 3415636794, 162991151
/Volumes/methlab_data/HBN/EEG-ET/NDARAK738BGC/NDARAK738BGC_Video3_Samples_ET.mat, Despicable, 60, 4078928248, 4249469703, 170541455
/Volumes/methlab_data/HBN/EEG-ET/NDARAK738BGC/NDARAK738BGC_Video4_Samples_ET.mat, Present, 60, 5085294002, 5288362442, 203068440
/Volumes/methlab_data/HBN/EEG-ET/NDARAL828WXM/NDARAL828WXM_Video-DM_Samples_ET.mat, Despicable, 120, 4391286982, 4561834603, 170547621
/Volumes/methlab_data/HBN/EEG-ET/NDARAL828WXM/NDARAL828WXM_Video-FF_Samples_ET.mat, Fractals, 120, 2924716962, 3087703978, 162987016
/Volumes/methlab_data/HBN/EEG-ET/NDARAL828WXM/NDARAL828WXM_Video-TP_Samples_ET.mat, Present, 120, 5523101385, 5726167372, 203065987
/Volumes/methlab_data/HBN/EEG-ET/NDARAL828WXM/NDARAL828WXM_Video-WK_Samples_ET.mat, Diary, 120, 4824331228, 4941719165, 117387937
/Volumes/methlab_data/HBN/EEG-ET/NDARAL897CYV/NDARAL897CYV_Video-DM_Samples_ET.mat, Despicable, 30, 5256141606, 5426676887, 170535281
/Volumes/methlab_data/HBN/EEG-ET/NDARAL897CYV/NDARAL897CYV_Video-TP_Samples_ET.mat, Present, 30, 5777605353, 5980884727, 203279374
/Volumes/methlab_data/HBN/EEG-ET/NDARAL897CYV/NDARAL897CYV_Video-WK_Samples_ET.mat, Diary, 30, 4092916273, 4210306090, 117389817
/Volumes/methlab_data/HBN/EEG-ET/NDARAM048AFP/NDARAM048AFP_Video1_Samples_ET.mat, Diary, 120, 3356547377, 3473933698, 117386321
/Volumes/methlab_data/HBN/EEG-ET/NDARAM048AFP/NDARAM048AFP_Video2_Samples_ET.mat, Despicable, 120, 4383647053, 4554204698, 170557645
/Volumes/methlab_data/HBN/EEG-ET/NDARAM048AFP/NDARAM048AFP_Video3_Samples_ET.mat, Fractals, 120, 4874194061, 5037181287, 162987226
/Volumes/methlab_data/HBN/EEG-ET/NDARAM197GFY/NDARAM197GFY_Video-DM_Samples_ET.mat, Despicable, 60, 4913314167, 5083848824, 170534657
/Volumes/methlab_data/HBN/EEG-ET/NDARAM197GFY/NDARAM197GFY_Video-WK_Samples_ET.mat, Diary, 60, 5135070042, 5252457161, 117387119
/Volumes/methlab_data/HBN/EEG-ET/NDARAM357BUA/NDARAM357BUA_Video-DM_Samples_ET.mat, Despicable, 30, 4481401252, 4651945724, 170544472
/Volumes/methlab_data/HBN/EEG-ET/NDARAM357BUA/NDARAM357BUA_Video-TP_Samples_ET.mat, Present, 30, 5652396317, 5855673902, 203277585
/Volumes/methlab_data/HBN/EEG-ET/NDARAM357BUA/NDARAM357BUA_Video-WK_Samples_ET.mat, Diary, 30, 3660520475, 3777908407, 117387932
/Volumes/methlab_data/HBN/EEG-ET/NDARAM487XU3/NDARAM487XU3_Video-DM_Samples_ET.mat, Despicable, 120, 1646579030, 1817130800, 170551770
/Volumes/methlab_data/HBN/EEG-ET/NDARAM487XU3/NDARAM487XU3_Video-FF_Samples_ET.mat, Fractals, 120, 1911857605, 2074845573, 162987968
/Volumes/methlab_data/HBN/EEG-ET/NDARAM487XU3/NDARAM487XU3_Video-TP_Samples_ET.mat, Present, 120, 2793212523, 2996287057, 203074534
/Volumes/methlab_data/HBN/EEG-ET/NDARAM487XU3/NDARAM487XU3_Video-WK_Samples_ET.mat, Diary, 120, 2158665768, 2276063581, 117397813
/Volumes/methlab_data/HBN/EEG-ET/NDARAM675UR8/NDARAM675UR8_Video1_Samples_ET.mat, Diary, 60, 1859254222, 1976647535, 117393313
/Volumes/methlab_data/HBN/EEG-ET/NDARAM675UR8/NDARAM675UR8_Video3_Samples_ET.mat, Despicable, 60, 1167841196, 1338390597, 170549401
/Volumes/methlab_data/HBN/EEG-ET/NDARAM704GKZ/NDARAM704GKZ_Video1_Samples_ET.mat, Diary, 60, 3951779649, 4069174584, 117394935
/Volumes/methlab_data/HBN/EEG-ET/NDARAM704GKZ/NDARAM704GKZ_Video3_Samples_ET.mat, Despicable, 60, 3490644972, 3661198432, 170553460
/Volumes/methlab_data/HBN/EEG-ET/NDARAM848GTE/NDARAM848GTE_Video1_Samples_ET.mat, Diary, 60, 3616492684, 3733886660, 117393976
/Volumes/methlab_data/HBN/EEG-ET/NDARAM848GTE/NDARAM848GTE_Video2_Samples_ET.mat, Fractals, 60, 4233531726, 4396518923, 162987197
/Volumes/methlab_data/HBN/EEG-ET/NDARAM848GTE/NDARAM848GTE_Video3_Samples_ET.mat, Despicable, 60, 4743195879, 4913739411, 170543532
/Volumes/methlab_data/HBN/EEG-ET/NDARAM848GTE/NDARAM848GTE_Video4_Samples_ET.mat, Present, 60, 5259026388, 5462087925, 203061537
/Volumes/methlab_data/HBN/EEG-ET/NDARAM873GAC/NDARAM873GAC_Video1_Samples_ET.mat, Diary, 60, 4428317768, 4545705510, 117387742
/Volumes/methlab_data/HBN/EEG-ET/NDARAM873GAC/NDARAM873GAC_Video3_Samples_ET.mat, Despicable, 60, 4005686963, 4176234178, 170547215
/Volumes/methlab_data/HBN/EEG-ET/NDARAN076TPG/NDARAN076TPG_Video-DM_Samples_ET.mat, Despicable, 120, 4097646722, 4268194144, 170547422
/Volumes/methlab_data/HBN/EEG-ET/NDARAN076TPG/NDARAN076TPG_Video-FF_Samples_ET.mat, Fractals, 120, 3316483039, 3479479132, 162996093
/Volumes/methlab_data/HBN/EEG-ET/NDARAN076TPG/NDARAN076TPG_Video-WK_Samples_ET.mat, Diary, 120, 4577343693, 4694741295, 117397602
/Volumes/methlab_data/HBN/EEG-ET/NDARAN160GUF/NDARAN160GUF_Video-DM_Samples_ET.mat, Despicable, 60, 4243700111, 4414234620, 170534509
/Volumes/methlab_data/HBN/EEG-ET/NDARAN160GUF/NDARAN160GUF_Video-TP_Samples_ET.mat, Present, 60, 5208339773, 5411604431, 203264658
/Volumes/methlab_data/HBN/EEG-ET/NDARAN160GUF/NDARAN160GUF_Video-WK_Samples_ET.mat, Diary, 60, 4751434885, 4868821859, 117386974
/Volumes/methlab_data/HBN/EEG-ET/NDARAN385MDH/NDARAN385MDH_Video1_Samples_ET.mat, Diary, 60, 6562406554, 6679801455, 117394901
/Volumes/methlab_data/HBN/EEG-ET/NDARAN385MDH/NDARAN385MDH_Video3_Samples_ET.mat, Despicable, 60, 6130814908, 6301366317, 170551409
/Volumes/methlab_data/HBN/EEG-ET/NDARAN461TGQ/NDARAN461TGQ_Video1_Samples_ET.mat, Diary, 120, 3998009540, 4115396374, 117386834
/Volumes/methlab_data/HBN/EEG-ET/NDARAN461TGQ/NDARAN461TGQ_Video2_Samples_ET.mat, Despicable, 120, 5149088271, 5319636192, 170547921
/Volumes/methlab_data/HBN/EEG-ET/NDARAN461TGQ/NDARAN461TGQ_Video3_Samples_ET.mat, Fractals, 120, 5724964726, 5887953017, 162988291
/Volumes/methlab_data/HBN/EEG-ET/NDARAN524ZK6/NDARAN524ZK6_Video-DM_Samples_ET.mat, Despicable, 60, 6037721499, 6208270100, 170548601
/Volumes/methlab_data/HBN/EEG-ET/NDARAN524ZK6/NDARAN524ZK6_Video-FF_Samples_ET.mat, Fractals, 60, 5557877265, 5720869577, 162992312
/Volumes/methlab_data/HBN/EEG-ET/NDARAN524ZK6/NDARAN524ZK6_Video-TP_Samples_ET.mat, Present, 60, 6722214437, 6925275024, 203060587
/Volumes/methlab_data/HBN/EEG-ET/NDARAN524ZK6/NDARAN524ZK6_Video-WK_Samples_ET.mat, Diary, 60, 4839713514, 4957110603, 117397089
/Volumes/methlab_data/HBN/EEG-ET/NDARAP049KXJ/NDARAP049KXJ_Video-DM_Samples_ET.mat, Despicable, 30, 4749674209, 4920211322, 170537113
/Volumes/methlab_data/HBN/EEG-ET/NDARAP049KXJ/NDARAP049KXJ_Video-TP_Samples_ET.mat, Present, 30, 5227519488, 5430799844, 203280356
/Volumes/methlab_data/HBN/EEG-ET/NDARAP049KXJ/NDARAP049KXJ_Video-WK_Samples_ET.mat, Diary, 30, 3384192668, 3501586050, 117393382
/Volumes/methlab_data/HBN/EEG-ET/NDARAP176AD1/NDARAP176AD1_Video1_Samples_ET.mat, Diary, 60, 3895824550, 4013222860, 117398310
/Volumes/methlab_data/HBN/EEG-ET/NDARAP176AD1/NDARAP176AD1_Video3_Samples_ET.mat, Despicable, 60, 367325868, 537874821, 170548953
/Volumes/methlab_data/HBN/EEG-ET/NDARAP359UM6/NDARAP359UM6_Video1_Samples_ET.mat, Diary, 60, 3094258580, 3211655618, 117397038
/Volumes/methlab_data/HBN/EEG-ET/NDARAP359UM6/NDARAP359UM6_Video3_Samples_ET.mat, Despicable, 60, 2661341379, 2831884016, 170542637
/Volumes/methlab_data/HBN/EEG-ET/NDARAP457WB5/NDARAP457WB5_Video-DM_Samples_ET.mat, Despicable, 30, 4158015221, 4328562986, 170547765
/Volumes/methlab_data/HBN/EEG-ET/NDARAP457WB5/NDARAP457WB5_Video-TP_Samples_ET.mat, Present, 30, 5126118627, 5329381542, 203262915
/Volumes/methlab_data/HBN/EEG-ET/NDARAP457WB5/NDARAP457WB5_Video-WK_Samples_ET.mat, Diary, 30, 4641987865, 4759377997, 117390132
/Volumes/methlab_data/HBN/EEG-ET/NDARAP522AFK/NDARAP522AFK_Video1_Samples_ET.mat, Diary, 60, 4535215963, 4652610041, 117394078
/Volumes/methlab_data/HBN/EEG-ET/NDARAP522AFK/NDARAP522AFK_Video2_Samples_ET.mat, Fractals, 60, 3559080565, 3722063871, 162983306
/Volumes/methlab_data/HBN/EEG-ET/NDARAP522AFK/NDARAP522AFK_Video3_Samples_ET.mat, Despicable, 60, 4093561606, 4264104243, 170542637
/Volumes/methlab_data/HBN/EEG-ET/NDARAP522AFK/NDARAP522AFK_Video4_Samples_ET.mat, Present, 60, 5039022297, 5242090939, 203068642
/Volumes/methlab_data/HBN/EEG-ET/NDARAP739AUP/NDARAP739AUP_Video-DM_Samples_ET.mat, Despicable, 30, 3805988023, 3976526436, 170538413
/Volumes/methlab_data/HBN/EEG-ET/NDARAP782TVC/NDARAP782TVC_Video1_Samples_ET.mat, Despicable, 120, 2303153653, 2390872282, 2561419422
2.582658e+08, 1.705471e+08, /Volumes/methlab_data/HBN/EEG-ET/NDARAP782TVC/NDARAP782TVC_Video2_Samples_ET.mat, Fractals, 120, 2608780758, 2771767670, 162986912
/Volumes/methlab_data/HBN/EEG-ET/NDARAP782TVC/NDARAP782TVC_Video3_Samples_ET.mat, Diary, 120, 3936693871, 4054090574, 117396703
/Volumes/methlab_data/HBN/EEG-ET/NDARAP782TVC/NDARAP782TVC_Video4_Samples_ET.mat, Present, 120, 4202120308, 4405188223, 203067915
/Volumes/methlab_data/HBN/EEG-ET/NDARAP785CTE/NDARAP785CTE_Video1_Samples_ET.mat, Diary, 60, 9509313487, 9626709508, 117396021
/Volumes/methlab_data/HBN/EEG-ET/NDARAP785CTE/NDARAP785CTE_Video2_Samples_ET.mat, Fractals, 60, 8272925355, 8435909598, 162984243
/Volumes/methlab_data/HBN/EEG-ET/NDARAP785CTE/NDARAP785CTE_Video3_Samples_ET.mat, Despicable, 60, 8985911425, 9156454106, 170542681
/Volumes/methlab_data/HBN/EEG-ET/NDARAP785CTE/NDARAP785CTE_Video4_Samples_ET.mat, Present, 60, 9979290758, 10182351347, 203060589
/Volumes/methlab_data/HBN/EEG-ET/NDARAP912JK3/NDARAP912JK3_Video-DM_Samples_ET.mat, Despicable, 60, 4225930981, 4396474086, 170543105
/Volumes/methlab_data/HBN/EEG-ET/NDARAP912JK3/NDARAP912JK3_Video-FF_Samples_ET.mat, Fractals, 60, 3705673575, 3868659344, 162985769
/Volumes/methlab_data/HBN/EEG-ET/NDARAP912JK3/NDARAP912JK3_Video-TP_Samples_ET.mat, Present, 60, 4750851696, 4953915909, 203064213
/Volumes/methlab_data/HBN/EEG-ET/NDARAP912JK3/NDARAP912JK3_Video-WK_Samples_ET.mat, Diary, 60, 3217451931, 3334843294, 117391363
/Volumes/methlab_data/HBN/EEG-ET/NDARAR238RZ8/NDARAR238RZ8_Video-DM_Samples_ET.mat, Despicable, 120, 8091572227, 8262119731, 170547504
/Volumes/methlab_data/HBN/EEG-ET/NDARAR238RZ8/NDARAR238RZ8_Video-FF_Samples_ET.mat, Fractals, 120, 7443886798, 7606873493, 162986695
/Volumes/methlab_data/HBN/EEG-ET/NDARAR238RZ8/NDARAR238RZ8_Video-TP_Samples_ET.mat, Present, 120, 9111065933, 9314133907, 203067974
/Volumes/methlab_data/HBN/EEG-ET/NDARAR238RZ8/NDARAR238RZ8_Video-WK_Samples_ET.mat, Diary, 120, 8533028973, 8650427431, 117398458
/Volumes/methlab_data/HBN/EEG-ET/NDARAR305LXG/NDARAR305LXG_Video-DM_Samples_ET.mat, Despicable, 60, 4505470367, 4676009714, 170539347
/Volumes/methlab_data/HBN/EEG-ET/NDARAR305LXG/NDARAR305LXG_Video-TP_Samples_ET.mat, Present, 60, 4994211228, 5197483667, 203272439
/Volumes/methlab_data/HBN/EEG-ET/NDARAR305LXG/NDARAR305LXG_Video-WK_Samples_ET.mat, Diary, 60, 3074815935, 3192202769, 117386834
/Volumes/methlab_data/HBN/EEG-ET/NDARAT100AEQ/NDARAT100AEQ_Video1_Samples_ET.mat, Diary, 60, 2868248579, 2985643639, 117395060
/Volumes/methlab_data/HBN/EEG-ET/NDARAT100AEQ/NDARAT100AEQ_Video3_Samples_ET.mat, Despicable, 60, 3261098419, 3431640064, 170541645
/Volumes/methlab_data/HBN/EEG-ET/NDARAT244VGA/NDARAT244VGA_Video-DM_Samples_ET.mat, Despicable, 120, 3887382128, 4057929432, 170547304
/Volumes/methlab_data/HBN/EEG-ET/NDARAT244VGA/NDARAT244VGA_Video-FF_Samples_ET.mat, Fractals, 120, 2898328517, 3061315376, 162986859
/Volumes/methlab_data/HBN/EEG-ET/NDARAT244VGA/NDARAT244VGA_Video-TP_Samples_ET.mat, Present, 120, 5039505548, 5242570397, 203064849
/Volumes/methlab_data/HBN/EEG-ET/NDARAT244VGA/NDARAT244VGA_Video-WK_Samples_ET.mat, Diary, 120, 4374478812, 4491877842, 117399030
/Volumes/methlab_data/HBN/EEG-ET/NDARAT299YRR/NDARAT299YRR_Video1_Samples_ET.mat, Diary, 60, 896441808, 1013841938, 117400130
/Volumes/methlab_data/HBN/EEG-ET/NDARAT299YRR/NDARAT299YRR_Video3_Samples_ET.mat, Despicable, 60, 690095706, 860639460, 170543754
/Volumes/methlab_data/HBN/EEG-ET/NDARAT358XM9/NDARAT358XM9_Video1_Samples_ET.mat, Diary, 60, 3580240775, 3697637796, 117397021
/Volumes/methlab_data/HBN/EEG-ET/NDARAT358XM9/NDARAT358XM9_Video2_Samples_ET.mat, Fractals, 60, 4141572620, 4304566892, 162994272
/Volumes/methlab_data/HBN/EEG-ET/NDARAT358XM9/NDARAT358XM9_Video3_Samples_ET.mat, Despicable, 60, 4557631793, 4728170377, 170538584
/Volumes/methlab_data/HBN/EEG-ET/NDARAT358XM9/NDARAT358XM9_Video4_Samples_ET.mat, Present, 60, 5032991879, 5236053451, 203061572
/Volumes/methlab_data/HBN/EEG-ET/NDARAT709MMX/NDARAT709MMX_Video-DM_Samples_ET.mat, Despicable, 60, 4951572543, 5122125918, 170553375
/Volumes/methlab_data/HBN/EEG-ET/NDARAT709MMX/NDARAT709MMX_Video-FF_Samples_ET.mat, Fractals, 60, 4529297614, 4692290637, 162993023
/Volumes/methlab_data/HBN/EEG-ET/NDARAT709MMX/NDARAT709MMX_Video-TP_Samples_ET.mat, Present, 60, 5426197434, 5629261770, 203064336
/Volumes/methlab_data/HBN/EEG-ET/NDARAT709MMX/NDARAT709MMX_Video-WK_Samples_ET.mat, Diary, 60, 3892761506, 4010155356, 117393850
/Volumes/methlab_data/HBN/EEG-ET/NDARAT982JTU/NDARAT982JTU_Video-DM_Samples_ET.mat, Despicable, 120, 2972910156, 3143456179, 170546023
/Volumes/methlab_data/HBN/EEG-ET/NDARAT982JTU/NDARAT982JTU_Video-FF_Samples_ET.mat, Fractals, 120, 2464243411, 2627229026, 162985615
/Volumes/methlab_data/HBN/EEG-ET/NDARAT982JTU/NDARAT982JTU_Video-TP_Samples_ET.mat, Present, 120, 4154001482, 4357068421, 203066939
/Volumes/methlab_data/HBN/EEG-ET/NDARAT982JTU/NDARAT982JTU_Video-WK_Samples_ET.mat, Diary, 120, 3500585206, 3617983412, 117398206
/Volumes/methlab_data/HBN/EEG-ET/NDARAU447JZH/NDARAU447JZH_Video1_Samples_ET.mat, Diary, 60, 1826730955, 1944125035, 117394080
/Volumes/methlab_data/HBN/EEG-ET/NDARAU447JZH/NDARAU447JZH_Video3_Samples_ET.mat, Despicable, 60, 3038469410, 3209018163, 170548753
/Volumes/methlab_data/HBN/EEG-ET/NDARAU530GLJ/NDARAU530GLJ_Video-DM_Samples_ET.mat, Despicable, 120, 5395294655, 5565842138, 170547483
/Volumes/methlab_data/HBN/EEG-ET/NDARAU530GLJ/NDARAU530GLJ_Video-FF_Samples_ET.mat, Fractals, 120, 4965067184, 5128050945, 162983761
/Volumes/methlab_data/HBN/EEG-ET/NDARAU530GLJ/NDARAU530GLJ_Video-TP_Samples_ET.mat, Present, 120, 5968380992, 6171448115, 203067123
/Volumes/methlab_data/HBN/EEG-ET/NDARAU530GLJ/NDARAU530GLJ_Video-WK_Samples_ET.mat, Diary, 120, 4352730603, 4470118400, 117387797
/Volumes/methlab_data/HBN/EEG-ET/NDARAU708TL8/NDARAU708TL8_Video1_Samples_ET.mat, Diary, 60, 3311168929, 3428563942, 117395013
/Volumes/methlab_data/HBN/EEG-ET/NDARAU708TL8/NDARAU708TL8_Video2_Samples_ET.mat, Fractals, 60, 2227796962, 2390779230, 162982268
/Volumes/methlab_data/HBN/EEG-ET/NDARAU708TL8/NDARAU708TL8_Video3_Samples_ET.mat, Despicable, 60, 2839126185, 3009666784, 170540599
/Volumes/methlab_data/HBN/EEG-ET/NDARAU708TL8/NDARAU708TL8_Video4_Samples_ET.mat, Present, 60, 3749384730, 3952456336, 203071606
/Volumes/methlab_data/HBN/EEG-ET/NDARAU840EUZ/NDARAU840EUZ_Video-DM_Samples_ET.mat, Despicable, 60, 3399509675, 3570059296, 170549621
/Volumes/methlab_data/HBN/EEG-ET/NDARAU840EUZ/NDARAU840EUZ_Video-FF_Samples_ET.mat, Fractals, 60, 2889849101, 3052837406, 162988305
/Volumes/methlab_data/HBN/EEG-ET/NDARAU840EUZ/NDARAU840EUZ_Video-TP_Samples_ET.mat, Present, 60, 3886323870, 4089392537, 203068667
/Volumes/methlab_data/HBN/EEG-ET/NDARAU840EUZ/NDARAU840EUZ_Video-WK_Samples_ET.mat, Diary, 60, 2232852435, 2350242495, 117390060
/Volumes/methlab_data/HBN/EEG-ET/NDARAU939WUK/NDARAU939WUK_Video-DM_Samples_ET.mat, Despicable, 60, 6010631707, 6181180203, 170548496
/Volumes/methlab_data/HBN/EEG-ET/NDARAU939WUK/NDARAU939WUK_Video-FF_Samples_ET.mat, Fractals, 60, 5509447746, 5672436892, 162989146
/Volumes/methlab_data/HBN/EEG-ET/NDARAU939WUK/NDARAU939WUK_Video-TP_Samples_ET.mat, Present, 60, 6504610602, 6707680095, 203069493
/Volumes/methlab_data/HBN/EEG-ET/NDARAU939WUK/NDARAU939WUK_Video-WK_Samples_ET.mat, Diary, 60, 5044202132, 5161599162, 117397030
/Volumes/methlab_data/HBN/EEG-ET/NDARAV187GJ5/NDARAV187GJ5_Video1_Samples_ET.mat, Diary, 120, 3181789549, 3299186464, 117396915
/Volumes/methlab_data/HBN/EEG-ET/NDARAV187GJ5/NDARAV187GJ5_Video2_Samples_ET.mat, Fractals, 120, 3968076417, 4131063349, 162986932
/Volumes/methlab_data/HBN/EEG-ET/NDARAV187GJ5/NDARAV187GJ5_Video3_Samples_ET.mat, Despicable, 120, 4703056496, 4873603133, 170546637
/Volumes/methlab_data/HBN/EEG-ET/NDARAV187GJ5/NDARAV187GJ5_Video4_Samples_ET.mat, Present, 120, 5367158216, 5570226519, 203068303
/Volumes/methlab_data/HBN/EEG-ET/NDARAV189JGX/NDARAV189JGX_Video1_Samples_ET.mat, Fractals, 120, 7698705641, 7861692509, 162986868
/Volumes/methlab_data/HBN/EEG-ET/NDARAV189JGX/NDARAV189JGX_Video2_Samples_ET.mat, Despicable, 120, 8558070794, 8728617775, 170546981
/Volumes/methlab_data/HBN/EEG-ET/NDARAV189JGX/NDARAV189JGX_Video3_Samples_ET.mat, Diary, 120, 9147798607, 9265195014, 117396407
/Volumes/methlab_data/HBN/EEG-ET/NDARAV189JGX/NDARAV189JGX_Video4_Samples_ET.mat, Present, 120, 10032413410, 10235480915, 203067505
/Volumes/methlab_data/HBN/EEG-ET/NDARAV454VF0/NDARAV454VF0_Video-DM_Samples_ET.mat, Despicable, 60, 6788902193, 6959450721, 170548528
/Volumes/methlab_data/HBN/EEG-ET/NDARAV454VF0/NDARAV454VF0_Video-TP_Samples_ET.mat, Present, 60, 7389369505, 7592637191, 203267686
/Volumes/methlab_data/HBN/EEG-ET/NDARAV454VF0/NDARAV454VF0_Video-WK_Samples_ET.mat, Diary, 60, 5087539932, 5204927904, 117387972
/Volumes/methlab_data/HBN/EEG-ET/NDARAV554TP2/NDARAV554TP2_Video-DM_Samples_ET.mat, Despicable, 60, 4366192510, 4536740796, 170548286
/Volumes/methlab_data/HBN/EEG-ET/NDARAV554TP2/NDARAV554TP2_Video-FF_Samples_ET.mat, Fractals, 60, 3913177806, 4076169813, 162992007
/Volumes/methlab_data/HBN/EEG-ET/NDARAV554TP2/NDARAV554TP2_Video-TP_Samples_ET.mat, Present, 60, 4856033092, 5059102349, 203069257
/Volumes/methlab_data/HBN/EEG-ET/NDARAV554TP2/NDARAV554TP2_Video-WK_Samples_ET.mat, Diary, 60, 3094966486, 3212364351, 117397865
/Volumes/methlab_data/HBN/EEG-ET/NDARAV610EY3/NDARAV610EY3_Video1_Samples_ET.mat, Diary, 60, 3641297309, 3758693357, 117396048
/Volumes/methlab_data/HBN/EEG-ET/NDARAV610EY3/NDARAV610EY3_Video3_Samples_ET.mat, Despicable, 60, 3226413875, 3396954527, 170540652
/Volumes/methlab_data/HBN/EEG-ET/NDARAV747WVL/NDARAV747WVL_Video1_Samples_ET.mat, Diary, 60, 1959697400, 2077086304, 117388904
/Volumes/methlab_data/HBN/EEG-ET/NDARAV747WVL/NDARAV747WVL_Video3_Samples_ET.mat, Despicable, 60, 3617280564, 3787818963, 170538399
/Volumes/methlab_data/HBN/EEG-ET/NDARAV894XWD/NDARAV894XWD_Video1_Samples_ET.mat, Diary, 120, 3392759503, 3510157412, 117397909
/Volumes/methlab_data/HBN/EEG-ET/NDARAV894XWD/NDARAV894XWD_Video2_Samples_ET.mat, Fractals, 120, 5165577249, 5328565144, 162987895
/Volumes/methlab_data/HBN/EEG-ET/NDARAV894XWD/NDARAV894XWD_Video3_Samples_ET.mat, Despicable, 120, 5632635379, 5803182954, 170547575
/Volumes/methlab_data/HBN/EEG-ET/NDARAW179AYF/NDARAW179AYF_Video1_Samples_ET.mat, Diary, 120, 2935092055, 3052487542, 117395487
/Volumes/methlab_data/HBN/EEG-ET/NDARAW179AYF/NDARAW179AYF_Video2_Samples_ET.mat, Despicable, 120, 4205941768, 4376498992, 170557224
/Volumes/methlab_data/HBN/EEG-ET/NDARAW179AYF/NDARAW179AYF_Video3_Samples_ET.mat, Fractals, 120, 4624348690, 4787346792, 162998102
/Volumes/methlab_data/HBN/EEG-ET/NDARAW179AYF/NDARAW179AYF_Video4_Samples_ET.mat, Present, 120, 5316245241, 5519323174, 203077933
/Volumes/methlab_data/HBN/EEG-ET/NDARAW216PM7/NDARAW216PM7_Video-DM_Samples_ET.mat, Despicable, 60, 5515637951, 5686175483, 170537532
/Volumes/methlab_data/HBN/EEG-ET/NDARAW216PM7/NDARAW216PM7_Video-TP_Samples_ET.mat, Present, 60, 6638256243, 6841531935, 203275692
/Volumes/methlab_data/HBN/EEG-ET/NDARAW216PM7/NDARAW216PM7_Video-WK_Samples_ET.mat, Diary, 60, 6076371208, 6193760168, 117388960
/Volumes/methlab_data/HBN/EEG-ET/NDARAW247CCF/NDARAW247CCF_Video-DM_Samples_ET.mat, Despicable, 60, 3505396085, 3675932670, 170536585
/Volumes/methlab_data/HBN/EEG-ET/NDARAW247CCF/NDARAW247CCF_Video-TP_Samples_ET.mat, Present, 60, 4423515186, 4626792923, 203277737
/Volumes/methlab_data/HBN/EEG-ET/NDARAW247CCF/NDARAW247CCF_Video-WK_Samples_ET.mat, Diary, 60, 3089722229, 3207266323, 117544094
/Volumes/methlab_data/HBN/EEG-ET/NDARAW298ZA9/NDARAW298ZA9_Video-DM_Samples_ET.mat, Despicable, 30, 2401360968, 2571898733, 170537765
/Volumes/methlab_data/HBN/EEG-ET/NDARAW298ZA9/NDARAW298ZA9_Video-TP_Samples_ET.mat, Present, 30, 2993284034, 3196551971, 203267937
/Volumes/methlab_data/HBN/EEG-ET/NDARAW298ZA9/NDARAW298ZA9_Video-WK_Samples_ET.mat, Diary, 30, 2831235339, 2948622437, 117387098
/Volumes/methlab_data/HBN/EEG-ET/NDARAW320CGR/NDARAW320CGR_Video1_Samples_ET.mat, Diary, 60, 4600335633, 4717731609, 117395976
/Volumes/methlab_data/HBN/EEG-ET/NDARAW320CGR/NDARAW320CGR_Video3_Samples_ET.mat, Despicable, 60, 4357760224, 4528303738, 170543514
/Volumes/methlab_data/HBN/EEG-ET/NDARAX075WL9/NDARAX075WL9_Video-DM_Samples_ET.mat, Despicable, 30, 4334784646, 4505322980, 170538334
/Volumes/methlab_data/HBN/EEG-ET/NDARAX075WL9/NDARAX075WL9_Video-TP_Samples_ET.mat, Present, 30, 4797240938, 5000517393, 203276455
/Volumes/methlab_data/HBN/EEG-ET/NDARAX075WL9/NDARAX075WL9_Video-WK_Samples_ET.mat, Diary, 30, 3067550511, 3184940364, 117389853
/Volumes/methlab_data/HBN/EEG-ET/NDARAX272ZJL/NDARAX272ZJL_Video1_Samples_ET.mat, Diary, 60, 4560953985, 4678353555, 117399570
/Volumes/methlab_data/HBN/EEG-ET/NDARAX272ZJL/NDARAX272ZJL_Video3_Samples_ET.mat, Despicable, 60, 4008768980, 4179312373, 170543393
/Volumes/methlab_data/HBN/EEG-ET/NDARAX272ZJL/NDARAX272ZJL_Video4_Samples_ET.mat, Present, 60, 4998653497, 5201714050, 203060553
/Volumes/methlab_data/HBN/EEG-ET/NDARAX283MAK/NDARAX283MAK_Video1_Samples_ET.mat, Diary, 60, 3766541868, 3883935879, 117394011
/Volumes/methlab_data/HBN/EEG-ET/NDARAX283MAK/NDARAX283MAK_Video3_Samples_ET.mat, Despicable, 60, 4146905783, 4317452365, 170546582
/Volumes/methlab_data/HBN/EEG-ET/NDARAX283MAK/NDARAX283MAK_Video4_Samples_ET.mat, Present, 60, 4622923319, 4825985928, 203062609
/Volumes/methlab_data/HBN/EEG-ET/NDARAX287BLD/NDARAX287BLD_Video-DM_Samples_ET.mat, Despicable, 120, 3701166087, 3871713049, 170546962
/Volumes/methlab_data/HBN/EEG-ET/NDARAX287BLD/NDARAX287BLD_Video-FF_Samples_ET.mat, Fractals, 120, 3258179035, 3421166326, 162987291
/Volumes/methlab_data/HBN/EEG-ET/NDARAX287BLD/NDARAX287BLD_Video-TP_Samples_ET.mat, Present, 120, 4336121393, 4539188668, 203067275
/Volumes/methlab_data/HBN/EEG-ET/NDARAX287BLD/NDARAX287BLD_Video-WK_Samples_ET.mat, Diary, 120, 2464943943, 2582340677, 117396734
/Volumes/methlab_data/HBN/EEG-ET/NDARAX358NB5/NDARAX358NB5_Video1_Samples_ET.mat, Diary, 60, 3150559270, 3267957232, 117397962
/Volumes/methlab_data/HBN/EEG-ET/NDARAX358NB5/NDARAX358NB5_Video2_Samples_ET.mat, Fractals, 60, 3351181044, 3514163206, 162982162
/Volumes/methlab_data/HBN/EEG-ET/NDARAX358NB5/NDARAX358NB5_Video3_Samples_ET.mat, Despicable, 60, 2930556780, 3101098348, 170541568
/Volumes/methlab_data/HBN/EEG-ET/NDARAX358NB5/NDARAX358NB5_Video4_Samples_ET.mat, Present, 60, 3559377127, 3762435655, 203058528
/Volumes/methlab_data/HBN/EEG-ET/NDARAX722PKY/NDARAX722PKY_Video-DM_Samples_ET.mat, Despicable, 30, 3636007849, 3806547330, 170539481
/Volumes/methlab_data/HBN/EEG-ET/NDARAX722PKY/NDARAX722PKY_Video-TP_Samples_ET.mat, Present, 30, 4204732504, 4408002088, 203269584
/Volumes/methlab_data/HBN/EEG-ET/NDARAX722PKY/NDARAX722PKY_Video-WK_Samples_ET.mat, Diary, 30, 2420132067, 2537519997, 117387930
/Volumes/methlab_data/HBN/EEG-ET/NDARAX887JRN/NDARAX887JRN_Video1_Samples_ET.mat, Diary, 120, 3288860792, 3406267421, 117406629
/Volumes/methlab_data/HBN/EEG-ET/NDARAX887JRN/NDARAX887JRN_Video2_Samples_ET.mat, Fractals, 120, 4382971479, 4545959280, 162987801
/Volumes/methlab_data/HBN/EEG-ET/NDARAX887JRN/NDARAX887JRN_Video3_Samples_ET.mat, Despicable, 120, 4770529692, 4941077452, 170547760
/Volumes/methlab_data/HBN/EEG-ET/NDARAX887JRN/NDARAX887JRN_Video4_Samples_ET.mat, Present, 120, 5404206529, 5607283141, 203076612
/Volumes/methlab_data/HBN/EEG-ET/NDARAY238DFL/NDARAY238DFL_Video1_Samples_ET.mat, Diary, 60, 3362701564, 3480099647, 117398083
/Volumes/methlab_data/HBN/EEG-ET/NDARAY238DFL/NDARAY238DFL_Video3_Samples_ET.mat, Despicable, 60, 3813709568, 3984249191, 170539623
/Volumes/methlab_data/HBN/EEG-ET/NDARAY283AU1/NDARAY283AU1_Video1_Samples_ET.mat, Diary, 60, 3262440634, 3379837658, 117397024
/Volumes/methlab_data/HBN/EEG-ET/NDARAY283AU1/NDARAY283AU1_Video2_Samples_ET.mat, Fractals, 60, 3893427751, 4056413022, 162985271
/Volumes/methlab_data/HBN/EEG-ET/NDARAY283AU1/NDARAY283AU1_Video3_Samples_ET.mat, Despicable, 60, 4327313518, 4497860099, 170546581
/Volumes/methlab_data/HBN/EEG-ET/NDARAY283AU1/NDARAY283AU1_Video4_Samples_ET.mat, Present, 60, 4810847360, 5013908925, 203061565
/Volumes/methlab_data/HBN/EEG-ET/NDARAY298THW/NDARAY298THW_Video-DM_Samples_ET.mat, Despicable, 60, 3982460300, 4152997616, 170537316
/Volumes/methlab_data/HBN/EEG-ET/NDARAY298THW/NDARAY298THW_Video-TP_Samples_ET.mat, Present, 60, 4941575559, 5144853191, 203277632
/Volumes/methlab_data/HBN/EEG-ET/NDARAY298THW/NDARAY298THW_Video-WK_Samples_ET.mat, Diary, 60, 4465666025, 4583067552, 117401527
/Volumes/methlab_data/HBN/EEG-ET/NDARAY461TZZ/NDARAY461TZZ_Video1_Samples_ET.mat, Diary, 60, 3186674463, 3304070481, 117396018
/Volumes/methlab_data/HBN/EEG-ET/NDARAY461TZZ/NDARAY461TZZ_Video3_Samples_ET.mat, Despicable, 60, 2764827211, 2935368794, 170541583
/Volumes/methlab_data/HBN/EEG-ET/NDARAY461TZZ/NDARAY461TZZ_Video4_Samples_ET.mat, Present, 60, 3599739493, 3802816077, 203076584
/Volumes/methlab_data/HBN/EEG-ET/NDARAY475AKD/NDARAY475AKD_Video-DM_Samples_ET.mat, Despicable, 60, 4126409952, 4296958888, 170548936
/Volumes/methlab_data/HBN/EEG-ET/NDARAY475AKD/NDARAY475AKD_Video-FF_Samples_ET.mat, Fractals, 60, 3692348046, 3855337318, 162989272
/Volumes/methlab_data/HBN/EEG-ET/NDARAY475AKD/NDARAY475AKD_Video-TP_Samples_ET.mat, Present, 60, 4651164953, 4854222662, 203057709
/Volumes/methlab_data/HBN/EEG-ET/NDARAY475AKD/NDARAY475AKD_Video-WK_Samples_ET.mat, Diary, 60, 3063221285, 3180612324, 117391039
/Volumes/methlab_data/HBN/EEG-ET/NDARAY665GWN/NDARAY665GWN_Video-DM_Samples_ET.mat, Despicable, 60, 4412255026, 4582803688, 170548662
/Volumes/methlab_data/HBN/EEG-ET/NDARAY665GWN/NDARAY665GWN_Video-TP_Samples_ET.mat, Present, 60, 4879933015, 5083211966, 203278951
/Volumes/methlab_data/HBN/EEG-ET/NDARAY665GWN/NDARAY665GWN_Video-WK_Samples_ET.mat, Diary, 60, 3948910904, 4066296989, 117386085
/Volumes/methlab_data/HBN/EEG-ET/NDARAY734WB0/NDARAY734WB0_Video1_Samples_ET.mat, Diary, 60, 1764111798, 1881503772, 117391974
/Volumes/methlab_data/HBN/EEG-ET/NDARAY734WB0/NDARAY734WB0_Video3_Samples_ET.mat, Despicable, 60, 3085336458, 3255881000, 170544542
/Volumes/methlab_data/HBN/EEG-ET/NDARAZ068TNJ/NDARAZ068TNJ_Video-DM_Samples_ET.mat, Despicable, 30, 4933868319, 5104405811, 170537492
/Volumes/methlab_data/HBN/EEG-ET/NDARAZ068TNJ/NDARAZ068TNJ_Video-TP_Samples_ET.mat, Present, 30, 5478702133, 5681967705, 203265572
/Volumes/methlab_data/HBN/EEG-ET/NDARAZ068TNJ/NDARAZ068TNJ_Video-WK_Samples_ET.mat, Diary, 30, 4505063450, 4622450384, 117386934
/Volumes/methlab_data/HBN/EEG-ET/NDARAZ681CYF/NDARAZ681CYF_Video-DM_Samples_ET.mat, Despicable, 60, 4786332149, 4956871426, 170539277
/Volumes/methlab_data/HBN/EEG-ET/NDARAZ681CYF/NDARAZ681CYF_Video-TP_Samples_ET.mat, Present, 60, 5619186403, 5822455960, 203269557
/Volumes/methlab_data/HBN/EEG-ET/NDARAZ681CYF/NDARAZ681CYF_Video-WK_Samples_ET.mat, Diary, 60, 5207219420, 5324609941, 117390521
/Volumes/methlab_data/HBN/EEG-ET/NDARBA004KBT/NDARBA004KBT_Video-DM_Samples_ET.mat, Despicable, 30, 4288830149, 4459367630, 170537481
/Volumes/methlab_data/HBN/EEG-ET/NDARBA004KBT/NDARBA004KBT_Video-TP_Samples_ET.mat, Present, 30, 4806115496, 5009383178, 203267682
/Volumes/methlab_data/HBN/EEG-ET/NDARBA004KBT/NDARBA004KBT_Video-WK_Samples_ET.mat, Diary, 30, 2871934410, 2989322432, 117388022
/Volumes/methlab_data/HBN/EEG-ET/NDARBA381JGH/NDARBA381JGH_Video-DM_Samples_ET.mat, Despicable, 120, 8920722344, 9091270368, 170548024
/Volumes/methlab_data/HBN/EEG-ET/NDARBA381JGH/NDARBA381JGH_Video-FF_Samples_ET.mat, Fractals, 120, 7748199936, 7911186579, 162986643
/Volumes/methlab_data/HBN/EEG-ET/NDARBA381JGH/NDARBA381JGH_Video-TP_Samples_ET.mat, Present, 120, 9717979307, 9921045083, 203065776
/Volumes/methlab_data/HBN/EEG-ET/NDARBA381JGH/NDARBA381JGH_Video-WK_Samples_ET.mat, Diary, 120, 8415151689, 8532540377, 117388688
/Volumes/methlab_data/HBN/EEG-ET/NDARBA507GCT/NDARBA507GCT_Video1_Samples_ET.mat, Diary, 120, 3276141488, 3393530187, 117388699
/Volumes/methlab_data/HBN/EEG-ET/NDARBA507GCT/NDARBA507GCT_Video2_Samples_ET.mat, Fractals, 120, 4904001604, 5066988439, 162986835
/Volumes/methlab_data/HBN/EEG-ET/NDARBA507GCT/NDARBA507GCT_Video3_Samples_ET.mat, Despicable, 120, 5408278522, 5578826092, 170547570
/Volumes/methlab_data/HBN/EEG-ET/NDARBA521RA8/NDARBA521RA8_Video1_Samples_ET.mat, Diary, 60, 2796250591, 2913638625, 117388034
/Volumes/methlab_data/HBN/EEG-ET/NDARBA521RA8/NDARBA521RA8_Video3_Samples_ET.mat, Despicable, 60, 3964778041, 4135333677, 170555636
/Volumes/methlab_data/HBN/EEG-ET/NDARBA839HLG/NDARBA839HLG_Video1_Samples_ET.mat, Diary, 60, 3904136848, 4021532894, 117396046
/Volumes/methlab_data/HBN/EEG-ET/NDARBA839HLG/NDARBA839HLG_Video3_Samples_ET.mat, Despicable, 60, 3486962794, 3657505439, 170542645
/Volumes/methlab_data/HBN/EEG-ET/NDARBB118UDB/NDARBB118UDB_Video1_Samples_ET.mat, Despicable, 120, 9448366149, 9618912837, 170546688
/Volumes/methlab_data/HBN/EEG-ET/NDARBB118UDB/NDARBB118UDB_Video2_Samples_ET.mat, Fractals, 120, 9734772369, 9897760487, 162988118
/Volumes/methlab_data/HBN/EEG-ET/NDARBB118UDB/NDARBB118UDB_Video3_Samples_ET.mat, Diary, 120, 10100561000, 10217957987, 117396987
/Volumes/methlab_data/HBN/EEG-ET/NDARBB118UDB/NDARBB118UDB_Video4_Samples_ET.mat, Present, 120, 10408618685, 10611685575, 203066890
/Volumes/methlab_data/HBN/EEG-ET/NDARBB995GGY/NDARBB995GGY_Video-DM_Samples_ET.mat, Despicable, 30, 5088240832, 5258777120, 170536288
/Volumes/methlab_data/HBN/EEG-ET/NDARBB995GGY/NDARBB995GGY_Video-TP_Samples_ET.mat, Present, 30, 5602204300, 5805483688, 203279388
/Volumes/methlab_data/HBN/EEG-ET/NDARBB995GGY/NDARBB995GGY_Video-WK_Samples_ET.mat, Diary, 30, 3770375471, 3887762284, 117386813
/Volumes/methlab_data/HBN/EEG-ET/NDARBC240LNC/NDARBC240LNC_Video1_Samples_ET.mat, Diary, 60, 5520070166, 5637456968, 117386802
/Volumes/methlab_data/HBN/EEG-ET/NDARBC240LNC/NDARBC240LNC_Video2_Samples_ET.mat, Fractals, 60, 4431641598, 4594631543, 162989945
/Volumes/methlab_data/HBN/EEG-ET/NDARBC240LNC/NDARBC240LNC_Video3_Samples_ET.mat, Despicable, 60, 5043266920, 5213814326, 170547406
/Volumes/methlab_data/HBN/EEG-ET/NDARBC240LNC/NDARBC240LNC_Video4_Samples_ET.mat, Present, 60, 6067940539, 6270999763, 203059224
/Volumes/methlab_data/HBN/EEG-ET/NDARBC296PLU/NDARBC296PLU_Video1_Samples_ET.mat, Diary, 60, 4505486961, 4622881754, 117394793
/Volumes/methlab_data/HBN/EEG-ET/NDARBC296PLU/NDARBC296PLU_Video3_Samples_ET.mat, Despicable, 60, 4099171029, 4269715563, 170544534
/Volumes/methlab_data/HBN/EEG-ET/NDARBC296PLU/NDARBC296PLU_Video4_Samples_ET.mat, Present, 60, 4669982980, 4873043374, 203060394
/Volumes/methlab_data/HBN/EEG-ET/NDARBC580HR5/NDARBC580HR5_Video1_Samples_ET.mat, Diary, 120, 4534343833, 4651742263, 117398430
/Volumes/methlab_data/HBN/EEG-ET/NDARBC580HR5/NDARBC580HR5_Video2_Samples_ET.mat, Fractals, 120, 5811236543, 5974223578, 162987035
/Volumes/methlab_data/HBN/EEG-ET/NDARBC580HR5/NDARBC580HR5_Video3_Samples_ET.mat, Despicable, 120, 6367822400, 6538369551, 170547151
/Volumes/methlab_data/HBN/EEG-ET/NDARBC734UVY/NDARBC734UVY_Video1_Samples_ET.mat, Diary, 60, 4956410249, 5073803257, 117393008
/Volumes/methlab_data/HBN/EEG-ET/NDARBC734UVY/NDARBC734UVY_Video3_Samples_ET.mat, Despicable, 60, 4167846007, 4338389557, 170543550
/Volumes/methlab_data/HBN/EEG-ET/NDARBC734UVY/NDARBC734UVY_Video4_Samples_ET.mat, Present, 60, 5630203376, 5833266905, 203063529
/Volumes/methlab_data/HBN/EEG-ET/NDARBD328NUQ/NDARBD328NUQ_Video-DM_Samples_ET.mat, Despicable, 30, 4568118974, 4738666515, 170547541
/Volumes/methlab_data/HBN/EEG-ET/NDARBD328NUQ/NDARBD328NUQ_Video-TP_Samples_ET.mat, Present, 30, 5047244545, 5250522211, 203277666
/Volumes/methlab_data/HBN/EEG-ET/NDARBD328NUQ/NDARBD328NUQ_Video-WK_Samples_ET.mat, Diary, 30, 3459624668, 3577111694, 117487026
/Volumes/methlab_data/HBN/EEG-ET/NDARBD370RBY/NDARBD370RBY_Video-DM_Samples_ET.mat, Despicable, 60, 5512000332, 5682542998, 170542666
/Volumes/methlab_data/HBN/EEG-ET/NDARBD370RBY/NDARBD370RBY_Video-FF_Samples_ET.mat, Fractals, 60, 6059348495, 6222341760, 162993265
/Volumes/methlab_data/HBN/EEG-ET/NDARBD370RBY/NDARBD370RBY_Video-WK_Samples_ET.mat, Diary, 60, 5051644753, 5169039823, 117395070
/Volumes/methlab_data/HBN/EEG-ET/NDARBD566RRW/NDARBD566RRW_Video1_Samples_ET.mat, Diary, 60, 5238651400, 5356041496, 117390096
/Volumes/methlab_data/HBN/EEG-ET/NDARBD566RRW/NDARBD566RRW_Video3_Samples_ET.mat, Despicable, 60, 4678137772, 4848688480, 170550708
/Volumes/methlab_data/HBN/EEG-ET/NDARBD879MBX/NDARBD879MBX_Video1_Samples_ET.mat, Diary, 120, 2984581617, 3101970214, 117388597
/Volumes/methlab_data/HBN/EEG-ET/NDARBD879MBX/NDARBD879MBX_Video2_Samples_ET.mat, Despicable, 120, 4286662829, 4457210903, 170548074
/Volumes/methlab_data/HBN/EEG-ET/NDARBD879MBX/NDARBD879MBX_Video3_Samples_ET.mat, Fractals, 120, 4766900355, 4929888070, 162987715
/Volumes/methlab_data/HBN/EEG-ET/NDARBD879MBX/NDARBD879MBX_Video4_Samples_ET.mat, Present, 120, 5417897022, 5620963755, 203066733
/Volumes/methlab_data/HBN/EEG-ET/NDARBD992CH7/NDARBD992CH7_Video-DM_Samples_ET.mat, Despicable, 30, 4111147524, 4281682867, 170535343
/Volumes/methlab_data/HBN/EEG-ET/NDARBD992CH7/NDARBD992CH7_Video-TP_Samples_ET.mat, Present, 30, 5124477170, 5327746152, 203268982
/Volumes/methlab_data/HBN/EEG-ET/NDARBD992CH7/NDARBD992CH7_Video-WK_Samples_ET.mat, Diary, 30, 3262640592, 3380036619, 117396027
/Volumes/methlab_data/HBN/EEG-ET/NDARBE091BGD/NDARBE091BGD_Video1_Samples_ET.mat, Diary, 60, 3991685283, 4109079210, 117393927
/Volumes/methlab_data/HBN/EEG-ET/NDARBE091BGD/NDARBE091BGD_Video2_Samples_ET.mat, Fractals, 60, 4696740274, 4859733408, 162993134
/Volumes/methlab_data/HBN/EEG-ET/NDARBE091BGD/NDARBE091BGD_Video3_Samples_ET.mat, Despicable, 60, 5173303845, 5343848325, 170544480
/Volumes/methlab_data/HBN/EEG-ET/NDARBE091BGD/NDARBE091BGD_Video4_Samples_ET.mat, Present, 60, 5738625114, 5941686564, 203061450
/Volumes/methlab_data/HBN/EEG-ET/NDARBE103DHM/NDARBE103DHM_Video1_Samples_ET.mat, Diary, 60, 1715173591, 1832568686, 117395095
/Volumes/methlab_data/HBN/EEG-ET/NDARBE103DHM/NDARBE103DHM_Video2_Samples_ET.mat, Fractals, 60, 2669563942, 2832546310, 162982368
/Volumes/methlab_data/HBN/EEG-ET/NDARBE103DHM/NDARBE103DHM_Video3_Samples_ET.mat, Despicable, 60, 3096557081, 3267100797, 170543716
/Volumes/methlab_data/HBN/EEG-ET/NDARBE103DHM/NDARBE103DHM_Video4_Samples_ET.mat, Present, 60, 3579881108, 3782951812, 203070704
/Volumes/methlab_data/HBN/EEG-ET/NDARBE287EFC/NDARBE287EFC_Video-DM_Samples_ET.mat, Despicable, 60, 5248775790, 5419312742, 170536952
/Volumes/methlab_data/HBN/EEG-ET/NDARBE287EFC/NDARBE287EFC_Video-TP_Samples_ET.mat, Present, 60, 5789193095, 5992458298, 203265203
/Volumes/methlab_data/HBN/EEG-ET/NDARBE287EFC/NDARBE287EFC_Video-WK_Samples_ET.mat, Diary, 60, 3958905823, 4076293109, 117387286
/Volumes/methlab_data/HBN/EEG-ET/NDARBE641DGZ/NDARBE641DGZ_Video1_Samples_ET.mat, Diary, 60, 8274011435, 8391411486, 117400051
/Volumes/methlab_data/HBN/EEG-ET/NDARBE641DGZ/NDARBE641DGZ_Video3_Samples_ET.mat, Despicable, 60, 7844174427, 8014717070, 170542643
/Volumes/methlab_data/HBN/EEG-ET/NDARBE719PMB/NDARBE719PMB_Video-DM_Samples_ET.mat, Despicable, 30, 3818526831, 3989063296, 170536465
/Volumes/methlab_data/HBN/EEG-ET/NDARBE719PMB/NDARBE719PMB_Video-TP_Samples_ET.mat, Present, 30, 4753555231, 4956821821, 203266590
/Volumes/methlab_data/HBN/EEG-ET/NDARBE719PMB/NDARBE719PMB_Video-WK_Samples_ET.mat, Diary, 30, 4295140456, 4412532380, 117391924
/Volumes/methlab_data/HBN/EEG-ET/NDARBF042LDM/NDARBF042LDM_Video-DM_Samples_ET.mat, Despicable, 30, 9438192022, 9608739611, 170547589
/Volumes/methlab_data/HBN/EEG-ET/NDARBF042LDM/NDARBF042LDM_Video-TP_Samples_ET.mat, Present, 30, 10296802031, 10500069765, 203267734
/Volumes/methlab_data/HBN/EEG-ET/NDARBF042LDM/NDARBF042LDM_Video-WK_Samples_ET.mat, Diary, 30, 9860267401, 9977654410, 117387009
/Volumes/methlab_data/HBN/EEG-ET/NDARBF176LPM/NDARBF176LPM_Video1_Samples_ET.mat, Despicable, 120, 1715371318, 1885918604, 170547286
/Volumes/methlab_data/HBN/EEG-ET/NDARBF176LPM/NDARBF176LPM_Video2_Samples_ET.mat, Fractals, 120, 2010769200, 2173756222, 162987022
/Volumes/methlab_data/HBN/EEG-ET/NDARBF176LPM/NDARBF176LPM_Video3_Samples_ET.mat, Diary, 120, 2291286754, 2408684914, 117398160
/Volumes/methlab_data/HBN/EEG-ET/NDARBF176LPM/NDARBF176LPM_Video4_Samples_ET.mat, Present, 120, 2453965876, 2657043400, 203077524
/Volumes/methlab_data/HBN/EEG-ET/NDARBF183RFB/NDARBF183RFB_Video-DM_Samples_ET.mat, Despicable, 120, 3443729126, 3614286316, 170557190
/Volumes/methlab_data/HBN/EEG-ET/NDARBF183RFB/NDARBF183RFB_Video-FF_Samples_ET.mat, Fractals, 120, 2630064879, 2793051334, 162986455
/Volumes/methlab_data/HBN/EEG-ET/NDARBF183RFB/NDARBF183RFB_Video-WK_Samples_ET.mat, Diary, 120, 3890680914, 4008075285, 117394371
/Volumes/methlab_data/HBN/EEG-ET/NDARBF293YRB/NDARBF293YRB_Video-DM_Samples_ET.mat, Despicable, 120, 4052985092, 4223530981, 170545889
/Volumes/methlab_data/HBN/EEG-ET/NDARBF293YRB/NDARBF293YRB_Video-FF_Samples_ET.mat, Fractals, 120, 4605589801, 4768576760, 162986959
/Volumes/methlab_data/HBN/EEG-ET/NDARBF293YRB/NDARBF293YRB_Video-TP_Samples_ET.mat, Present, 120, 5012826901, 5215894258, 203067357
/Volumes/methlab_data/HBN/EEG-ET/NDARBF293YRB/NDARBF293YRB_Video-WK_Samples_ET.mat, Diary, 120, 4839318439, 4956715972, 117397533
/Volumes/methlab_data/HBN/EEG-ET/NDARBF389RLF/NDARBF389RLF_Video-DM_Samples_ET.mat, Despicable, 60, 4642029228, 4812575866, 170546638
/Volumes/methlab_data/HBN/EEG-ET/NDARBF389RLF/NDARBF389RLF_Video-TP_Samples_ET.mat, Present, 60, 5122022690, 5325292473, 203269783
/Volumes/methlab_data/HBN/EEG-ET/NDARBF389RLF/NDARBF389RLF_Video-WK_Samples_ET.mat, Diary, 60, 3700887570, 3818275601, 117388031
/Volumes/methlab_data/HBN/EEG-ET/NDARBF805EHN/NDARBF805EHN_Video1_Samples_ET.mat, Diary, 60, 5153924097, 5271316971, 117392874
/Volumes/methlab_data/HBN/EEG-ET/NDARBF805EHN/NDARBF805EHN_Video3_Samples_ET.mat, Despicable, 60, 4690746883, 4861304393, 170557510
/Volumes/methlab_data/HBN/EEG-ET/NDARBF851NH6/NDARBF851NH6_Video1_Samples_ET.mat, Despicable, 120, 3103931145, 3274477239, 170546094
/Volumes/methlab_data/HBN/EEG-ET/NDARBF851NH6/NDARBF851NH6_Video2_Samples_ET.mat, Diary, 120, 4092834831, 4210225829, 117390998
/Volumes/methlab_data/HBN/EEG-ET/NDARBF851NH6/NDARBF851NH6_Video3_Samples_ET.mat, Fractals, 120, 4479800694, 4642786930, 162986236
/Volumes/methlab_data/HBN/EEG-ET/NDARBF851NH6/NDARBF851NH6_Video4_Samples_ET.mat, Present, 120, 5117928431, 5320994826, 203066395
/Volumes/methlab_data/HBN/EEG-ET/NDARBF906DVB/NDARBF906DVB_Video-DM_Samples_ET.mat, Despicable, 120, 5011262718, 5181808921, 170546203
/Volumes/methlab_data/HBN/EEG-ET/NDARBF906DVB/NDARBF906DVB_Video-FF_Samples_ET.mat, Fractals, 120, 3075464536, 3238451209, 162986673
/Volumes/methlab_data/HBN/EEG-ET/NDARBF906DVB/NDARBF906DVB_Video-TP_Samples_ET.mat, Present, 120, 6024375167, 6227442813, 203067646
/Volumes/methlab_data/HBN/EEG-ET/NDARBF906DVB/NDARBF906DVB_Video-WK_Samples_ET.mat, Diary, 120, 5395629562, 5513026848, 117397286
/Volumes/methlab_data/HBN/EEG-ET/NDARBG188RA5/NDARBG188RA5_Video1_Samples_ET.mat, Fractals, 120, 7370010922, 7532997663, 162986741
/Volumes/methlab_data/HBN/EEG-ET/NDARBG188RA5/NDARBG188RA5_Video2_Samples_ET.mat, Despicable, 120, 8178736207, 8349283427, 170547220
/Volumes/methlab_data/HBN/EEG-ET/NDARBG188RA5/NDARBG188RA5_Video3_Samples_ET.mat, Diary, 120, 8644293145, 8761690376, 117397231
/Volumes/methlab_data/HBN/EEG-ET/NDARBG188RA5/NDARBG188RA5_Video4_Samples_ET.mat, Present, 120, 9237950426, 9441018220, 203067794
/Volumes/methlab_data/HBN/EEG-ET/NDARBG574KF4/NDARBG574KF4_Video1_Samples_ET.mat, Diary, 60, 9923756480, 10041151774, 117395294
/Volumes/methlab_data/HBN/EEG-ET/NDARBG574KF4/NDARBG574KF4_Video3_Samples_ET.mat, Despicable, 60, 9347814714, 9518356765, 170542051
/Volumes/methlab_data/HBN/EEG-ET/NDARBG831VK4/NDARBG831VK4_Video1_Samples_ET.mat, Diary, 60, 3291593665, 3408986651, 117392986
/Volumes/methlab_data/HBN/EEG-ET/NDARBG831VK4/NDARBG831VK4_Video3_Samples_ET.mat, Despicable, 60, 2838616585, 3009161111, 170544526
/Volumes/methlab_data/HBN/EEG-ET/NDARBH019KPD/NDARBH019KPD_Video-DM_Samples_ET.mat, Despicable, 30, 4135631480, 4306167992, 170536512
/Volumes/methlab_data/HBN/EEG-ET/NDARBH019KPD/NDARBH019KPD_Video-TP_Samples_ET.mat, Present, 30, 5075051322, 5278327967, 203276645
/Volumes/methlab_data/HBN/EEG-ET/NDARBH019KPD/NDARBH019KPD_Video-WK_Samples_ET.mat, Diary, 30, 4640025900, 4757415885, 117389985
/Volumes/methlab_data/HBN/EEG-ET/NDARBH024NH2/NDARBH024NH2_Video1_Samples_ET.mat, Diary, 60, 4350737882, 4468129873, 117391991
/Volumes/methlab_data/HBN/EEG-ET/NDARBH024NH2/NDARBH024NH2_Video3_Samples_ET.mat, Despicable, 60, 3886041513, 4056583065, 170541552
/Volumes/methlab_data/HBN/EEG-ET/NDARBH512BHA/NDARBH512BHA_Video-DM_Samples_ET.mat, Despicable, 120, 3957457632, 4128001681, 170544049
/Volumes/methlab_data/HBN/EEG-ET/NDARBH512BHA/NDARBH512BHA_Video-FF_Samples_ET.mat, Fractals, 120, 3216480542, 3379466735, 162986193
/Volumes/methlab_data/HBN/EEG-ET/NDARBH512BHA/NDARBH512BHA_Video-TP_Samples_ET.mat, Present, 120, 5133717260, 5336794204, 203076944
/Volumes/methlab_data/HBN/EEG-ET/NDARBH512BHA/NDARBH512BHA_Video-WK_Samples_ET.mat, Diary, 120, 4382082085, 4499478451, 117396366
/Volumes/methlab_data/HBN/EEG-ET/NDARBH728DFK/NDARBH728DFK_Video-DM_Samples_ET.mat, Despicable, 60, 4900521996, 5071067266, 170545270
/Volumes/methlab_data/HBN/EEG-ET/NDARBH728DFK/NDARBH728DFK_Video-FF_Samples_ET.mat, Fractals, 60, 4446290656, 4609280629, 162989973
/Volumes/methlab_data/HBN/EEG-ET/NDARBH728DFK/NDARBH728DFK_Video-TP_Samples_ET.mat, Present, 60, 5374946602, 5578007784, 203061182
/Volumes/methlab_data/HBN/EEG-ET/NDARBH728DFK/NDARBH728DFK_Video-WK_Samples_ET.mat, Diary, 60, 3803272202, 3920665989, 117393787
/Volumes/methlab_data/HBN/EEG-ET/NDARBH992ARB/NDARBH992ARB_Video-DM_Samples_ET.mat, Despicable, 60, 4670956011, 4841498604, 170542593
/Volumes/methlab_data/HBN/EEG-ET/NDARBH992ARB/NDARBH992ARB_Video-FF_Samples_ET.mat, Fractals, 60, 3772286644, 3935334932, 163048288
/Volumes/methlab_data/HBN/EEG-ET/NDARBH992ARB/NDARBH992ARB_Video-TP_Samples_ET.mat, Present, 60, 5617675350, 5820735926, 203060576
/Volumes/methlab_data/HBN/EEG-ET/NDARBH992ARB/NDARBH992ARB_Video-WK_Samples_ET.mat, Diary, 60, 5125361272, 5242758288, 117397016
/Volumes/methlab_data/HBN/EEG-ET/NDARBJ159HXB/NDARBJ159HXB_Video1_Samples_ET.mat, Fractals, 120, 3643039324, 3806026385, 162987061
/Volumes/methlab_data/HBN/EEG-ET/NDARBJ159HXB/NDARBJ159HXB_Video2_Samples_ET.mat, Diary, 120, 4903177593, 5020564913, 117387320
/Volumes/methlab_data/HBN/EEG-ET/NDARBJ159HXB/NDARBJ159HXB_Video3_Samples_ET.mat, Despicable, 120, 5355963280, 5526504299, 170541019
/Volumes/methlab_data/HBN/EEG-ET/NDARBJ159HXB/NDARBJ159HXB_Video4_Samples_ET.mat, Present, 120, 6114945324, 6318011641, 203066317
/Volumes/methlab_data/HBN/EEG-ET/NDARBJ375VP4/NDARBJ375VP4_Video-DM_Samples_ET.mat, Despicable, 60, 2696560055, 2867102793, 170542738
/Volumes/methlab_data/HBN/EEG-ET/NDARBJ375VP4/NDARBJ375VP4_Video-FF_Samples_ET.mat, Fractals, 60, 3234095609, 3397082997, 162987388
/Volumes/methlab_data/HBN/EEG-ET/NDARBJ375VP4/NDARBJ375VP4_Video-WK_Samples_ET.mat, Diary, 60, 1915237898, 2032631997, 117394099
/Volumes/methlab_data/HBN/EEG-ET/NDARBJ478HW5/NDARBJ478HW5_Video-DM_Samples_ET.mat, Despicable, 120, 3327418744, 3497968668, 170549924
/Volumes/methlab_data/HBN/EEG-ET/NDARBJ478HW5/NDARBJ478HW5_Video-FF_Samples_ET.mat, Fractals, 120, 3764315548, 3927305378, 162989830
/Volumes/methlab_data/HBN/EEG-ET/NDARBJ478HW5/NDARBJ478HW5_Video-TP_Samples_ET.mat, Present, 120, 4010909978, 4213972325, 203062347
/Volumes/methlab_data/HBN/EEG-ET/NDARBJ478HW5/NDARBJ478HW5_Video-WK_Samples_ET.mat, Diary, 120, 3541680480, 3659076742, 117396262
/Volumes/methlab_data/HBN/EEG-ET/NDARBJ637CFZ/NDARBJ637CFZ_Video-DM_Samples_ET.mat, Despicable, 120, 4412803282, 4583350582, 170547300
/Volumes/methlab_data/HBN/EEG-ET/NDARBJ637CFZ/NDARBJ637CFZ_Video-FF_Samples_ET.mat, Fractals, 120, 3429679675, 3592675959, 162996284
/Volumes/methlab_data/HBN/EEG-ET/NDARBJ637CFZ/NDARBJ637CFZ_Video-TP_Samples_ET.mat, Present, 120, 5590525912, 5793592688, 203066776
/Volumes/methlab_data/HBN/EEG-ET/NDARBJ637CFZ/NDARBJ637CFZ_Video-WK_Samples_ET.mat, Diary, 120, 4987989991, 5105387686, 117397695
/Volumes/methlab_data/HBN/EEG-ET/NDARBJ674TVU/NDARBJ674TVU_Video1_Samples_ET.mat, Diary, 60, 3865152033, 3982545021, 117392988
/Volumes/methlab_data/HBN/EEG-ET/NDARBJ674TVU/NDARBJ674TVU_Video2_Samples_ET.mat, Fractals, 60, 4777318602, 4940300808, 162982206
/Volumes/methlab_data/HBN/EEG-ET/NDARBJ674TVU/NDARBJ674TVU_Video3_Samples_ET.mat, Despicable, 60, 4346624281, 4517166805, 170542524
/Volumes/methlab_data/HBN/EEG-ET/NDARBJ674TVU/NDARBJ674TVU_Video4_Samples_ET.mat, Present, 60, 5241553650, 5444625181, 203071531
/Volumes/methlab_data/HBN/EEG-ET/NDARBK082PDD/NDARBK082PDD_Video1_Samples_ET.mat, Diary, 60, 3604794964, 3722187922, 117392958
/Volumes/methlab_data/HBN/EEG-ET/NDARBK082PDD/NDARBK082PDD_Video3_Samples_ET.mat, Despicable, 60, 3164908087, 3335458692, 170550605
/Volumes/methlab_data/HBN/EEG-ET/NDARBK638HLZ/NDARBK638HLZ_Video1_Samples_ET.mat, Diary, 60, 5185173039, 5302561883, 117388844
/Volumes/methlab_data/HBN/EEG-ET/NDARBK638HLZ/NDARBK638HLZ_Video2_Samples_ET.mat, Fractals, 60, 3931946799, 4094936822, 162990023
/Volumes/methlab_data/HBN/EEG-ET/NDARBK638HLZ/NDARBK638HLZ_Video3_Samples_ET.mat, Despicable, 60, 4587001989, 4757548328, 170546339
/Volumes/methlab_data/HBN/EEG-ET/NDARBK638HLZ/NDARBK638HLZ_Video4_Samples_ET.mat, Present, 60, 5605916899, 5808984210, 203067311
/Volumes/methlab_data/HBN/EEG-ET/NDARBK669XJQ/NDARBK669XJQ_Video1_Samples_ET.mat, Diary, 60, 5239658507, 5357057476, 117398969
/Volumes/methlab_data/HBN/EEG-ET/NDARBK669XJQ/NDARBK669XJQ_Video3_Samples_ET.mat, Despicable, 60, 4732484123, 4903027651, 170543528
/Volumes/methlab_data/HBN/EEG-ET/NDARBL042LWN/NDARBL042LWN_Video-DM_Samples_ET.mat, Despicable, 120, 3700893892, 3871450256, 170556364
/Volumes/methlab_data/HBN/EEG-ET/NDARBL042LWN/NDARBL042LWN_Video-FF_Samples_ET.mat, Fractals, 120, 2890288453, 3053284996, 162996543
/Volumes/methlab_data/HBN/EEG-ET/NDARBL042LWN/NDARBL042LWN_Video-TP_Samples_ET.mat, Present, 120, 4765727745, 4968804244, 203076499
/Volumes/methlab_data/HBN/EEG-ET/NDARBL042LWN/NDARBL042LWN_Video-WK_Samples_ET.mat, Diary, 120, 4171440702, 4288837831, 117397129
/Volumes/methlab_data/HBN/EEG-ET/NDARBL117AUV/NDARBL117AUV_Video1_Samples_ET.mat, Diary, 60, 4875721345, 4993110205, 117388860
/Volumes/methlab_data/HBN/EEG-ET/NDARBL117AUV/NDARBL117AUV_Video3_Samples_ET.mat, Despicable, 60, 4393301990, 4563847326, 170545336
/Volumes/methlab_data/HBN/EEG-ET/NDARBL170XJX/NDARBL170XJX_Video-TP_Samples_ET.mat, Present, 30, 5240098738, 5443374494, 203275756
/Volumes/methlab_data/HBN/EEG-ET/NDARBL170XJX/NDARBL170XJX_Video-WK_Samples_ET.mat, Diary, 30, 3616432812, 3733819832, 117387020
/Volumes/methlab_data/HBN/EEG-ET/NDARBL242L4H/NDARBL242L4H_Video-DM_Samples_ET.mat, Despicable, 60, 3142941084, 3313485565, 170544481
/Volumes/methlab_data/HBN/EEG-ET/NDARBL242L4H/NDARBL242L4H_Video-FF_Samples_ET.mat, Fractals, 60, 2669739873, 2832729999, 162990126
/Volumes/methlab_data/HBN/EEG-ET/NDARBL242L4H/NDARBL242L4H_Video-TP_Samples_ET.mat, Present, 60, 3694783861, 3897852278, 203068417
/Volumes/methlab_data/HBN/EEG-ET/NDARBL242L4H/NDARBL242L4H_Video-WK_Samples_ET.mat, Diary, 60, 1988093417, 2105488379, 117394962
/Volumes/methlab_data/HBN/EEG-ET/NDARBL444FBA/NDARBL444FBA_Video1_Samples_ET.mat, Diary, 60, 2685103037, 2802495953, 117392916
/Volumes/methlab_data/HBN/EEG-ET/NDARBL444FBA/NDARBL444FBA_Video3_Samples_ET.mat, Despicable, 60, 2227427963, 2397972377, 170544414
/Volumes/methlab_data/HBN/EEG-ET/NDARBL444FBA/NDARBL444FBA_Video4_Samples_ET.mat, Present, 60, 3158055925, 3361116297, 203060372
/Volumes/methlab_data/HBN/EEG-ET/NDARBL532FPT/NDARBL532FPT_Video-DM_Samples_ET.mat, Despicable, 60, 9825712710, 9996258234, 170545524
/Volumes/methlab_data/HBN/EEG-ET/NDARBL532FPT/NDARBL532FPT_Video-FF_Samples_ET.mat, Fractals, 60, 9274825417, 9437807648, 162982231
/Volumes/methlab_data/HBN/EEG-ET/NDARBL532FPT/NDARBL532FPT_Video-TP_Samples_ET.mat, Present, 60, 10619257467, 10822326987, 203069520
/Volumes/methlab_data/HBN/EEG-ET/NDARBL532FPT/NDARBL532FPT_Video-WK_Samples_ET.mat, Diary, 60, 8204622188, 8322018155, 117395967
/Volumes/methlab_data/HBN/EEG-ET/NDARBL935ZUA/NDARBL935ZUA_Video1_Samples_ET.mat, Despicable, 120, 5165929531, 5336475521, 170545990
/Volumes/methlab_data/HBN/EEG-ET/NDARBL935ZUA/NDARBL935ZUA_Video2_Samples_ET.mat, Diary, 120, 5447652771, 5565041887, 117389116
/Volumes/methlab_data/HBN/EEG-ET/NDARBL935ZUA/NDARBL935ZUA_Video3_Samples_ET.mat, Fractals, 120, 5678305690, 5841292796, 162987106
/Volumes/methlab_data/HBN/EEG-ET/NDARBL935ZUA/NDARBL935ZUA_Video4_Samples_ET.mat, Present, 120, 5973224120, 6176289780, 203065660
/Volumes/methlab_data/HBN/EEG-ET/NDARBM173BJG/NDARBM173BJG_Video1_Samples_ET.mat, Diary, 60, 3605680907, 3723075918, 117395011
/Volumes/methlab_data/HBN/EEG-ET/NDARBM173BJG/NDARBM173BJG_Video3_Samples_ET.mat, Despicable, 60, 3973031481, 4143573006, 170541525
/Volumes/methlab_data/HBN/EEG-ET/NDARBM370JCB/NDARBM370JCB_Video-DM_Samples_ET.mat, Despicable, 30, 5084256999, 5254792492, 170535493
/Volumes/methlab_data/HBN/EEG-ET/NDARBM370JCB/NDARBM370JCB_Video-TP_Samples_ET.mat, Present, 30, 5559968986, 5763236587, 203267601
/Volumes/methlab_data/HBN/EEG-ET/NDARBM370JCB/NDARBM370JCB_Video-WK_Samples_ET.mat, Diary, 30, 3941158647, 4058549579, 117390932
/Volumes/methlab_data/HBN/EEG-ET/NDARBM433VER/NDARBM433VER_Video1_Samples_ET.mat, Diary, 60, 3654949167, 3772343254, 117394087
/Volumes/methlab_data/HBN/EEG-ET/NDARBM433VER/NDARBM433VER_Video2_Samples_ET.mat, Fractals, 60, 4221610157, 4384601514, 162991357
/Volumes/methlab_data/HBN/EEG-ET/NDARBM433VER/NDARBM433VER_Video3_Samples_ET.mat, Despicable, 60, 4735415739, 4905955452, 170539713
/Volumes/methlab_data/HBN/EEG-ET/NDARBM433VER/NDARBM433VER_Video4_Samples_ET.mat, Present, 60, 5244035649, 5447095354, 203059705
/Volumes/methlab_data/HBN/EEG-ET/NDARBM642JFT/NDARBM642JFT_Video1_Samples_ET.mat, Diary, 120, 3189035125, 3306431017, 117395892
/Volumes/methlab_data/HBN/EEG-ET/NDARBM642JFT/NDARBM642JFT_Video2_Samples_ET.mat, Fractals, 120, 4125457465, 4288444970, 162987505
/Volumes/methlab_data/HBN/EEG-ET/NDARBM642JFT/NDARBM642JFT_Video3_Samples_ET.mat, Despicable, 120, 4674574392, 4845121975, 170547583
/Volumes/methlab_data/HBN/EEG-ET/NDARBM642JFT/NDARBM642JFT_Video4_Samples_ET.mat, Present, 120, 5366513811, 5569575343, 203061532
/Volumes/methlab_data/HBN/EEG-ET/NDARBM764KG0/NDARBM764KG0_Video-DM_Samples_ET.mat, Despicable, 60, 3448403024, 3618955643, 170552619
/Volumes/methlab_data/HBN/EEG-ET/NDARBM764KG0/NDARBM764KG0_Video-FF_Samples_ET.mat, Fractals, 60, 4740549586, 4903539845, 162990259
/Volumes/methlab_data/HBN/EEG-ET/NDARBM764KG0/NDARBM764KG0_Video-TP_Samples_ET.mat, Present, 60, 5280989684, 5484051266, 203061582
/Volumes/methlab_data/HBN/EEG-ET/NDARBM764KG0/NDARBM764KG0_Video-WK_Samples_ET.mat, Diary, 60, 4294194014, 4411588015, 117394001
/Volumes/methlab_data/HBN/EEG-ET/NDARBM839WR5/NDARBM839WR5_Video1_Samples_ET.mat, Diary, 120, 3093469730, 3210866488, 117396758
/Volumes/methlab_data/HBN/EEG-ET/NDARBM839WR5/NDARBM839WR5_Video2_Samples_ET.mat, Fractals, 120, 4421589950, 4584588254, 162998304
/Volumes/methlab_data/HBN/EEG-ET/NDARBM839WR5/NDARBM839WR5_Video3_Samples_ET.mat, Despicable, 120, 4929746376, 5100286655, 170540279
/Volumes/methlab_data/HBN/EEG-ET/NDARBM839WR5/NDARBM839WR5_Video4_Samples_ET.mat, Present, 120, 5662732506, 5865799194, 203066688
/Volumes/methlab_data/HBN/EEG-ET/NDARBN100LCD/NDARBN100LCD_Video1_Samples_ET.mat, Diary, 60, 3314678733, 3432076590, 117397857
/Volumes/methlab_data/HBN/EEG-ET/NDARBN100LCD/NDARBN100LCD_Video3_Samples_ET.mat, Despicable, 60, 4784667925, 4955221304, 170553379
/Volumes/methlab_data/HBN/EEG-ET/NDARBN620TT7/NDARBN620TT7_Video-DM_Samples_ET.mat, Despicable, 120, 7792588303, 7963133720, 170545417
/Volumes/methlab_data/HBN/EEG-ET/NDARBN620TT7/NDARBN620TT7_Video-FF_Samples_ET.mat, Fractals, 120, 7072051825, 7235038357, 162986532
/Volumes/methlab_data/HBN/EEG-ET/NDARBN620TT7/NDARBN620TT7_Video-TP_Samples_ET.mat, Present, 120, 8861401035, 9064468098, 203067063
/Volumes/methlab_data/HBN/EEG-ET/NDARBN620TT7/NDARBN620TT7_Video-WK_Samples_ET.mat, Diary, 120, 8241313428, 8358711686, 117398258
/Volumes/methlab_data/HBN/EEG-ET/NDARBP398JHL/NDARBP398JHL_Video-DM_Samples_ET.mat, Despicable, 60, 4281322028, 4451858734, 170536706
/Volumes/methlab_data/HBN/EEG-ET/NDARBP398JHL/NDARBP398JHL_Video-TP_Samples_ET.mat, Present, 60, 5618778447, 5822059319, 203280872
/Volumes/methlab_data/HBN/EEG-ET/NDARBP398JHL/NDARBP398JHL_Video-WK_Samples_ET.mat, Diary, 60, 3572118198, 3689507269, 117389071
/Volumes/methlab_data/HBN/EEG-ET/NDARBP527JWC/NDARBP527JWC_Video-DM_Samples_ET.mat, Despicable, 60, 2295053276, 2465602641, 170549365
/Volumes/methlab_data/HBN/EEG-ET/NDARBP527JWC/NDARBP527JWC_Video-TP_Samples_ET.mat, Present, 60, 3023214056, 3226495557, 203281501
/Volumes/methlab_data/HBN/EEG-ET/NDARBP527JWC/NDARBP527JWC_Video-WK_Samples_ET.mat, Diary, 60, 2824596915, 2941983747, 117386832
/Volumes/methlab_data/HBN/EEG-ET/NDARBP681MTT/NDARBP681MTT_Video-DM_Samples_ET.mat, Despicable, 120, 3634373900, 3804921179, 170547279
/Volumes/methlab_data/HBN/EEG-ET/NDARBP681MTT/NDARBP681MTT_Video-FF_Samples_ET.mat, Fractals, 120, 2538149603, 2701136886, 162987283
/Volumes/methlab_data/HBN/EEG-ET/NDARBP681MTT/NDARBP681MTT_Video-TP_Samples_ET.mat, Present, 120, 4293099468, 4496166854, 203067386
/Volumes/methlab_data/HBN/EEG-ET/NDARBP681MTT/NDARBP681MTT_Video-WK_Samples_ET.mat, Diary, 120, 3211015694, 3328413032, 117397338
/Volumes/methlab_data/HBN/EEG-ET/NDARBP770MUM/NDARBP770MUM_Video-DM_Samples_ET.mat, Despicable, 120, 3647230192, 3817777457, 170547265
/Volumes/methlab_data/HBN/EEG-ET/NDARBP770MUM/NDARBP770MUM_Video-FF_Samples_ET.mat, Fractals, 120, 2847825200, 3010812216, 162987016
/Volumes/methlab_data/HBN/EEG-ET/NDARBP770MUM/NDARBP770MUM_Video-TP_Samples_ET.mat, Present, 120, 4540575870, 4743641653, 203065783
/Volumes/methlab_data/HBN/EEG-ET/NDARBP770MUM/NDARBP770MUM_Video-WK_Samples_ET.mat, Diary, 120, 3997367624, 4114775344, 117407720
/Volumes/methlab_data/HBN/EEG-ET/NDARBP894XHG/NDARBP894XHG_Video1_Samples_ET.mat, Diary, 120, 4455596555, 4572994072, 117397517
/Volumes/methlab_data/HBN/EEG-ET/NDARBP894XHG/NDARBP894XHG_Video2_Samples_ET.mat, Despicable, 120, 5437080890, 5607627330, 170546440
/Volumes/methlab_data/HBN/EEG-ET/NDARBP894XHG/NDARBP894XHG_Video3_Samples_ET.mat, Fractals, 120, 5894187000, 6057171908, 162984908
/Volumes/methlab_data/HBN/EEG-ET/NDARBR128UFP/NDARBR128UFP_Video1_Samples_ET.mat, Diary, 60, 3667902467, 3785292421, 117389954
/Volumes/methlab_data/HBN/EEG-ET/NDARBR128UFP/NDARBR128UFP_Video2_Samples_ET.mat, Fractals, 60, 4348799374, 4511789506, 162990132
/Volumes/methlab_data/HBN/EEG-ET/NDARBR128UFP/NDARBR128UFP_Video3_Samples_ET.mat, Despicable, 60, 4766732547, 4937280059, 170547512
/Volumes/methlab_data/HBN/EEG-ET/NDARBR128UFP/NDARBR128UFP_Video4_Samples_ET.mat, Present, 60, 5229024065, 5432097539, 203073474
/Volumes/methlab_data/HBN/EEG-ET/NDARBR533KJZ/NDARBR533KJZ_Video-DM_Samples_ET.mat, Despicable, 30, 5066029013, 5236566413, 170537400
/Volumes/methlab_data/HBN/EEG-ET/NDARBR533KJZ/NDARBR533KJZ_Video-TP_Samples_ET.mat, Present, 30, 5589803762, 5793093292, 203289530
/Volumes/methlab_data/HBN/EEG-ET/NDARBR533KJZ/NDARBR533KJZ_Video-WK_Samples_ET.mat, Diary, 30, 3660449772, 3777835652, 117385880
/Volumes/methlab_data/HBN/EEG-ET/NDARBR740NKV/NDARBR740NKV_Video1_Samples_ET.mat, Diary, 60, 1778605078, 1896000001, 117394923
/Volumes/methlab_data/HBN/EEG-ET/NDARBR740NKV/NDARBR740NKV_Video3_Samples_ET.mat, Despicable, 60, 801798727, 972343853, 170545126
/Volumes/methlab_data/HBN/EEG-ET/NDARBT436PMT/NDARBT436PMT_Video-DM_Samples_ET.mat, Despicable, 60, 4921274806, 5091811522, 170536716
/Volumes/methlab_data/HBN/EEG-ET/NDARBT436PMT/NDARBT436PMT_Video-TP_Samples_ET.mat, Present, 60, 5394556707, 5597829584, 203272877
/Volumes/methlab_data/HBN/EEG-ET/NDARBT436PMT/NDARBT436PMT_Video-WK_Samples_ET.mat, Diary, 60, 3663115507, 3780502609, 117387102
/Volumes/methlab_data/HBN/EEG-ET/NDARBT607PZL/NDARBT607PZL_Video1_Samples_ET.mat, Diary, 60, 2790332783, 2907721755, 117388972
/Volumes/methlab_data/HBN/EEG-ET/NDARBT607PZL/NDARBT607PZL_Video3_Samples_ET.mat, Despicable, 60, 2568571064, 2739120613, 170549549
/Volumes/methlab_data/HBN/EEG-ET/NDARBT607PZL/NDARBT607PZL_Video4_Samples_ET.mat, Present, 60, 3155353723, 3358422225, 203068502
/Volumes/methlab_data/HBN/EEG-ET/NDARBT640EBN/NDARBT640EBN_Video1_Samples_ET.mat, Diary, 60, 4909158855, 5026547868, 117389013
/Volumes/methlab_data/HBN/EEG-ET/NDARBT640EBN/NDARBT640EBN_Video3_Samples_ET.mat, Despicable, 60, 4494157463, 4664700034, 170542571
/Volumes/methlab_data/HBN/EEG-ET/NDARBT640EBN/NDARBT640EBN_Video4_Samples_ET.mat, Present, 60, 5317580613, 5520643218, 203062605
/Volumes/methlab_data/HBN/EEG-ET/NDARBT747UHM/NDARBT747UHM_Video1_Samples_ET.mat, Diary, 120, 3129080476, 3246468894, 117388418
/Volumes/methlab_data/HBN/EEG-ET/NDARBT747UHM/NDARBT747UHM_Video2_Samples_ET.mat, Fractals, 120, 4553170880, 4716168664, 162997784
/Volumes/methlab_data/HBN/EEG-ET/NDARBT747UHM/NDARBT747UHM_Video3_Samples_ET.mat, Despicable, 120, 5111028174, 5281575662, 170547488
/Volumes/methlab_data/HBN/EEG-ET/NDARBU098PJT/NDARBU098PJT_Video1_Samples_ET.mat, Diary, 120, 3742949087, 3860336996, 117387909
/Volumes/methlab_data/HBN/EEG-ET/NDARBU098PJT/NDARBU098PJT_Video2_Samples_ET.mat, Fractals, 120, 4736604546, 4899592488, 162987942
/Volumes/methlab_data/HBN/EEG-ET/NDARBU098PJT/NDARBU098PJT_Video3_Samples_ET.mat, Despicable, 120, 5185242424, 5355790280, 170547856
/Volumes/methlab_data/HBN/EEG-ET/NDARBU098PJT/NDARBU098PJT_Video4_Samples_ET.mat, Present, 120, 5778519956, 5981587187, 203067231
/Volumes/methlab_data/HBN/EEG-ET/NDARBU112XZE/NDARBU112XZE_Video1_Samples_ET.mat, Diary, 60, 2286955761, 2404348890, 117393129
/Volumes/methlab_data/HBN/EEG-ET/NDARBU112XZE/NDARBU112XZE_Video3_Samples_ET.mat, Despicable, 60, 3476888204, 3647431024, 170542820
/Volumes/methlab_data/HBN/EEG-ET/NDARBU183TDJ/NDARBU183TDJ_Video-DM_Samples_ET.mat, Despicable, 30, 3509974924, 3680511560, 170536636
/Volumes/methlab_data/HBN/EEG-ET/NDARBU183TDJ/NDARBU183TDJ_Video-TP_Samples_ET.mat, Present, 30, 4093738796, 4297006572, 203267776
/Volumes/methlab_data/HBN/EEG-ET/NDARBU183TDJ/NDARBU183TDJ_Video-WK_Samples_ET.mat, Diary, 30, 2362525372, 2479913405, 117388033
/Volumes/methlab_data/HBN/EEG-ET/NDARBU532YXZ/NDARBU532YXZ_Video1_Samples_ET.mat, Diary, 120, 3508898573, 3626296191, 117397618
/Volumes/methlab_data/HBN/EEG-ET/NDARBU532YXZ/NDARBU532YXZ_Video2_Samples_ET.mat, Fractals, 120, 4412533290, 4575520074, 162986784
/Volumes/methlab_data/HBN/EEG-ET/NDARBU532YXZ/NDARBU532YXZ_Video3_Samples_ET.mat, Despicable, 120, 4969829957, 5140377487, 170547530
/Volumes/methlab_data/HBN/EEG-ET/NDARBU532YXZ/NDARBU532YXZ_Video4_Samples_ET.mat, Present, 120, 5705647131, 5908708664, 203061533
/Volumes/methlab_data/HBN/EEG-ET/NDARBU607ZZ3/NDARBU607ZZ3_Video1_Samples_ET.mat, Diary, 60, 7638071839, 7755457908, 117386069
/Volumes/methlab_data/HBN/EEG-ET/NDARBU607ZZ3/NDARBU607ZZ3_Video3_Samples_ET.mat, Despicable, 60, 7159097902, 7329646605, 170548703
/Volumes/methlab_data/HBN/EEG-ET/NDARBU668NTV/NDARBU668NTV_Video1_Samples_ET.mat, Diary, 120, 4174871302, 4292267675, 117396373
/Volumes/methlab_data/HBN/EEG-ET/NDARBU668NTV/NDARBU668NTV_Video2_Samples_ET.mat, Fractals, 120, 5428373621, 5591360433, 162986812
/Volumes/methlab_data/HBN/EEG-ET/NDARBU668NTV/NDARBU668NTV_Video3_Samples_ET.mat, Despicable, 120, 5972329681, 6142877501, 170547820
/Volumes/methlab_data/HBN/EEG-ET/NDARBU668NTV/NDARBU668NTV_Video4_Samples_ET.mat, Present, 120, 6605526128, 6808595934, 203069806
/Volumes/methlab_data/HBN/EEG-ET/NDARBU730PN8/NDARBU730PN8_Video1_Samples_ET.mat, Diary, 60, 3655906953, 3773296876, 117389923
/Volumes/methlab_data/HBN/EEG-ET/NDARBU730PN8/NDARBU730PN8_Video3_Samples_ET.mat, Despicable, 60, 4036572799, 4207122273, 170549474
/Volumes/methlab_data/HBN/EEG-ET/NDARBU757VJK/NDARBU757VJK_Video1_Samples_ET.mat, Despicable, 120, 3087094353, 3257641445, 170547092
/Volumes/methlab_data/HBN/EEG-ET/NDARBU757VJK/NDARBU757VJK_Video2_Samples_ET.mat, Diary, 120, 4703974910, 4821371408, 117396498
/Volumes/methlab_data/HBN/EEG-ET/NDARBU757VJK/NDARBU757VJK_Video3_Samples_ET.mat, Fractals, 120, 5173992910, 5336988480, 162995570
/Volumes/methlab_data/HBN/EEG-ET/NDARBU757VJK/NDARBU757VJK_Video4_Samples_ET.mat, Present, 120, 5865767068, 6068835325, 203068257
/Volumes/methlab_data/HBN/EEG-ET/NDARBU928LV0/NDARBU928LV0_Video1_Samples_ET.mat, Diary, 60, 5929806097, 6047201105, 117395008
/Volumes/methlab_data/HBN/EEG-ET/NDARBU928LV0/NDARBU928LV0_Video3_Samples_ET.mat, Despicable, 60, 5505580339, 5676122871, 170542532
/Volumes/methlab_data/HBN/EEG-ET/NDARBU928LV0/NDARBU928LV0_Video4_Samples_ET.mat, Present, 60, 6367289245, 6570353777, 203064532
/Volumes/methlab_data/HBN/EEG-ET/NDARBV059CGE/NDARBV059CGE_Video1_Samples_ET.mat, Diary, 120, 3408863583, 3526261005, 117397422
/Volumes/methlab_data/HBN/EEG-ET/NDARBV059CGE/NDARBV059CGE_Video2_Samples_ET.mat, Fractals, 120, 4541487418, 4704473919, 162986501
/Volumes/methlab_data/HBN/EEG-ET/NDARBV059CGE/NDARBV059CGE_Video3_Samples_ET.mat, Despicable, 120, 5093375061, 5263921931, 170546870
/Volumes/methlab_data/HBN/EEG-ET/NDARBV059CGE/NDARBV059CGE_Video4_Samples_ET.mat, Present, 120, 5780650194, 5983717476, 203067282
/Volumes/methlab_data/HBN/EEG-ET/NDARBV167RMU/NDARBV167RMU_Video1_Samples_ET.mat, Fractals, 120, 5174880391, 5337876166, 162995775
/Volumes/methlab_data/HBN/EEG-ET/NDARBV167RMU/NDARBV167RMU_Video2_Samples_ET.mat, Despicable, 120, 6032384842, 6202931860, 170547018
/Volumes/methlab_data/HBN/EEG-ET/NDARBV167RMU/NDARBV167RMU_Video3_Samples_ET.mat, Diary, 120, 6562255901, 6679649211, 117393310
/Volumes/methlab_data/HBN/EEG-ET/NDARBV167RMU/NDARBV167RMU_Video4_Samples_ET.mat, Present, 120, 7185419441, 7388485995, 203066554
/Volumes/methlab_data/HBN/EEG-ET/NDARBV364MBC/NDARBV364MBC_Video1_Samples_ET.mat, Diary, 60, 3707686182, 3825072567, 117386385
/Volumes/methlab_data/HBN/EEG-ET/NDARBV364MBC/NDARBV364MBC_Video3_Samples_ET.mat, Despicable, 60, 3491246502, 3661788772, 170542270
/Volumes/methlab_data/HBN/EEG-ET/NDARBV630BK6/NDARBV630BK6_Video-DM_Samples_ET.mat, Despicable, 60, 3020052311, 3190600962, 170548651
/Volumes/methlab_data/HBN/EEG-ET/NDARBV630BK6/NDARBV630BK6_Video-FF_Samples_ET.mat, Fractals, 60, 1875095836, 2038083087, 162987251
/Volumes/methlab_data/HBN/EEG-ET/NDARBV630BK6/NDARBV630BK6_Video-TP_Samples_ET.mat, Present, 60, 3512346389, 3715404950, 203058561
/Volumes/methlab_data/HBN/EEG-ET/NDARBV630BK6/NDARBV630BK6_Video-WK_Samples_ET.mat, Diary, 60, 2579490838, 2696876884, 117386046
/Volumes/methlab_data/HBN/EEG-ET/NDARBV680AA8/NDARBV680AA8_Video1_Samples_ET.mat, Diary, 60, 367188074, 484588812, 117400738
/Volumes/methlab_data/HBN/EEG-ET/NDARBV680AA8/NDARBV680AA8_Video3_Samples_ET.mat, Despicable, 60, 754203492, 924756058, 170552566
/Volumes/methlab_data/HBN/EEG-ET/NDARBW026UGE/NDARBW026UGE_Video-DM_Samples_ET.mat, Despicable, 60, 5174724433, 5345267854, 170543421
/Volumes/methlab_data/HBN/EEG-ET/NDARBW026UGE/NDARBW026UGE_Video-FF_Samples_ET.mat, Fractals, 60, 4282398154, 4445376235, 162978081
/Volumes/methlab_data/HBN/EEG-ET/NDARBW026UGE/NDARBW026UGE_Video-TP_Samples_ET.mat, Present, 60, 6048136007, 6251231405, 203095398
/Volumes/methlab_data/HBN/EEG-ET/NDARBW026UGE/NDARBW026UGE_Video-WK_Samples_ET.mat, Diary, 60, 5612509483, 5729903391, 117393908
/Volumes/methlab_data/HBN/EEG-ET/NDARBW255JE1/NDARBW255JE1_Video-DM_Samples_ET.mat, Despicable, 120, 4889369448, 5059917059, 170547611
/Volumes/methlab_data/HBN/EEG-ET/NDARBW255JE1/NDARBW255JE1_Video-FF_Samples_ET.mat, Fractals, 120, 5196307952, 5359294350, 162986398
/Volumes/methlab_data/HBN/EEG-ET/NDARBW255JE1/NDARBW255JE1_Video-TP_Samples_ET.mat, Present, 120, 6378149546, 6581216832, 203067286
/Volumes/methlab_data/HBN/EEG-ET/NDARBW255JE1/NDARBW255JE1_Video-WK_Samples_ET.mat, Diary, 120, 5499325949, 5616722632, 117396683
/Volumes/methlab_data/HBN/EEG-ET/NDARBW262RV7/NDARBW262RV7_Video-DM_Samples_ET.mat, Despicable, 60, 6479910568, 6650449330, 170538762
/Volumes/methlab_data/HBN/EEG-ET/NDARBW262RV7/NDARBW262RV7_Video-TP_Samples_ET.mat, Present, 60, 6957059394, 7160326309, 203266915
/Volumes/methlab_data/HBN/EEG-ET/NDARBW262RV7/NDARBW262RV7_Video-WK_Samples_ET.mat, Diary, 60, 5188263201, 5305665255, 117402054
/Volumes/methlab_data/HBN/EEG-ET/NDARBW268XPY/NDARBW268XPY_Video-DM_Samples_ET.mat, Despicable, 30, 2660618192, 2831163944, 170545752
/Volumes/methlab_data/HBN/EEG-ET/NDARBW268XPY/NDARBW268XPY_Video-TP_Samples_ET.mat, Present, 30, 3755988696, 3959264624, 203275928
/Volumes/methlab_data/HBN/EEG-ET/NDARBW268XPY/NDARBW268XPY_Video-WK_Samples_ET.mat, Diary, 30, 3193432429, 3310818541, 117386112
/Volumes/methlab_data/HBN/EEG-ET/NDARBW525JHY/NDARBW525JHY_Video-DM_Samples_ET.mat, Despicable, 60, 2008363133, 2178917909, 170554776
/Volumes/methlab_data/HBN/EEG-ET/NDARBW525JHY/NDARBW525JHY_Video-FF_Samples_ET.mat, Fractals, 60, 2507037188, 2670022627, 162985439
/Volumes/methlab_data/HBN/EEG-ET/NDARBW525JHY/NDARBW525JHY_Video-TP_Samples_ET.mat, Present, 60, 2989871028, 3192935824, 203064796
/Volumes/methlab_data/HBN/EEG-ET/NDARBW525JHY/NDARBW525JHY_Video-WK_Samples_ET.mat, Diary, 60, 2341092707, 2458487856, 117395149
/Volumes/methlab_data/HBN/EEG-ET/NDARBW971DCW/NDARBW971DCW_Video-DM_Samples_ET.mat, Despicable, 30, 5447433355, 5617972146, 170538791
/Volumes/methlab_data/HBN/EEG-ET/NDARBW971DCW/NDARBW971DCW_Video-TP_Samples_ET.mat, Present, 30, 6078097060, 6281364077, 203267017
/Volumes/methlab_data/HBN/EEG-ET/NDARBW971DCW/NDARBW971DCW_Video-WK_Samples_ET.mat, Diary, 30, 3933895239, 4051284425, 117389186
/Volumes/methlab_data/HBN/EEG-ET/NDARBX121UM9/NDARBX121UM9_Video1_Samples_ET.mat, Diary, 60, 3310531344, 3427921467, 117390123
/Volumes/methlab_data/HBN/EEG-ET/NDARBX121UM9/NDARBX121UM9_Video3_Samples_ET.mat, Despicable, 60, 4387915112, 4558456876, 170541764
/Volumes/methlab_data/HBN/EEG-ET/NDARBX400RTC/NDARBX400RTC_Video1_Samples_ET.mat, Diary, 60, 1848044811, 1965435433, 117390622
/Volumes/methlab_data/HBN/EEG-ET/NDARBX400RTC/NDARBX400RTC_Video3_Samples_ET.mat, Despicable, 60, 1607337402, 1777892881, 170555479
/Volumes/methlab_data/HBN/EEG-ET/NDARBX830ZD4/NDARBX830ZD4_Video-WK_Samples_ET.mat, Diary, 120, 4791690026, 4909086409, 117396383
/Volumes/methlab_data/HBN/EEG-ET/NDARBX974XDR/NDARBX974XDR_Video1_Samples_ET.mat, Diary, 120, 4002638664, 4120024778, 117386114
/Volumes/methlab_data/HBN/EEG-ET/NDARBX974XDR/NDARBX974XDR_Video2_Samples_ET.mat, Fractals, 120, 5923347750, 6086335531, 162987781
/Volumes/methlab_data/HBN/EEG-ET/NDARBX974XDR/NDARBX974XDR_Video3_Samples_ET.mat, Despicable, 120, 6452705255, 6623252425, 170547170
/Volumes/methlab_data/HBN/EEG-ET/NDARBX974XDR/NDARBX974XDR_Video4_Samples_ET.mat, Present, 120, 7156660633, 7359738124, 203077491
/Volumes/methlab_data/HBN/EEG-ET/NDARBY518PRN/NDARBY518PRN_Video1_Samples_ET.mat, Diary, 60, 761514970, 878898465, 117383495
/Volumes/methlab_data/HBN/EEG-ET/NDARBY518PRN/NDARBY518PRN_Video3_Samples_ET.mat, Despicable, 60, 517594534, 688137822, 170543288
/Volumes/methlab_data/HBN/EEG-ET/NDARBZ216FW8/NDARBZ216FW8_Video1_Samples_ET.mat, Diary, 60, 747520280, 864916141, 117395861
/Volumes/methlab_data/HBN/EEG-ET/NDARBZ216FW8/NDARBZ216FW8_Video3_Samples_ET.mat, Despicable, 60, 302644384, 473196733, 170552349
/Volumes/methlab_data/HBN/EEG-ET/NDARBZ444ZHK/NDARBZ444ZHK_Video-DM_Samples_ET.mat, Despicable, 30, 3313278681, 3483817596, 170538915
/Volumes/methlab_data/HBN/EEG-ET/NDARBZ444ZHK/NDARBZ444ZHK_Video-WK_Samples_ET.mat, Diary, 30, 2036469835, 2153870040, 117400205
/Volumes/methlab_data/HBN/EEG-ET/NDARBZ475NKK/NDARBZ475NKK_Video-DM_Samples_ET.mat, Despicable, 60, 3799778750, 3970320228, 170541478
/Volumes/methlab_data/HBN/EEG-ET/NDARBZ475NKK/NDARBZ475NKK_Video-FF_Samples_ET.mat, Fractals, 60, 3563946192, 3726938338, 162992146
/Volumes/methlab_data/HBN/EEG-ET/NDARBZ475NKK/NDARBZ475NKK_Video-TP_Samples_ET.mat, Present, 60, 4236202012, 4439264613, 203062601
/Volumes/methlab_data/HBN/EEG-ET/NDARBZ475NKK/NDARBZ475NKK_Video-WK_Samples_ET.mat, Diary, 60, 4062717466, 4180113364, 117395898
/Volumes/methlab_data/HBN/EEG-ET/NDARBZ913ZB9/NDARBZ913ZB9_Video1_Samples_ET.mat, Diary, 120, 2593783314, 2711171076, 117387762
/Volumes/methlab_data/HBN/EEG-ET/NDARBZ913ZB9/NDARBZ913ZB9_Video2_Samples_ET.mat, Fractals, 120, 3582787937, 3745775513, 162987576
/Volumes/methlab_data/HBN/EEG-ET/NDARBZ913ZB9/NDARBZ913ZB9_Video3_Samples_ET.mat, Despicable, 120, 4033924502, 4204472167, 170547665
/Volumes/methlab_data/HBN/EEG-ET/NDARBZ925PRF/NDARBZ925PRF_Video-DM_Samples_ET.mat, Despicable, 120, 4382748418, 4553304641, 170556223
/Volumes/methlab_data/HBN/EEG-ET/NDARBZ925PRF/NDARBZ925PRF_Video-FF_Samples_ET.mat, Fractals, 120, 3520593163, 3683589554, 162996391
/Volumes/methlab_data/HBN/EEG-ET/NDARBZ925PRF/NDARBZ925PRF_Video-TP_Samples_ET.mat, Present, 120, 5430830281, 5633897852, 203067571
/Volumes/methlab_data/HBN/EEG-ET/NDARBZ925PRF/NDARBZ925PRF_Video-WK_Samples_ET.mat, Diary, 120, 4833434779, 4950832123, 117397344
/Volumes/methlab_data/HBN/EEG-ET/NDARCA050RZL/NDARCA050RZL_Video-DM_Samples_ET.mat, Despicable, 60, 5487637990, 5658175633, 170537643
/Volumes/methlab_data/HBN/EEG-ET/NDARCA050RZL/NDARCA050RZL_Video-TP_Samples_ET.mat, Present, 60, 5971701484, 6174981345, 203279861
/Volumes/methlab_data/HBN/EEG-ET/NDARCA050RZL/NDARCA050RZL_Video-WK_Samples_ET.mat, Diary, 60, 4272405989, 4389811102, 117405113
/Volumes/methlab_data/HBN/EEG-ET/NDARCA146GG1/NDARCA146GG1_Video-DM_Samples_ET.mat, Despicable, 60, 4589547260, 4760085807, 170538547
/Volumes/methlab_data/HBN/EEG-ET/NDARCA146GG1/NDARCA146GG1_Video-TP_Samples_ET.mat, Present, 60, 5547551214, 5750816876, 203265662
/Volumes/methlab_data/HBN/EEG-ET/NDARCA146GG1/NDARCA146GG1_Video-WK_Samples_ET.mat, Diary, 60, 5058373548, 5175762513, 117388965
/Volumes/methlab_data/HBN/EEG-ET/NDARCA153NKE/NDARCA153NKE_Video1_Samples_ET.mat, Diary, 60, 4168414029, 4285810019, 117395990
/Volumes/methlab_data/HBN/EEG-ET/NDARCA153NKE/NDARCA153NKE_Video3_Samples_ET.mat, Despicable, 60, 3695050180, 3865590822, 170540642
/Volumes/methlab_data/HBN/EEG-ET/NDARCA186WGH/NDARCA186WGH_Video1_Samples_ET.mat, Diary, 60, 1908810961, 2026206004, 117395043
/Volumes/methlab_data/HBN/EEG-ET/NDARCA186WGH/NDARCA186WGH_Video3_Samples_ET.mat, Despicable, 60, 3273791351, 3444332004, 170540653
/Volumes/methlab_data/HBN/EEG-ET/NDARCA578CEB/NDARCA578CEB_Video1_Samples_ET.mat, Diary, 60, 2104816852, 2222207826, 117390974
/Volumes/methlab_data/HBN/EEG-ET/NDARCA578CEB/NDARCA578CEB_Video2_Samples_ET.mat, Fractals, 60, 2690992253, 2853980501, 162988248
/Volumes/methlab_data/HBN/EEG-ET/NDARCA578CEB/NDARCA578CEB_Video3_Samples_ET.mat, Despicable, 60, 3124227547, 3294774143, 170546596
/Volumes/methlab_data/HBN/EEG-ET/NDARCA578CEB/NDARCA578CEB_Video4_Samples_ET.mat, Present, 60, 3606849765, 3809917339, 203067574
/Volumes/methlab_data/HBN/EEG-ET/NDARCA618DGA/NDARCA618DGA_Video-DM_Samples_ET.mat, Despicable, 120, 5016737088, 5187284828, 170547740
/Volumes/methlab_data/HBN/EEG-ET/NDARCA618DGA/NDARCA618DGA_Video-FF_Samples_ET.mat, Fractals, 120, 4568659661, 4731647145, 162987484
/Volumes/methlab_data/HBN/EEG-ET/NDARCA618DGA/NDARCA618DGA_Video-TP_Samples_ET.mat, Present, 120, 5643223627, 5846291359, 203067732
/Volumes/methlab_data/HBN/EEG-ET/NDARCA618DGA/NDARCA618DGA_Video-WK_Samples_ET.mat, Diary, 120, 3754791174, 3872179820, 117388646
/Volumes/methlab_data/HBN/EEG-ET/NDARCA740UC8/NDARCA740UC8_Video1_Samples_ET.mat, Diary, 60, 4495496361, 4612882308, 117385947
/Volumes/methlab_data/HBN/EEG-ET/NDARCA740UC8/NDARCA740UC8_Video2_Samples_ET.mat, Fractals, 60, 3138724094, 3301712239, 162988145
/Volumes/methlab_data/HBN/EEG-ET/NDARCA740UC8/NDARCA740UC8_Video3_Samples_ET.mat, Despicable, 60, 3943577561, 4114120030, 170542469
/Volumes/methlab_data/HBN/EEG-ET/NDARCA740UC8/NDARCA740UC8_Video4_Samples_ET.mat, Present, 60, 4955986608, 5159055054, 203068446
/Volumes/methlab_data/HBN/EEG-ET/NDARCA789EE0/NDARCA789EE0_Video1_Samples_ET.mat, Diary, 60, 1710680969, 1828071274, 117390305
/Volumes/methlab_data/HBN/EEG-ET/NDARCA789EE0/NDARCA789EE0_Video3_Samples_ET.mat, Despicable, 60, 1285043271, 1455593153, 170549882
/Volumes/methlab_data/HBN/EEG-ET/NDARCB142ZPB/NDARCB142ZPB_Video-DM_Samples_ET.mat, Despicable, 60, 1187685315, 1358228780, 170543465
/Volumes/methlab_data/HBN/EEG-ET/NDARCB142ZPB/NDARCB142ZPB_Video-FF_Samples_ET.mat, Fractals, 60, 1783863754, 1946847682, 162983928
/Volumes/methlab_data/HBN/EEG-ET/NDARCB142ZPB/NDARCB142ZPB_Video-TP_Samples_ET.mat, Present, 60, 2548946135, 2752006563, 203060428
/Volumes/methlab_data/HBN/EEG-ET/NDARCB142ZPB/NDARCB142ZPB_Video-WK_Samples_ET.mat, Diary, 60, 1474543912, 1591937838, 117393926
/Volumes/methlab_data/HBN/EEG-ET/NDARCB305AFY/NDARCB305AFY_Video-DM_Samples_ET.mat, Despicable, 30, 4464610560, 4635146971, 170536411
/Volumes/methlab_data/HBN/EEG-ET/NDARCB305AFY/NDARCB305AFY_Video-TP_Samples_ET.mat, Present, 30, 4945416982, 5148694496, 203277514
/Volumes/methlab_data/HBN/EEG-ET/NDARCB305AFY/NDARCB305AFY_Video-WK_Samples_ET.mat, Diary, 30, 3091525258, 3208916149, 117390891
/Volumes/methlab_data/HBN/EEG-ET/NDARCB370UK4/NDARCB370UK4_Video1_Samples_ET.mat, Diary, 60, 2363297098, 2480688917, 117391819
/Volumes/methlab_data/HBN/EEG-ET/NDARCB370UK4/NDARCB370UK4_Video3_Samples_ET.mat, Despicable, 60, 2135896732, 2306436013, 170539281
/Volumes/methlab_data/HBN/EEG-ET/NDARCB504PGG/NDARCB504PGG_Video-DM_Samples_ET.mat, Despicable, 60, 3451174643, 3621709258, 170534615
/Volumes/methlab_data/HBN/EEG-ET/NDARCB504PGG/NDARCB504PGG_Video-TP_Samples_ET.mat, Present, 60, 3927987991, 4131268845, 203280854
/Volumes/methlab_data/HBN/EEG-ET/NDARCB504PGG/NDARCB504PGG_Video-WK_Samples_ET.mat, Diary, 60, 3058144446, 3175534539, 117390093
/Volumes/methlab_data/HBN/EEG-ET/NDARCB627KDN/NDARCB627KDN_Video-DM_Samples_ET.mat, Despicable, 60, 4129955437, 4300500869, 170545432
/Volumes/methlab_data/HBN/EEG-ET/NDARCB627KDN/NDARCB627KDN_Video-FF_Samples_ET.mat, Fractals, 60, 4776257916, 4939246040, 162988124
/Volumes/methlab_data/HBN/EEG-ET/NDARCB627KDN/NDARCB627KDN_Video-TP_Samples_ET.mat, Present, 60, 5327313101, 5530377550, 203064449
/Volumes/methlab_data/HBN/EEG-ET/NDARCB627KDN/NDARCB627KDN_Video-WK_Samples_ET.mat, Diary, 60, 3412655807, 3530046737, 117390930
/Volumes/methlab_data/HBN/EEG-ET/NDARCB959FYA/NDARCB959FYA_Video1_Samples_ET.mat, Diary, 60, 2781555745, 2898948442, 117392697
/Volumes/methlab_data/HBN/EEG-ET/NDARCB959FYA/NDARCB959FYA_Video3_Samples_ET.mat, Despicable, 60, 4031188506, 4201735073, 170546567
/Volumes/methlab_data/HBN/EEG-ET/NDARCC059WTH/NDARCC059WTH_Video-DM_Samples_ET.mat, Despicable, 60, 5369574306, 5540125092, 170550786
/Volumes/methlab_data/HBN/EEG-ET/NDARCC059WTH/NDARCC059WTH_Video-FF_Samples_ET.mat, Fractals, 60, 4858523526, 5021510905, 162987379
/Volumes/methlab_data/HBN/EEG-ET/NDARCC059WTH/NDARCC059WTH_Video-TP_Samples_ET.mat, Present, 60, 5987710038, 6190778725, 203068687
/Volumes/methlab_data/HBN/EEG-ET/NDARCC059WTH/NDARCC059WTH_Video-WK_Samples_ET.mat, Diary, 60, 4087145372, 4204535507, 117390135
/Volumes/methlab_data/HBN/EEG-ET/NDARCC101PA9/NDARCC101PA9_Video-WK_Samples_ET.mat, Diary, 60, 2574934389, 2692329350, 117394961
/Volumes/methlab_data/HBN/EEG-ET/NDARCC140AAK/NDARCC140AAK_Video1_Samples_ET.mat, Diary, 120, 7165177446, 7282574077, 117396631
/Volumes/methlab_data/HBN/EEG-ET/NDARCC140AAK/NDARCC140AAK_Video2_Samples_ET.mat, Fractals, 120, 8195410352, 8358397552, 162987200
/Volumes/methlab_data/HBN/EEG-ET/NDARCC140AAK/NDARCC140AAK_Video3_Samples_ET.mat, Despicable, 120, 8624918285, 8795464911, 170546626
/Volumes/methlab_data/HBN/EEG-ET/NDARCC140AAK/NDARCC140AAK_Video4_Samples_ET.mat, Present, 120, 9262704587, 9465771771, 203067184
/Volumes/methlab_data/HBN/EEG-ET/NDARCC340ER5/NDARCC340ER5_Video1_Samples_ET.mat, Diary, 60, 4890201097, 5007596214, 117395117
/Volumes/methlab_data/HBN/EEG-ET/NDARCC340ER5/NDARCC340ER5_Video2_Samples_ET.mat, Fractals, 60, 5805533804, 5968526191, 162992387
/Volumes/methlab_data/HBN/EEG-ET/NDARCC340ER5/NDARCC340ER5_Video3_Samples_ET.mat, Despicable, 60, 6240587675, 6411134387, 170546712
/Volumes/methlab_data/HBN/EEG-ET/NDARCC340ER5/NDARCC340ER5_Video4_Samples_ET.mat, Present, 60, 6735923191, 6938995920, 203072729
/Volumes/methlab_data/HBN/EEG-ET/NDARCC620ZFT/NDARCC620ZFT_Video-DM_Samples_ET.mat, Despicable, 60, 340819015, 511360911, 170541896
/Volumes/methlab_data/HBN/EEG-ET/NDARCC620ZFT/NDARCC620ZFT_Video-FF_Samples_ET.mat, Fractals, 60, 2176025421, 2339004851, 162979430
/Volumes/methlab_data/HBN/EEG-ET/NDARCC620ZFT/NDARCC620ZFT_Video-TP_Samples_ET.mat, Present, 60, 2101349451, 2304411236, 203061785
/Volumes/methlab_data/HBN/EEG-ET/NDARCC620ZFT/NDARCC620ZFT_Video-WK_Samples_ET.mat, Diary, 60, 1041704226, 1159098360, 117394134
/Volumes/methlab_data/HBN/EEG-ET/NDARCC824FCL/NDARCC824FCL_Video-DM_Samples_ET.mat, Despicable, 60, 4545916464, 4716456920, 170540456
/Volumes/methlab_data/HBN/EEG-ET/NDARCC824FCL/NDARCC824FCL_Video-FF_Samples_ET.mat, Fractals, 60, 4072724246, 4235715396, 162991150
/Volumes/methlab_data/HBN/EEG-ET/NDARCC824FCL/NDARCC824FCL_Video-TP_Samples_ET.mat, Present, 60, 5048180206, 5251248652, 203068446
/Volumes/methlab_data/HBN/EEG-ET/NDARCC824FCL/NDARCC824FCL_Video-WK_Samples_ET.mat, Diary, 60, 3348678874, 3466072825, 117393951
/Volumes/methlab_data/HBN/EEG-ET/NDARCD182XT1/NDARCD182XT1_Video-DM_Samples_ET.mat, Despicable, 30, 3965004831, 4135541297, 170536466
/Volumes/methlab_data/HBN/EEG-ET/NDARCD296XU9/NDARCD296XU9_Video-DM_Samples_ET.mat, Despicable, 120, 5560650584, 5731195727, 170545143
/Volumes/methlab_data/HBN/EEG-ET/NDARCD296XU9/NDARCD296XU9_Video-FF_Samples_ET.mat, Fractals, 120, 5143230118, 5306222610, 162992492
/Volumes/methlab_data/HBN/EEG-ET/NDARCD296XU9/NDARCD296XU9_Video-TP_Samples_ET.mat, Present, 120, 6180762852, 6383835273, 203072421
/Volumes/methlab_data/HBN/EEG-ET/NDARCD296XU9/NDARCD296XU9_Video-WK_Samples_ET.mat, Diary, 120, 4523040320, 4640436386, 117396066
/Volumes/methlab_data/HBN/EEG-ET/NDARCD401HGZ/NDARCD401HGZ_Video1_Samples_ET.mat, Diary, 60, 1843812271, 1961206326, 117394055
/Volumes/methlab_data/HBN/EEG-ET/NDARCD401HGZ/NDARCD401HGZ_Video3_Samples_ET.mat, Despicable, 60, 3127782391, 3298322022, 170539631
/Volumes/methlab_data/HBN/EEG-ET/NDARCD453JG4/NDARCD453JG4_Video-DM_Samples_ET.mat, Despicable, 60, 3658883095, 3829425642, 170542547
/Volumes/methlab_data/HBN/EEG-ET/NDARCD453JG4/NDARCD453JG4_Video-FF_Samples_ET.mat, Fractals, 60, 3140971132, 3303956315, 162985183
/Volumes/methlab_data/HBN/EEG-ET/NDARCD453JG4/NDARCD453JG4_Video-TP_Samples_ET.mat, Present, 60, 4150698648, 4353768152, 203069504
/Volumes/methlab_data/HBN/EEG-ET/NDARCD453JG4/NDARCD453JG4_Video-WK_Samples_ET.mat, Diary, 60, 2381250280, 2498642248, 117391968
/Volumes/methlab_data/HBN/EEG-ET/NDARCD543VK6/NDARCD543VK6_Video1_Samples_ET.mat, Diary, 120, 3359677229, 3477065199, 117387970
/Volumes/methlab_data/HBN/EEG-ET/NDARCD543VK6/NDARCD543VK6_Video2_Samples_ET.mat, Fractals, 120, 4966345837, 5129333385, 162987548
/Volumes/methlab_data/HBN/EEG-ET/NDARCD543VK6/NDARCD543VK6_Video3_Samples_ET.mat, Despicable, 120, 5473322956, 5643880403, 170557447
/Volumes/methlab_data/HBN/EEG-ET/NDARCD543VK6/NDARCD543VK6_Video4_Samples_ET.mat, Present, 120, 6146707865, 6349776052, 203068187
/Volumes/methlab_data/HBN/EEG-ET/NDARCD661GL0/NDARCD661GL0_Video1_Samples_ET.mat, Diary, 60, 5470120337, 5587512617, 117392280
/Volumes/methlab_data/HBN/EEG-ET/NDARCD661GL0/NDARCD661GL0_Video2_Samples_ET.mat, Fractals, 60, 4211530617, 4374523246, 162992629
/Volumes/methlab_data/HBN/EEG-ET/NDARCD661GL0/NDARCD661GL0_Video3_Samples_ET.mat, Despicable, 60, 4981305604, 5151847616, 170542012
/Volumes/methlab_data/HBN/EEG-ET/NDARCD661GL0/NDARCD661GL0_Video4_Samples_ET.mat, Present, 60, 5906067546, 6109126617, 203059071
/Volumes/methlab_data/HBN/EEG-ET/NDARCD687JUZ/NDARCD687JUZ_Video-DM_Samples_ET.mat, Despicable, 60, 4436777325, 4607323916, 170546591
/Volumes/methlab_data/HBN/EEG-ET/NDARCD687JUZ/NDARCD687JUZ_Video-TP_Samples_ET.mat, Present, 60, 5587205679, 5790483557, 203277878
/Volumes/methlab_data/HBN/EEG-ET/NDARCD687JUZ/NDARCD687JUZ_Video-WK_Samples_ET.mat, Diary, 60, 3882551488, 3999939514, 117388026
/Volumes/methlab_data/HBN/EEG-ET/NDARCE162VRB/NDARCE162VRB_Video-DM_Samples_ET.mat, Despicable, 30, 4316368488, 4486902926, 170534438
/Volumes/methlab_data/HBN/EEG-ET/NDARCE162VRB/NDARCE162VRB_Video-WK_Samples_ET.mat, Diary, 30, 2881470544, 2998857429, 117386885
/Volumes/methlab_data/HBN/EEG-ET/NDARCE353XKH/NDARCE353XKH_Video1_Samples_ET.mat, Diary, 60, 2961424644, 3078819705, 117395061
/Volumes/methlab_data/HBN/EEG-ET/NDARCE353XKH/NDARCE353XKH_Video3_Samples_ET.mat, Despicable, 60, 3354081357, 3524625009, 170543652
/Volumes/methlab_data/HBN/EEG-ET/NDARCE368YHM/NDARCE368YHM_Video1_Samples_ET.mat, Diary, 60, 4186818077, 4304209746, 117391669
/Volumes/methlab_data/HBN/EEG-ET/NDARCE368YHM/NDARCE368YHM_Video3_Samples_ET.mat, Despicable, 60, 5464098387, 5634646637, 170548250
/Volumes/methlab_data/HBN/EEG-ET/NDARCE405PKT/NDARCE405PKT_Video-DM_Samples_ET.mat, Despicable, 60, 6780751057, 6951289623, 170538566
/Volumes/methlab_data/HBN/EEG-ET/NDARCE405PKT/NDARCE405PKT_Video-TP_Samples_ET.mat, Present, 60, 7738502170, 7941780921, 203278751
/Volumes/methlab_data/HBN/EEG-ET/NDARCE405PKT/NDARCE405PKT_Video-WK_Samples_ET.mat, Diary, 60, 7286406543, 7403795558, 117389015
/Volumes/methlab_data/HBN/EEG-ET/NDARCE721YB5/NDARCE721YB5_Video1_Samples_ET.mat, Diary, 120, 3247746286, 3365143193, 117396907
/Volumes/methlab_data/HBN/EEG-ET/NDARCE721YB5/NDARCE721YB5_Video2_Samples_ET.mat, Fractals, 120, 4735415632, 4898403786, 162988154
/Volumes/methlab_data/HBN/EEG-ET/NDARCE721YB5/NDARCE721YB5_Video3_Samples_ET.mat, Despicable, 120, 5210762964, 5381309986, 170547022
/Volumes/methlab_data/HBN/EEG-ET/NDARCE721YB5/NDARCE721YB5_Video4_Samples_ET.mat, Present, 120, 5890818684, 6093886281, 203067597
/Volumes/methlab_data/HBN/EEG-ET/NDARCF052AE0/NDARCF052AE0_Video1_Samples_ET.mat, Diary, 120, 3725099396, 3842496836, 117397440
/Volumes/methlab_data/HBN/EEG-ET/NDARCF052AE0/NDARCF052AE0_Video2_Samples_ET.mat, Fractals, 120, 4932752769, 5095739068, 162986299
/Volumes/methlab_data/HBN/EEG-ET/NDARCF052AE0/NDARCF052AE0_Video3_Samples_ET.mat, Despicable, 120, 5370350099, 5540897230, 170547131
/Volumes/methlab_data/HBN/EEG-ET/NDARCF052AE0/NDARCF052AE0_Video4_Samples_ET.mat, Present, 120, 6008307889, 6211374579, 203066690
/Volumes/methlab_data/HBN/EEG-ET/NDARCF247TDJ/NDARCF247TDJ_Video1_Samples_ET.mat, Diary, 60, 1507278445, 1624674381, 117395936
/Volumes/methlab_data/HBN/EEG-ET/NDARCF247TDJ/NDARCF247TDJ_Video3_Samples_ET.mat, Despicable, 60, 1063262891, 1233808308, 170545417
/Volumes/methlab_data/HBN/EEG-ET/NDARCG037CX4/NDARCG037CX4_Video1_Samples_ET.mat, Diary, 60, 16472727283, 16590121629, 117394346
/Volumes/methlab_data/HBN/EEG-ET/NDARCG037CX4/NDARCG037CX4_Video3_Samples_ET.mat, Despicable, 60, 17423001673, 17593545764, 170544091
/Volumes/methlab_data/HBN/EEG-ET/NDARCG037CX4/NDARCG037CX4_Video4_Samples_ET.mat, Present, 60, 17902146707, 18105209955, 203063248
/Volumes/methlab_data/HBN/EEG-ET/NDARCG073G26/NDARCG073G26_Video1_Samples_ET.mat, Diary, 60, 3410802755, 3528199614, 117396859
/Volumes/methlab_data/HBN/EEG-ET/NDARCG258NEF/NDARCG258NEF_Video-DM_Samples_ET.mat, Despicable, 120, 2951930286, 3122476643, 170546357
/Volumes/methlab_data/HBN/EEG-ET/NDARCG258NEF/NDARCG258NEF_Video-FF_Samples_ET.mat, Fractals, 120, 3395170850, 3558159063, 162988213
/Volumes/methlab_data/HBN/EEG-ET/NDARCG258NEF/NDARCG258NEF_Video-TP_Samples_ET.mat, Present, 120, 4123138251, 4326204711, 203066460
/Volumes/methlab_data/HBN/EEG-ET/NDARCG258NEF/NDARCG258NEF_Video-WK_Samples_ET.mat, Diary, 120, 2298498629, 2415895979, 117397350
/Volumes/methlab_data/HBN/EEG-ET/NDARCG438NML/NDARCG438NML_Video1_Samples_ET.mat, Diary, 60, 3173348576, 3290745370, 117396794
/Volumes/methlab_data/HBN/EEG-ET/NDARCG438NML/NDARCG438NML_Video2_Samples_ET.mat, Fractals, 60, 4270668423, 4433665727, 162997304
/Volumes/methlab_data/HBN/EEG-ET/NDARCG438NML/NDARCG438NML_Video3_Samples_ET.mat, Despicable, 60, 3824990467, 3995535152, 170544685
/Volumes/methlab_data/HBN/EEG-ET/NDARCG438NML/NDARCG438NML_Video4_Samples_ET.mat, Present, 60, 4748177100, 4951247970, 203070870
/Volumes/methlab_data/HBN/EEG-ET/NDARCG785NND/NDARCG785NND_Video-DM_Samples_ET.mat, Despicable, 120, 5650709799, 5821253516, 170543717
/Volumes/methlab_data/HBN/EEG-ET/NDARCG785NND/NDARCG785NND_Video-FF_Samples_ET.mat, Fractals, 120, 4952007923, 5115004703, 162996780
/Volumes/methlab_data/HBN/EEG-ET/NDARCG785NND/NDARCG785NND_Video-TP_Samples_ET.mat, Present, 120, 6675997366, 6879064544, 203067178
/Volumes/methlab_data/HBN/EEG-ET/NDARCG785NND/NDARCG785NND_Video-WK_Samples_ET.mat, Diary, 120, 6168995551, 6286386616, 117391065
/Volumes/methlab_data/HBN/EEG-ET/NDARCG831KUG/NDARCG831KUG_Video-DM_Samples_ET.mat, Despicable, 60, 6453776852, 6624320439, 170543587
/Volumes/methlab_data/HBN/EEG-ET/NDARCG831KUG/NDARCG831KUG_Video-FF_Samples_ET.mat, Fractals, 60, 5640317719, 5803309995, 162992276
/Volumes/methlab_data/HBN/EEG-ET/NDARCG831KUG/NDARCG831KUG_Video-TP_Samples_ET.mat, Present, 60, 7493801144, 7696862738, 203061594
/Volumes/methlab_data/HBN/EEG-ET/NDARCG831KUG/NDARCG831KUG_Video-WK_Samples_ET.mat, Diary, 60, 6939920537, 7057314563, 117394026
/Volumes/methlab_data/HBN/EEG-ET/NDARCG947ZC0/NDARCG947ZC0_Video1_Samples_ET.mat, Diary, 120, 9362823900, 9480221038, 117397138
/Volumes/methlab_data/HBN/EEG-ET/NDARCG947ZC0/NDARCG947ZC0_Video2_Samples_ET.mat, Fractals, 120, 10499320987, 10662310936, 162989949
/Volumes/methlab_data/HBN/EEG-ET/NDARCG947ZC0/NDARCG947ZC0_Video3_Samples_ET.mat, Despicable, 120, 11091254093, 11261800228, 170546135
/Volumes/methlab_data/HBN/EEG-ET/NDARCG947ZC0/NDARCG947ZC0_Video4_Samples_ET.mat, Present, 120, 11973638131, 12176705044, 203066913
/Volumes/methlab_data/HBN/EEG-ET/NDARCG984YXZ/NDARCG984YXZ_Video3_Samples_ET.mat, Despicable, 60, 3000512923, 3171055399, 170542476
/Volumes/methlab_data/HBN/EEG-ET/NDARCH001CN2/NDARCH001CN2_Video1_Samples_ET.mat, Diary, 60, 4964616569, 5082004510, 117387941
/Volumes/methlab_data/HBN/EEG-ET/NDARCH001CN2/NDARCH001CN2_Video3_Samples_ET.mat, Despicable, 60, 4400074849, 4570613324, 170538475
/Volumes/methlab_data/HBN/EEG-ET/NDARCH001CN2/NDARCH001CN2_Video4_Samples_ET.mat, Present, 60, 5394210988, 5597269435, 203058447
/Volumes/methlab_data/HBN/EEG-ET/NDARCH514JCT/NDARCH514JCT_Video-DM_Samples_ET.mat, Despicable, 120, 4902470938, 5073018561, 170547623
/Volumes/methlab_data/HBN/EEG-ET/NDARCH514JCT/NDARCH514JCT_Video-FF_Samples_ET.mat, Fractals, 120, 4473903416, 4636890780, 162987364
/Volumes/methlab_data/HBN/EEG-ET/NDARCH514JCT/NDARCH514JCT_Video-TP_Samples_ET.mat, Present, 120, 5097979581, 5301047670, 203068089
/Volumes/methlab_data/HBN/EEG-ET/NDARCH514JCT/NDARCH514JCT_Video-WK_Samples_ET.mat, Diary, 120, 3476609133, 3593998297, 117389164
/Volumes/methlab_data/HBN/EEG-ET/NDARCH755XDL/NDARCH755XDL_Video1_Samples_ET.mat, Diary, 60, 2939539376, 3056935862, 117396486
/Volumes/methlab_data/HBN/EEG-ET/NDARCH755XDL/NDARCH755XDL_Video3_Samples_ET.mat, Despicable, 60, 3945172467, 4115714767, 170542300
/Volumes/methlab_data/HBN/EEG-ET/NDARCH795JD4/NDARCH795JD4_Video-DM_Samples_ET.mat, Despicable, 60, 3925074501, 4095612941, 170538440
/Volumes/methlab_data/HBN/EEG-ET/NDARCH795JD4/NDARCH795JD4_Video-TP_Samples_ET.mat, Present, 60, 4782212853, 4985492459, 203279606
/Volumes/methlab_data/HBN/EEG-ET/NDARCH795JD4/NDARCH795JD4_Video-WK_Samples_ET.mat, Diary, 60, 4365617626, 4483007555, 117389929
/Volumes/methlab_data/HBN/EEG-ET/NDARCH838TY6/NDARCH838TY6_Video-DM_Samples_ET.mat, Despicable, 60, 3032088935, 3202630813, 170541878
/Volumes/methlab_data/HBN/EEG-ET/NDARCH838TY6/NDARCH838TY6_Video-FF_Samples_ET.mat, Fractals, 60, 2503385245, 2666378774, 162993529
/Volumes/methlab_data/HBN/EEG-ET/NDARCH838TY6/NDARCH838TY6_Video-TP_Samples_ET.mat, Present, 60, 4281289247, 4484352166, 203062919
/Volumes/methlab_data/HBN/EEG-ET/NDARCH838TY6/NDARCH838TY6_Video-WK_Samples_ET.mat, Diary, 60, 3727897038, 3845292291, 117395253
/Volumes/methlab_data/HBN/EEG-ET/NDARCH868WVX/NDARCH868WVX_Video-DM_Samples_ET.mat, Despicable, 60, 2524190237, 2694739805, 170549568
/Volumes/methlab_data/HBN/EEG-ET/NDARCH868WVX/NDARCH868WVX_Video-FF_Samples_ET.mat, Fractals, 60, 3144054317, 3307041442, 162987125
/Volumes/methlab_data/HBN/EEG-ET/NDARCH868WVX/NDARCH868WVX_Video-TP_Samples_ET.mat, Present, 60, 3638415628, 3841485133, 203069505
/Volumes/methlab_data/HBN/EEG-ET/NDARCH868WVX/NDARCH868WVX_Video-WK_Samples_ET.mat, Diary, 60, 2980988036, 3098375999, 117387963
/Volumes/methlab_data/HBN/EEG-ET/NDARCH881EFG/NDARCH881EFG_Video1_Samples_ET.mat, Diary, 60, 7908224547, 8025619460, 117394913
/Volumes/methlab_data/HBN/EEG-ET/NDARCH881EFG/NDARCH881EFG_Video3_Samples_ET.mat, Despicable, 60, 7463562486, 7634104938, 170542452
/Volumes/methlab_data/HBN/EEG-ET/NDARCH889NUF/NDARCH889NUF_Video-DM_Samples_ET.mat, Despicable, 60, 4396303320, 4566848924, 170545604
/Volumes/methlab_data/HBN/EEG-ET/NDARCH889NUF/NDARCH889NUF_Video-FF_Samples_ET.mat, Fractals, 60, 3517553405, 3680626819, 163073414
/Volumes/methlab_data/HBN/EEG-ET/NDARCH889NUF/NDARCH889NUF_Video-TP_Samples_ET.mat, Present, 60, 5285561491, 5488625215, 203063724
/Volumes/methlab_data/HBN/EEG-ET/NDARCH889NUF/NDARCH889NUF_Video-WK_Samples_ET.mat, Diary, 60, 4860266550, 4977662684, 117396134
/Volumes/methlab_data/HBN/EEG-ET/NDARCJ170CT9/NDARCJ170CT9_Video1_Samples_ET.mat, Diary, 60, 3051517721, 3168911616, 117393895
/Volumes/methlab_data/HBN/EEG-ET/NDARCJ170CT9/NDARCJ170CT9_Video3_Samples_ET.mat, Despicable, 60, 2539657385, 2710207824, 170550439
/Volumes/methlab_data/HBN/EEG-ET/NDARCJ246FJB/NDARCJ246FJB_Video-DM_Samples_ET.mat, Despicable, 60, 4517678169, 4688223860, 170545691
/Volumes/methlab_data/HBN/EEG-ET/NDARCJ246FJB/NDARCJ246FJB_Video-TP_Samples_ET.mat, Present, 60, 5004042371, 5207320181, 203277810
/Volumes/methlab_data/HBN/EEG-ET/NDARCJ246FJB/NDARCJ246FJB_Video-WK_Samples_ET.mat, Diary, 60, 3204078631, 3321464706, 117386075
/Volumes/methlab_data/HBN/EEG-ET/NDARCJ330NBP/NDARCJ330NBP_Video-DM_Samples_ET.mat, Despicable, 60, 3426293280, 3596831650, 170538370
/Volumes/methlab_data/HBN/EEG-ET/NDARCJ330NBP/NDARCJ330NBP_Video-FF_Samples_ET.mat, Fractals, 60, 2783095449, 2946084474, 162989025
/Volumes/methlab_data/HBN/EEG-ET/NDARCJ330NBP/NDARCJ330NBP_Video-TP_Samples_ET.mat, Present, 60, 4361299025, 4564369304, 203070279
/Volumes/methlab_data/HBN/EEG-ET/NDARCJ330NBP/NDARCJ330NBP_Video-WK_Samples_ET.mat, Diary, 60, 3885236109, 4002627942, 117391833
/Volumes/methlab_data/HBN/EEG-ET/NDARCJ363KLE/NDARCJ363KLE_Video1_Samples_ET.mat, Diary, 60, 2599300165, 2716696215, 117396050
/Volumes/methlab_data/HBN/EEG-ET/NDARCJ363KLE/NDARCJ363KLE_Video3_Samples_ET.mat, Despicable, 60, 3332625807, 3503169456, 170543649
/Volumes/methlab_data/HBN/EEG-ET/NDARCJ433TCG/NDARCJ433TCG_Video-DM_Samples_ET.mat, Despicable, 60, 4640727352, 4811268079, 170540727
/Volumes/methlab_data/HBN/EEG-ET/NDARCJ433TCG/NDARCJ433TCG_Video-FF_Samples_ET.mat, Fractals, 60, 4223066619, 4386062062, 162995443
/Volumes/methlab_data/HBN/EEG-ET/NDARCJ433TCG/NDARCJ433TCG_Video-TP_Samples_ET.mat, Present, 60, 5120248803, 5323310605, 203061802
/Volumes/methlab_data/HBN/EEG-ET/NDARCJ433TCG/NDARCJ433TCG_Video-WK_Samples_ET.mat, Diary, 60, 3540098090, 3657493240, 117395150
/Volumes/methlab_data/HBN/EEG-ET/NDARCJ475WJP/NDARCJ475WJP_Video1_Samples_ET.mat, Diary, 60, 3172045690, 3289442743, 117397053
/Volumes/methlab_data/HBN/EEG-ET/NDARCJ475WJP/NDARCJ475WJP_Video3_Samples_ET.mat, Despicable, 60, 2961464752, 3132011393, 170546641
/Volumes/methlab_data/HBN/EEG-ET/NDARCJ594BWQ/NDARCJ594BWQ_Video1_Samples_ET.mat, Diary, 60, 9538899759, 9656299358, 117399599
/Volumes/methlab_data/HBN/EEG-ET/NDARCJ594BWQ/NDARCJ594BWQ_Video3_Samples_ET.mat, Despicable, 60, 9099191618, 9269736086, 170544468
/Volumes/methlab_data/HBN/EEG-ET/NDARCK113CJM/NDARCK113CJM_Video-DM_Samples_ET.mat, Despicable, 30, 4212936538, 4383472960, 170536422
/Volumes/methlab_data/HBN/EEG-ET/NDARCK113CJM/NDARCK113CJM_Video-TP_Samples_ET.mat, Present, 30, 5140264180, 5343530668, 203266488
/Volumes/methlab_data/HBN/EEG-ET/NDARCK113CJM/NDARCK113CJM_Video-WK_Samples_ET.mat, Diary, 30, 3341734528, 3459122411, 117387883
/Volumes/methlab_data/HBN/EEG-ET/NDARCK647MU6/NDARCK647MU6_Video1_Samples_ET.mat, Fractals, 120, 7118270712, 7281256491, 162985779
/Volumes/methlab_data/HBN/EEG-ET/NDARCK647MU6/NDARCK647MU6_Video2_Samples_ET.mat, Despicable, 120, 7865772072, 8036319266, 170547194
/Volumes/methlab_data/HBN/EEG-ET/NDARCK647MU6/NDARCK647MU6_Video3_Samples_ET.mat, Diary, 120, 8405071781, 8522459171, 117387390
/Volumes/methlab_data/HBN/EEG-ET/NDARCK647MU6/NDARCK647MU6_Video4_Samples_ET.mat, Present, 120, 8944574657, 9147637043, 203062386
/Volumes/methlab_data/HBN/EEG-ET/NDARCK661RZ6/NDARCK661RZ6_Video-DM_Samples_ET.mat, Despicable, 60, 899490825, 1070042618, 170551793
/Volumes/methlab_data/HBN/EEG-ET/NDARCL016NHB/NDARCL016NHB_Video1_Samples_ET.mat, Diary, 120, 2878938960, 2996335804, 117396844
/Volumes/methlab_data/HBN/EEG-ET/NDARCL016NHB/NDARCL016NHB_Video2_Samples_ET.mat, Fractals, 120, 4343649781, 4506647204, 162997423
/Volumes/methlab_data/HBN/EEG-ET/NDARCL016NHB/NDARCL016NHB_Video3_Samples_ET.mat, Despicable, 120, 4831707982, 5002254801, 170546819
/Volumes/methlab_data/HBN/EEG-ET/NDARCL016NHB/NDARCL016NHB_Video4_Samples_ET.mat, Present, 120, 5547553881, 5750621317, 203067436
/Volumes/methlab_data/HBN/EEG-ET/NDARCL080RHP/NDARCL080RHP_Video1_Samples_ET.mat, Diary, 60, 1892629800, 2010020851, 117391051
/Volumes/methlab_data/HBN/EEG-ET/NDARCL080RHP/NDARCL080RHP_Video3_Samples_ET.mat, Despicable, 60, 3518575191, 3689118716, 170543525
/Volumes/methlab_data/HBN/EEG-ET/NDARCL105LUE/NDARCL105LUE_Video1_Samples_ET.mat, Diary, 60, 1300955515, 1418351489, 117395974
/Volumes/methlab_data/HBN/EEG-ET/NDARCL105LUE/NDARCL105LUE_Video3_Samples_ET.mat, Despicable, 60, 1819818793, 1990370207, 170551414
/Volumes/methlab_data/HBN/EEG-ET/NDARCL253KU1/NDARCL253KU1_Video-DM_Samples_ET.mat, Despicable, 30, 7059360741, 7229898490, 170537749
/Volumes/methlab_data/HBN/EEG-ET/NDARCL253KU1/NDARCL253KU1_Video-TP_Samples_ET.mat, Present, 30, 7539185434, 7742454400, 203268966
/Volumes/methlab_data/HBN/EEG-ET/NDARCL253KU1/NDARCL253KU1_Video-WK_Samples_ET.mat, Diary, 30, 6589383990, 6706771116, 117387126
/Volumes/methlab_data/HBN/EEG-ET/NDARCL590LPD/NDARCL590LPD_Video1_Samples_ET.mat, Diary, 120, 3124836875, 3242224911, 117388036
/Volumes/methlab_data/HBN/EEG-ET/NDARCL590LPD/NDARCL590LPD_Video2_Samples_ET.mat, Fractals, 120, 5020594198, 5183580662, 162986464
/Volumes/methlab_data/HBN/EEG-ET/NDARCL590LPD/NDARCL590LPD_Video3_Samples_ET.mat, Despicable, 120, 5501936350, 5672479948, 170543598
/Volumes/methlab_data/HBN/EEG-ET/NDARCL895UV8/NDARCL895UV8_Video1_Samples_ET.mat, Diary, 60, 418191360, 535583686, 117392326
/Volumes/methlab_data/HBN/EEG-ET/NDARCM050BN2/NDARCM050BN2_Video-DM_Samples_ET.mat, Despicable, 60, 4042685578, 4213232211, 170546633
/Volumes/methlab_data/HBN/EEG-ET/NDARCM050BN2/NDARCM050BN2_Video-TP_Samples_ET.mat, Present, 60, 4979245974, 5182523782, 203277808
/Volumes/methlab_data/HBN/EEG-ET/NDARCM050BN2/NDARCM050BN2_Video-WK_Samples_ET.mat, Diary, 60, 3213724285, 3331111320, 117387035
/Volumes/methlab_data/HBN/EEG-ET/NDARCM135DVC/NDARCM135DVC_Video1_Samples_ET.mat, Diary, 60, 1043783123, 1161177455, 117394332
/Volumes/methlab_data/HBN/EEG-ET/NDARCM135DVC/NDARCM135DVC_Video3_Samples_ET.mat, Despicable, 60, 530088854, 700633737, 170544883
/Volumes/methlab_data/HBN/EEG-ET/NDARCM717HCJ/NDARCM717HCJ_Video1_Samples_ET.mat, Fractals, 120, 6397867137, 6560848147, 162981010
/Volumes/methlab_data/HBN/EEG-ET/NDARCM826PV9/NDARCM826PV9_Video1_Samples_ET.mat, Diary, 60, 3889269005, 4006662987, 117393982
/Volumes/methlab_data/HBN/EEG-ET/NDARCM826PV9/NDARCM826PV9_Video3_Samples_ET.mat, Despicable, 60, 3447968169, 3618510688, 170542519
/Volumes/methlab_data/HBN/EEG-ET/NDARCM826PV9/NDARCM826PV9_Video4_Samples_ET.mat, Present, 60, 4356272005, 4559333503, 203061498
/Volumes/methlab_data/HBN/EEG-ET/NDARCM953HKD/NDARCM953HKD_Video-DM_Samples_ET.mat, Despicable, 60, 7381944901, 7552492249, 170547348
/Volumes/methlab_data/HBN/EEG-ET/NDARCM953HKD/NDARCM953HKD_Video-TP_Samples_ET.mat, Present, 60, 8302514422, 8505783865, 203269443
/Volumes/methlab_data/HBN/EEG-ET/NDARCM953HKD/NDARCM953HKD_Video-WK_Samples_ET.mat, Diary, 60, 7848591146, 7965978996, 117387850
/Volumes/methlab_data/HBN/EEG-ET/NDARCN669XPR/NDARCN669XPR_Video1_Samples_ET.mat, Diary, 120, 3516289890, 3633685159, 117395269
/Volumes/methlab_data/HBN/EEG-ET/NDARCN669XPR/NDARCN669XPR_Video2_Samples_ET.mat, Fractals, 120, 4788849309, 4951836631, 162987322
/Volumes/methlab_data/HBN/EEG-ET/NDARCN669XPR/NDARCN669XPR_Video3_Samples_ET.mat, Despicable, 120, 5182175493, 5352718112, 170542619
/Volumes/methlab_data/HBN/EEG-ET/NDARCN669XPR/NDARCN669XPR_Video4_Samples_ET.mat, Present, 120, 5838957175, 6097357744, 258400569
/Volumes/methlab_data/HBN/EEG-ET/NDARCN681CXW/NDARCN681CXW_Video-DM_Samples_ET.mat, Despicable, 60, 3118458369, 3289001792, 170543423
/Volumes/methlab_data/HBN/EEG-ET/NDARCN681CXW/NDARCN681CXW_Video-FF_Samples_ET.mat, Fractals, 60, 2396057403, 2559046511, 162989108
/Volumes/methlab_data/HBN/EEG-ET/NDARCN681CXW/NDARCN681CXW_Video-TP_Samples_ET.mat, Present, 60, 4229076414, 4432143777, 203067363
/Volumes/methlab_data/HBN/EEG-ET/NDARCN681CXW/NDARCN681CXW_Video-WK_Samples_ET.mat, Diary, 60, 3718167739, 3835558613, 117390874
/Volumes/methlab_data/HBN/EEG-ET/NDARCP073AFY/NDARCP073AFY_Video-DM_Samples_ET.mat, Despicable, 30, 3304332928, 3474881397, 170548469
/Volumes/methlab_data/HBN/EEG-ET/NDARCP073AFY/NDARCP073AFY_Video-TP_Samples_ET.mat, Present, 30, 3753718322, 3956994908, 203276586
/Volumes/methlab_data/HBN/EEG-ET/NDARCP073AFY/NDARCP073AFY_Video-WK_Samples_ET.mat, Diary, 30, 3512650063, 3630038980, 117388917
/Volumes/methlab_data/HBN/EEG-ET/NDARCP452ZVH/NDARCP452ZVH_Video-DM_Samples_ET.mat, Despicable, 30, 5218413113, 5388950985, 170537872
/Volumes/methlab_data/HBN/EEG-ET/NDARCP452ZVH/NDARCP452ZVH_Video-TP_Samples_ET.mat, Present, 30, 6263995105, 6467264190, 203269085
/Volumes/methlab_data/HBN/EEG-ET/NDARCP452ZVH/NDARCP452ZVH_Video-WK_Samples_ET.mat, Diary, 30, 5804020125, 5921408334, 117388209
/Volumes/methlab_data/HBN/EEG-ET/NDARCP642KML/NDARCP642KML_Video-DM_Samples_ET.mat, Despicable, 120, 2201258150, 2371804311, 170546161
/Volumes/methlab_data/HBN/EEG-ET/NDARCP642KML/NDARCP642KML_Video-FF_Samples_ET.mat, Fractals, 120, 2441004834, 2604002100, 162997266
/Volumes/methlab_data/HBN/EEG-ET/NDARCP642KML/NDARCP642KML_Video-TP_Samples_ET.mat, Present, 120, 2902821432, 3105888658, 203067226
/Volumes/methlab_data/HBN/EEG-ET/NDARCP642KML/NDARCP642KML_Video-WK_Samples_ET.mat, Diary, 120, 2679813164, 2797210988, 117397824
/Volumes/methlab_data/HBN/EEG-ET/NDARCR499NE4/NDARCR499NE4_Video1_Samples_ET.mat, Diary, 60, 2854584310, 2971982258, 117397948
/Volumes/methlab_data/HBN/EEG-ET/NDARCR499NE4/NDARCR499NE4_Video3_Samples_ET.mat, Despicable, 60, 2642631609, 2813171089, 170539480
/Volumes/methlab_data/HBN/EEG-ET/NDARCR576EV1/NDARCR576EV1_Video-DM_Samples_ET.mat, Despicable, 120, 8946749978, 9117296972, 170546994
/Volumes/methlab_data/HBN/EEG-ET/NDARCR576EV1/NDARCR576EV1_Video-FF_Samples_ET.mat, Fractals, 120, 9589674988, 9752657063, 162982075
/Volumes/methlab_data/HBN/EEG-ET/NDARCR576EV1/NDARCR576EV1_Video-TP_Samples_ET.mat, Present, 120, 9844363228, 10047430516, 203067288
/Volumes/methlab_data/HBN/EEG-ET/NDARCR576EV1/NDARCR576EV1_Video-WK_Samples_ET.mat, Diary, 120, 9427299624, 9544689178, 117389554
/Volumes/methlab_data/HBN/EEG-ET/NDARCR582GKJ/NDARCR582GKJ_Video1_Samples_ET.mat, Diary, 120, 8877402801, 8994798728, 117395927
/Volumes/methlab_data/HBN/EEG-ET/NDARCR582GKJ/NDARCR582GKJ_Video2_Samples_ET.mat, Fractals, 120, 9331169467, 9494155377, 162985910
/Volumes/methlab_data/HBN/EEG-ET/NDARCR582GKJ/NDARCR582GKJ_Video3_Samples_ET.mat, Despicable, 120, 9755308169, 9925850796, 170542627
/Volumes/methlab_data/HBN/EEG-ET/NDARCR582GKJ/NDARCR582GKJ_Video4_Samples_ET.mat, Present, 120, 10358513974, 10561579573, 203065599
/Volumes/methlab_data/HBN/EEG-ET/NDARCR594JN0/NDARCR594JN0_Video1_Samples_ET.mat, Diary, 60, 3354755475, 3472151568, 117396093
/Volumes/methlab_data/HBN/EEG-ET/NDARCR594JN0/NDARCR594JN0_Video2_Samples_ET.mat, Fractals, 60, 2352308172, 2515293464, 162985292
/Volumes/methlab_data/HBN/EEG-ET/NDARCR594JN0/NDARCR594JN0_Video3_Samples_ET.mat, Despicable, 60, 2862734308, 3033276001, 170541693
/Volumes/methlab_data/HBN/EEG-ET/NDARCR594JN0/NDARCR594JN0_Video4_Samples_ET.mat, Present, 60, 3787992041, 4004616369, 216624328
/Volumes/methlab_data/HBN/EEG-ET/NDARCR715LEY/NDARCR715LEY_Video-DM_Samples_ET.mat, Despicable, 60, 5007625801, 5178163321, 170537520
/Volumes/methlab_data/HBN/EEG-ET/NDARCR715LEY/NDARCR715LEY_Video-TP_Samples_ET.mat, Present, 60, 5932199401, 6135466172, 203266771
/Volumes/methlab_data/HBN/EEG-ET/NDARCR715LEY/NDARCR715LEY_Video-WK_Samples_ET.mat, Diary, 60, 5504091738, 5621485832, 117394094
/Volumes/methlab_data/HBN/EEG-ET/NDARCR743RHQ/NDARCR743RHQ_Video-DM_Samples_ET.mat, Despicable, 120, 6675795295, 6846343059, 170547764
/Volumes/methlab_data/HBN/EEG-ET/NDARCR743RHQ/NDARCR743RHQ_Video-FF_Samples_ET.mat, Fractals, 120, 5519123167, 5682109933, 162986766
/Volumes/methlab_data/HBN/EEG-ET/NDARCR743RHQ/NDARCR743RHQ_Video-TP_Samples_ET.mat, Present, 120, 7365551720, 7568619615, 203067895
/Volumes/methlab_data/HBN/EEG-ET/NDARCR743RHQ/NDARCR743RHQ_Video-WK_Samples_ET.mat, Diary, 120, 6238087491, 6355480641, 117393150
/Volumes/methlab_data/HBN/EEG-ET/NDARCT277WK9/NDARCT277WK9_Video-DM_Samples_ET.mat, Despicable, 30, 4428962761, 4599510932, 170548171
/Volumes/methlab_data/HBN/EEG-ET/NDARCT277WK9/NDARCT277WK9_Video-TP_Samples_ET.mat, Present, 30, 4916982445, 5120260867, 203278422
/Volumes/methlab_data/HBN/EEG-ET/NDARCT277WK9/NDARCT277WK9_Video-WK_Samples_ET.mat, Diary, 30, 3310916514, 3428305924, 117389410
/Volumes/methlab_data/HBN/EEG-ET/NDARCT889DMB/NDARCT889DMB_Video-DM_Samples_ET.mat, Despicable, 60, 6183482306, 6354031054, 170548748
/Volumes/methlab_data/HBN/EEG-ET/NDARCT889DMB/NDARCT889DMB_Video-FF_Samples_ET.mat, Fractals, 60, 5450229160, 5613214576, 162985416
/Volumes/methlab_data/HBN/EEG-ET/NDARCT889DMB/NDARCT889DMB_Video-TP_Samples_ET.mat, Present, 60, 7296860545, 7499923357, 203062812
/Volumes/methlab_data/HBN/EEG-ET/NDARCT889DMB/NDARCT889DMB_Video-WK_Samples_ET.mat, Diary, 60, 6726995077, 6844385270, 117390193
/Volumes/methlab_data/HBN/EEG-ET/NDARCT933HF2/NDARCT933HF2_Video1_Samples_ET.mat, Diary, 60, 4413689827, 4531090885, 117401058
/Volumes/methlab_data/HBN/EEG-ET/NDARCT933HF2/NDARCT933HF2_Video3_Samples_ET.mat, Despicable, 60, 5798374175, 5968921828, 170547653
/Volumes/methlab_data/HBN/EEG-ET/NDARCT974NAJ/NDARCT974NAJ_Video1_Samples_ET.mat, Diary, 60, 1948601108, 2065994177, 117393069
/Volumes/methlab_data/HBN/EEG-ET/NDARCT974NAJ/NDARCT974NAJ_Video3_Samples_ET.mat, Despicable, 60, 1471826855, 1642377823, 170550968
/Volumes/methlab_data/HBN/EEG-ET/NDARCU034JPB/NDARCU034JPB_Video1_Samples_ET.mat, Diary, 60, 2517079897, 2634480068, 117400171
/Volumes/methlab_data/HBN/EEG-ET/NDARCU034JPB/NDARCU034JPB_Video3_Samples_ET.mat, Despicable, 60, 2096216784, 2266769700, 170552916
/Volumes/methlab_data/HBN/EEG-ET/NDARCU118LMX/NDARCU118LMX_Video1_Samples_ET.mat, Diary, 60, 3339350727, 3456744662, 117393935
/Volumes/methlab_data/HBN/EEG-ET/NDARCU118LMX/NDARCU118LMX_Video3_Samples_ET.mat, Despicable, 60, 2907706852, 3078259358, 170552506
/Volumes/methlab_data/HBN/EEG-ET/NDARCU417HRA/NDARCU417HRA_Video1_Samples_ET.mat, Diary, 120, 1586949970, 1704338226, 117388256
/Volumes/methlab_data/HBN/EEG-ET/NDARCU417HRA/NDARCU417HRA_Video2_Samples_ET.mat, Fractals, 120, 2580124595, 2743121055, 162996460
/Volumes/methlab_data/HBN/EEG-ET/NDARCU417HRA/NDARCU417HRA_Video3_Samples_ET.mat, Despicable, 120, 3083621129, 3254168052, 170546923
/Volumes/methlab_data/HBN/EEG-ET/NDARCU621EBN/NDARCU621EBN_Video-DM_Samples_ET.mat, Despicable, 60, 9137450307, 9308004624, 170554317
/Volumes/methlab_data/HBN/EEG-ET/NDARCU621EBN/NDARCU621EBN_Video-FF_Samples_ET.mat, Fractals, 60, 9378593381, 9541571323, 162977942
/Volumes/methlab_data/HBN/EEG-ET/NDARCU621EBN/NDARCU621EBN_Video-TP_Samples_ET.mat, Present, 60, 9849063134, 10052126376, 203063242
/Volumes/methlab_data/HBN/EEG-ET/NDARCU621EBN/NDARCU621EBN_Video-WK_Samples_ET.mat, Diary, 60, 9653349132, 9770743946, 117394814
/Volumes/methlab_data/HBN/EEG-ET/NDARCU736GZ1/NDARCU736GZ1_Video1_Samples_ET.mat, Diary, 60, 2558941027, 2676334062, 117393035
/Volumes/methlab_data/HBN/EEG-ET/NDARCU736GZ1/NDARCU736GZ1_Video2_Samples_ET.mat, Fractals, 60, 3395554518, 3558543785, 162989267
/Volumes/methlab_data/HBN/EEG-ET/NDARCU736GZ1/NDARCU736GZ1_Video3_Samples_ET.mat, Despicable, 60, 4572011273, 4742555893, 170544620
/Volumes/methlab_data/HBN/EEG-ET/NDARCU736GZ1/NDARCU736GZ1_Video4_Samples_ET.mat, Present, 60, 5082374105, 5285435696, 203061591
/Volumes/methlab_data/HBN/EEG-ET/NDARCU744XWL/NDARCU744XWL_Video1_Samples_ET.mat, Diary, 60, 3444462918, 3561851930, 117389012
/Volumes/methlab_data/HBN/EEG-ET/NDARCU744XWL/NDARCU744XWL_Video2_Samples_ET.mat, Fractals, 60, 4123660109, 4286643360, 162983251
/Volumes/methlab_data/HBN/EEG-ET/NDARCU744XWL/NDARCU744XWL_Video3_Samples_ET.mat, Despicable, 60, 4543064625, 4713609243, 170544618
/Volumes/methlab_data/HBN/EEG-ET/NDARCU744XWL/NDARCU744XWL_Video4_Samples_ET.mat, Present, 60, 5055637030, 5258698601, 203061571
/Volumes/methlab_data/HBN/EEG-ET/NDARCU865PBV/NDARCU865PBV_Video1_Samples_ET.mat, Diary, 60, 4288361515, 4405750461, 117388946
/Volumes/methlab_data/HBN/EEG-ET/NDARCU865PBV/NDARCU865PBV_Video3_Samples_ET.mat, Despicable, 60, 3960008579, 4130559064, 170550485
/Volumes/methlab_data/HBN/EEG-ET/NDARCU919KUL/NDARCU919KUL_Video-DM_Samples_ET.mat, Despicable, 60, 3075733246, 3246277781, 170544535
/Volumes/methlab_data/HBN/EEG-ET/NDARCU957PGQ/NDARCU957PGQ_Video1_Samples_ET.mat, Diary, 120, 3314714494, 3432112246, 117397752
/Volumes/methlab_data/HBN/EEG-ET/NDARCU957PGQ/NDARCU957PGQ_Video2_Samples_ET.mat, Despicable, 120, 4694144795, 4864691948, 170547153
/Volumes/methlab_data/HBN/EEG-ET/NDARCU957PGQ/NDARCU957PGQ_Video3_Samples_ET.mat, Fractals, 120, 5266430992, 5429428644, 162997652
/Volumes/methlab_data/HBN/EEG-ET/NDARCU957PGQ/NDARCU957PGQ_Video4_Samples_ET.mat, Present, 120, 6105495558, 6308562896, 203067338
/Volumes/methlab_data/HBN/EEG-ET/NDARCV154DB9/NDARCV154DB9_Video1_Samples_ET.mat, Diary, 60, 2673600430, 2790994508, 117394078
/Volumes/methlab_data/HBN/EEG-ET/NDARCV154DB9/NDARCV154DB9_Video2_Samples_ET.mat, Fractals, 60, 3348796199, 3511789561, 162993362
/Volumes/methlab_data/HBN/EEG-ET/NDARCV154DB9/NDARCV154DB9_Video3_Samples_ET.mat, Despicable, 60, 3782072793, 3952614494, 170541701
/Volumes/methlab_data/HBN/EEG-ET/NDARCV154DB9/NDARCV154DB9_Video4_Samples_ET.mat, Present, 60, 4265096595, 4468155300, 203058705
/Volumes/methlab_data/HBN/EEG-ET/NDARCV378MMX/NDARCV378MMX_Video-DM_Samples_ET.mat, Despicable, 60, 4926370780, 5096913312, 170542532
/Volumes/methlab_data/HBN/EEG-ET/NDARCV378MMX/NDARCV378MMX_Video-FF_Samples_ET.mat, Fractals, 60, 4504303531, 4667296756, 162993225
/Volumes/methlab_data/HBN/EEG-ET/NDARCV378MMX/NDARCV378MMX_Video-TP_Samples_ET.mat, Present, 60, 5409924503, 5612995002, 203070499
/Volumes/methlab_data/HBN/EEG-ET/NDARCV378MMX/NDARCV378MMX_Video-WK_Samples_ET.mat, Diary, 60, 3814903375, 3932298347, 117394972
/Volumes/methlab_data/HBN/EEG-ET/NDARCV440TRV/NDARCV440TRV_Video-DM_Samples_ET.mat, Despicable, 60, 4985129844, 5155668377, 170538533
/Volumes/methlab_data/HBN/EEG-ET/NDARCV440TRV/NDARCV440TRV_Video-FF_Samples_ET.mat, Fractals, 60, 4553586896, 4716564089, 162977193
/Volumes/methlab_data/HBN/EEG-ET/NDARCV440TRV/NDARCV440TRV_Video-TP_Samples_ET.mat, Present, 60, 5514829166, 5717888662, 203059496
/Volumes/methlab_data/HBN/EEG-ET/NDARCV440TRV/NDARCV440TRV_Video-WK_Samples_ET.mat, Diary, 60, 3924575430, 4041966382, 117390952
/Volumes/methlab_data/HBN/EEG-ET/NDARCV606ZZ5/NDARCV606ZZ5_Video1_Samples_ET.mat, Diary, 60, 2989288880, 3106685737, 117396857
/Volumes/methlab_data/HBN/EEG-ET/NDARCV606ZZ5/NDARCV606ZZ5_Video2_Samples_ET.mat, Fractals, 60, 1848170737, 2011154773, 162984036
/Volumes/methlab_data/HBN/EEG-ET/NDARCV606ZZ5/NDARCV606ZZ5_Video3_Samples_ET.mat, Despicable, 60, 2545794968, 2716337300, 170542332
/Volumes/methlab_data/HBN/EEG-ET/NDARCV606ZZ5/NDARCV606ZZ5_Video4_Samples_ET.mat, Present, 60, 3429486514, 3632551760, 203065246
/Volumes/methlab_data/HBN/EEG-ET/NDARCV628NRY/NDARCV628NRY_Video-WK_Samples_ET.mat, Diary, 60, 5219516485, 5336907514, 117391029
/Volumes/methlab_data/HBN/EEG-ET/NDARCV628UUW/NDARCV628UUW_Video-DM_Samples_ET.mat, Despicable, 120, 10395194029, 10565740496, 170546467
/Volumes/methlab_data/HBN/EEG-ET/NDARCV628UUW/NDARCV628UUW_Video-FF_Samples_ET.mat, Fractals, 120, 9177891839, 9340879072, 162987233
/Volumes/methlab_data/HBN/EEG-ET/NDARCV628UUW/NDARCV628UUW_Video-TP_Samples_ET.mat, Present, 120, 11041524250, 11244588920, 203064670
/Volumes/methlab_data/HBN/EEG-ET/NDARCV628UUW/NDARCV628UUW_Video-WK_Samples_ET.mat, Diary, 120, 9915717175, 10033114443, 117397268
/Volumes/methlab_data/HBN/EEG-ET/NDARCV944JA6/NDARCV944JA6_Video1_Samples_ET.mat, Diary, 60, 3761616486, 3879005215, 117388729
/Volumes/methlab_data/HBN/EEG-ET/NDARCV944JA6/NDARCV944JA6_Video3_Samples_ET.mat, Despicable, 60, 3332893397, 3503442646, 170549249
/Volumes/methlab_data/HBN/EEG-ET/NDARCV981XUY/NDARCV981XUY_Video1_Samples_ET.mat, Diary, 60, 4276112903, 4393509703, 117396800
/Volumes/methlab_data/HBN/EEG-ET/NDARCV981XUY/NDARCV981XUY_Video2_Samples_ET.mat, Fractals, 60, 5329236566, 5492228542, 162991976
/Volumes/methlab_data/HBN/EEG-ET/NDARCV981XUY/NDARCV981XUY_Video3_Samples_ET.mat, Despicable, 60, 4856872453, 5027413751, 170541298
/Volumes/methlab_data/HBN/EEG-ET/NDARCV981XUY/NDARCV981XUY_Video4_Samples_ET.mat, Present, 60, 5826377161, 6029450399, 203073238
/Volumes/methlab_data/HBN/EEG-ET/NDARCW058DP8/NDARCW058DP8_Video-DM_Samples_ET.mat, Despicable, 30, 3257579808, 3428121497, 170541689
/Volumes/methlab_data/HBN/EEG-ET/NDARCW058DP8/NDARCW058DP8_Video-WK_Samples_ET.mat, Diary, 30, 3885577192, 4002966274, 117389082
/Volumes/methlab_data/HBN/EEG-ET/NDARCW071AU5/NDARCW071AU5_Video1_Samples_ET.mat, Diary, 60, 4385391711, 4502785630, 117393919
/Volumes/methlab_data/HBN/EEG-ET/NDARCW071AU5/NDARCW071AU5_Video3_Samples_ET.mat, Despicable, 60, 3940373441, 4110914878, 170541437
/Volumes/methlab_data/HBN/EEG-ET/NDARCW094JCG/NDARCW094JCG_Video1_Samples_ET.mat, Diary, 60, 5774490022, 5891883086, 117393064
/Volumes/methlab_data/HBN/EEG-ET/NDARCW094JCG/NDARCW094JCG_Video3_Samples_ET.mat, Despicable, 60, 5243735638, 5414277288, 170541650
/Volumes/methlab_data/HBN/EEG-ET/NDARCW497XW2/NDARCW497XW2_Video1_Samples_ET.mat, Diary, 60, 3282011935, 3399408986, 117397051
/Volumes/methlab_data/HBN/EEG-ET/NDARCW497XW2/NDARCW497XW2_Video2_Samples_ET.mat, Fractals, 60, 1996771275, 2159761517, 162990242
/Volumes/methlab_data/HBN/EEG-ET/NDARCW497XW2/NDARCW497XW2_Video3_Samples_ET.mat, Despicable, 60, 2704227453, 2874779089, 170551636
/Volumes/methlab_data/HBN/EEG-ET/NDARCW497XW2/NDARCW497XW2_Video4_Samples_ET.mat, Present, 60, 3743101951, 3946172518, 203070567
/Volumes/methlab_data/HBN/EEG-ET/NDARCW932EU6/NDARCW932EU6_Video-DM_Samples_ET.mat, Despicable, 120, 3914234925, 4084782615, 170547690
/Volumes/methlab_data/HBN/EEG-ET/NDARCW932EU6/NDARCW932EU6_Video-FF_Samples_ET.mat, Fractals, 120, 3179910774, 3342896357, 162985583
/Volumes/methlab_data/HBN/EEG-ET/NDARCW932EU6/NDARCW932EU6_Video-TP_Samples_ET.mat, Present, 120, 5073498171, 5276565950, 203067779
/Volumes/methlab_data/HBN/EEG-ET/NDARCW932EU6/NDARCW932EU6_Video-WK_Samples_ET.mat, Diary, 120, 4336567053, 4453958612, 117391559
/Volumes/methlab_data/HBN/EEG-ET/NDARCW933FD5/NDARCW933FD5_Video1_Samples_ET.mat, Diary, 120, 4852347176, 4969735007, 117387831
/Volumes/methlab_data/HBN/EEG-ET/NDARCW933FD5/NDARCW933FD5_Video2_Samples_ET.mat, Fractals, 120, 5999068789, 6162056542, 162987753
/Volumes/methlab_data/HBN/EEG-ET/NDARCW933FD5/NDARCW933FD5_Video3_Samples_ET.mat, Despicable, 120, 6501735905, 6672283180, 170547275
/Volumes/methlab_data/HBN/EEG-ET/NDARCW933FD5/NDARCW933FD5_Video4_Samples_ET.mat, Present, 120, 7217794402, 7420861946, 203067544
/Volumes/methlab_data/HBN/EEG-ET/NDARCW963FP9/NDARCW963FP9_Video1_Samples_ET.mat, Diary, 60, 3495117926, 3612510544, 117392618
/Volumes/methlab_data/HBN/EEG-ET/NDARCW963FP9/NDARCW963FP9_Video3_Samples_ET.mat, Despicable, 60, 3070189386, 3240731830, 170542444
/Volumes/methlab_data/HBN/EEG-ET/NDARCX021XWF/NDARCX021XWF_Video-DM_Samples_ET.mat, Despicable, 30, 6178742560, 6349281459, 170538899
/Volumes/methlab_data/HBN/EEG-ET/NDARCX021XWF/NDARCX021XWF_Video-TP_Samples_ET.mat, Present, 30, 6700888606, 6904167684, 203279078
/Volumes/methlab_data/HBN/EEG-ET/NDARCX021XWF/NDARCX021XWF_Video-WK_Samples_ET.mat, Diary, 30, 5033014592, 5150401810, 117387218
/Volumes/methlab_data/HBN/EEG-ET/NDARCX053GU5/NDARCX053GU5_Video1_Samples_ET.mat, Diary, 60, 3708200024, 3825588065, 117388041
/Volumes/methlab_data/HBN/EEG-ET/NDARCX053GU5/NDARCX053GU5_Video3_Samples_ET.mat, Despicable, 60, 3293156728, 3463705278, 170548550
/Volumes/methlab_data/HBN/EEG-ET/NDARCX053GU5/NDARCX053GU5_Video4_Samples_ET.mat, Present, 60, 4119113392, 4322180929, 203067537
/Volumes/methlab_data/HBN/EEG-ET/NDARCX221CWA/NDARCX221CWA_Video1_Samples_ET.mat, Diary, 60, 5454018676, 5571416705, 117398029
/Volumes/methlab_data/HBN/EEG-ET/NDARCX221CWA/NDARCX221CWA_Video3_Samples_ET.mat, Despicable, 60, 5013692374, 5184235942, 170543568
/Volumes/methlab_data/HBN/EEG-ET/NDARCX462NVA/NDARCX462NVA_Video-DM_Samples_ET.mat, Despicable, 60, 5500410571, 5670950344, 170539773
/Volumes/methlab_data/HBN/EEG-ET/NDARCX462NVA/NDARCX462NVA_Video-FF_Samples_ET.mat, Fractals, 60, 5068605672, 5231596880, 162991208
/Volumes/methlab_data/HBN/EEG-ET/NDARCX462NVA/NDARCX462NVA_Video-TP_Samples_ET.mat, Present, 60, 5987831244, 6190893773, 203062529
/Volumes/methlab_data/HBN/EEG-ET/NDARCX462NVA/NDARCX462NVA_Video-WK_Samples_ET.mat, Diary, 60, 4497824322, 4615218304, 117393982
/Volumes/methlab_data/HBN/EEG-ET/NDARCX505WVX/NDARCX505WVX_Video-DM_Samples_ET.mat, Despicable, 60, 2571640830, 2742187061, 170546231
/Volumes/methlab_data/HBN/EEG-ET/NDARCX505WVX/NDARCX505WVX_Video-TP_Samples_ET.mat, Present, 60, 3525250078, 3728528383, 203278305
/Volumes/methlab_data/HBN/EEG-ET/NDARCX505WVX/NDARCX505WVX_Video-WK_Samples_ET.mat, Diary, 60, 3009195279, 3126586049, 117390770
/Volumes/methlab_data/HBN/EEG-ET/NDARCX580WB7/NDARCX580WB7_Video1_Samples_ET.mat, Diary, 60, 3773594294, 3890986263, 117391969
/Volumes/methlab_data/HBN/EEG-ET/NDARCX580WB7/NDARCX580WB7_Video3_Samples_ET.mat, Despicable, 60, 2959198801, 3129743337, 170544536
/Volumes/methlab_data/HBN/EEG-ET/NDARCY178KJP/NDARCY178KJP_Video1_Samples_ET.mat, Diary, 60, 4639748848, 4757143899, 117395051
/Volumes/methlab_data/HBN/EEG-ET/NDARCY178KJP/NDARCY178KJP_Video3_Samples_ET.mat, Despicable, 60, 4204826229, 4375365862, 170539633
/Volumes/methlab_data/HBN/EEG-ET/NDARCZ388PF5/NDARCZ388PF5_Video-DM_Samples_ET.mat, Despicable, 120, 4638750174, 4809297174, 170547000
/Volumes/methlab_data/HBN/EEG-ET/NDARCZ388PF5/NDARCZ388PF5_Video-FF_Samples_ET.mat, Fractals, 120, 3917583477, 4080571527, 162988050
/Volumes/methlab_data/HBN/EEG-ET/NDARCZ388PF5/NDARCZ388PF5_Video-TP_Samples_ET.mat, Present, 120, 5267017208, 5470083104, 203065896
/Volumes/methlab_data/HBN/EEG-ET/NDARCZ388PF5/NDARCZ388PF5_Video-WK_Samples_ET.mat, Diary, 120, 2819571883, 2936966206, 117394323
/Volumes/methlab_data/HBN/EEG-ET/NDARCZ770BRG/NDARCZ770BRG_Video1_Samples_ET.mat, Diary, 60, 1508549886, 1625950853, 117400967
/Volumes/methlab_data/HBN/EEG-ET/NDARCZ770BRG/NDARCZ770BRG_Video3_Samples_ET.mat, Despicable, 60, 1072417239, 1242957793, 170540554
/Volumes/methlab_data/HBN/EEG-ET/NDARCZ915NC1/NDARCZ915NC1_Video1_Samples_ET.mat, Diary, 60, 2849287536, 2966682510, 117394974
/Volumes/methlab_data/HBN/EEG-ET/NDARCZ915NC1/NDARCZ915NC1_Video3_Samples_ET.mat, Despicable, 60, 2350252916, 2520795432, 170542516
/Volumes/methlab_data/HBN/EEG-ET/NDARCZ915NC1/NDARCZ915NC1_Video4_Samples_ET.mat, Present, 60, 3283586432, 3486648967, 203062535
/Volumes/methlab_data/HBN/EEG-ET/NDARCZ947WU5/NDARCZ947WU5_Video1_Samples_ET.mat, Diary, 60, 5399809964, 5517204983, 117395019
/Volumes/methlab_data/HBN/EEG-ET/NDARCZ947WU5/NDARCZ947WU5_Video3_Samples_ET.mat, Despicable, 60, 6545579023, 6716154633, 170575610
/Volumes/methlab_data/HBN/EEG-ET/NDARDA516MNY/NDARDA516MNY_Video-DM_Samples_ET.mat, Despicable, 60, 517349485, 687892002, 170542517
/Volumes/methlab_data/HBN/EEG-ET/NDARDA516MNY/NDARDA516MNY_Video-TP_Samples_ET.mat, Present, 60, 1570186134, 1773247532, 203061398
/Volumes/methlab_data/HBN/EEG-ET/NDARDA516MNY/NDARDA516MNY_Video-WK_Samples_ET.mat, Diary, 60, 1053685295, 1171084238, 117398943
/Volumes/methlab_data/HBN/EEG-ET/NDARDA573XGG/NDARDA573XGG_Video1_Samples_ET.mat, Diary, 60, 3142937926, 3260331739, 117393813
/Volumes/methlab_data/HBN/EEG-ET/NDARDA573XGG/NDARDA573XGG_Video2_Samples_ET.mat, Fractals, 60, 4631525708, 4794516673, 162990965
/Volumes/methlab_data/HBN/EEG-ET/NDARDA573XGG/NDARDA573XGG_Video3_Samples_ET.mat, Despicable, 60, 4196591983, 4367133280, 170541297
/Volumes/methlab_data/HBN/EEG-ET/NDARDA573XGG/NDARDA573XGG_Video4_Samples_ET.mat, Present, 60, 5110488581, 5313550695, 203062114
/Volumes/methlab_data/HBN/EEG-ET/NDARDA656RBN/NDARDA656RBN_Video-DM_Samples_ET.mat, Despicable, 120, 3545603303, 3716146609, 170543306
/Volumes/methlab_data/HBN/EEG-ET/NDARDA656RBN/NDARDA656RBN_Video-FF_Samples_ET.mat, Fractals, 120, 2715634873, 2878621167, 162986294
/Volumes/methlab_data/HBN/EEG-ET/NDARDA656RBN/NDARDA656RBN_Video-TP_Samples_ET.mat, Present, 120, 4616413898, 4819480270, 203066372
/Volumes/methlab_data/HBN/EEG-ET/NDARDA656RBN/NDARDA656RBN_Video-WK_Samples_ET.mat, Diary, 120, 4028686083, 4146084046, 117397963
/Volumes/methlab_data/HBN/EEG-ET/NDARDA665DRH/NDARDA665DRH_Video1_Samples_ET.mat, Diary, 60, 4752056255, 4869450064, 117393809
/Volumes/methlab_data/HBN/EEG-ET/NDARDA665DRH/NDARDA665DRH_Video3_Samples_ET.mat, Despicable, 60, 4304421573, 4474972864, 170551291
/Volumes/methlab_data/HBN/EEG-ET/NDARDA665DRH/NDARDA665DRH_Video4_Samples_ET.mat, Present, 60, 5187570380, 5390633600, 203063220
/Volumes/methlab_data/HBN/EEG-ET/NDARDA695XTL/NDARDA695XTL_Video1_Samples_ET.mat, Diary, 60, 2009407127, 2126801979, 117394852
/Volumes/methlab_data/HBN/EEG-ET/NDARDA695XTL/NDARDA695XTL_Video3_Samples_ET.mat, Despicable, 60, 1595584170, 1766124513, 170540343
/Volumes/methlab_data/HBN/EEG-ET/NDARDB033FW5/NDARDB033FW5_Video-DM_Samples_ET.mat, Despicable, 30, 5087038916, 5257579563, 170540647
/Volumes/methlab_data/HBN/EEG-ET/NDARDB033FW5/NDARDB033FW5_Video-TP_Samples_ET.mat, Present, 30, 5582286219, 5785553974, 203267755
/Volumes/methlab_data/HBN/EEG-ET/NDARDB033FW5/NDARDB033FW5_Video-WK_Samples_ET.mat, Diary, 30, 3578174745, 3695563790, 117389045
/Volumes/methlab_data/HBN/EEG-ET/NDARDB146NWY/NDARDB146NWY_Video1_Samples_ET.mat, Diary, 60, 1708177488, 1825571526, 117394038
/Volumes/methlab_data/HBN/EEG-ET/NDARDB146NWY/NDARDB146NWY_Video3_Samples_ET.mat, Despicable, 60, 1485182834, 1655735444, 170552610
/Volumes/methlab_data/HBN/EEG-ET/NDARDB161LU6/NDARDB161LU6_Video-DM_Samples_ET.mat, Despicable, 60, 3011309139, 3181848669, 170539530
/Volumes/methlab_data/HBN/EEG-ET/NDARDB161LU6/NDARDB161LU6_Video-TP_Samples_ET.mat, Present, 60, 3539614483, 3742883135, 203268652
/Volumes/methlab_data/HBN/EEG-ET/NDARDB161LU6/NDARDB161LU6_Video-WK_Samples_ET.mat, Diary, 60, 1803661762, 1921047728, 117385966
/Volumes/methlab_data/HBN/EEG-ET/NDARDB720VEA/NDARDB720VEA_Video-DM_Samples_ET.mat, Despicable, 120, 4751798107, 5025944327, 274146220
/Volumes/methlab_data/HBN/EEG-ET/NDARDB720VEA/NDARDB720VEA_Video-FF_Samples_ET.mat, Fractals, 120, 5478712717, 5568431228, 89718511
/Volumes/methlab_data/HBN/EEG-ET/NDARDB720VEA/NDARDB720VEA_Video-WK_Samples_ET.mat, Diary, 120, 6183379833, 6300771600, 117391767
/Volumes/methlab_data/HBN/EEG-ET/NDARDB804YHE/NDARDB804YHE_Video1_Samples_ET.mat, Diary, 60, 2015293093, 2132691247, 117398154
/Volumes/methlab_data/HBN/EEG-ET/NDARDB804YHE/NDARDB804YHE_Video3_Samples_ET.mat, Despicable, 60, 3408349334, 3578894104, 170544770
/Volumes/methlab_data/HBN/EEG-ET/NDARDC003YG7/NDARDC003YG7_Video-DM_Samples_ET.mat, Despicable, 120, 6049657836, 6220204293, 170546457
/Volumes/methlab_data/HBN/EEG-ET/NDARDC389TLD/NDARDC389TLD_Video1_Samples_ET.mat, Diary, 120, 4726800913, 4844197231, 117396318
/Volumes/methlab_data/HBN/EEG-ET/NDARDC389TLD/NDARDC389TLD_Video2_Samples_ET.mat, Fractals, 120, 6151902252, 6314899186, 162996934
/Volumes/methlab_data/HBN/EEG-ET/NDARDC389TLD/NDARDC389TLD_Video3_Samples_ET.mat, Despicable, 120, 6426870576, 6597417953, 170547377
/Volumes/methlab_data/HBN/EEG-ET/NDARDC389TLD/NDARDC389TLD_Video4_Samples_ET.mat, Present, 120, 6703138824, 6906206753, 203067929
/Volumes/methlab_data/HBN/EEG-ET/NDARDC704GKW/NDARDC704GKW_Video1_Samples_ET.mat, Diary, 60, 3305280540, 3422664547, 117384007
/Volumes/methlab_data/HBN/EEG-ET/NDARDC704GKW/NDARDC704GKW_Video3_Samples_ET.mat, Despicable, 60, 3028418808, 3198964393, 170545585
/Volumes/methlab_data/HBN/EEG-ET/NDARDC814WW2/NDARDC814WW2_Video-DM_Samples_ET.mat, Despicable, 120, 6300934211, 6471481180, 170546969
/Volumes/methlab_data/HBN/EEG-ET/NDARDC814WW2/NDARDC814WW2_Video-FF_Samples_ET.mat, Fractals, 120, 5576818569, 5739805187, 162986618
/Volumes/methlab_data/HBN/EEG-ET/NDARDC814WW2/NDARDC814WW2_Video-TP_Samples_ET.mat, Present, 120, 7282216581, 7485284600, 203068019
/Volumes/methlab_data/HBN/EEG-ET/NDARDC814WW2/NDARDC814WW2_Video-WK_Samples_ET.mat, Diary, 120, 6803950270, 6921348019, 117397749
/Volumes/methlab_data/HBN/EEG-ET/NDARDC843HHM/NDARDC843HHM_Video1_Samples_ET.mat, Diary, 60, 4400517821, 4517911812, 117393991
/Volumes/methlab_data/HBN/EEG-ET/NDARDC843HHM/NDARDC843HHM_Video2_Samples_ET.mat, Fractals, 60, 3262345104, 3425329356, 162984252
/Volumes/methlab_data/HBN/EEG-ET/NDARDC843HHM/NDARDC843HHM_Video3_Samples_ET.mat, Despicable, 60, 3960163448, 4130708067, 170544619
/Volumes/methlab_data/HBN/EEG-ET/NDARDC843HHM/NDARDC843HHM_Video4_Samples_ET.mat, Present, 60, 4857092586, 5060154168, 203061582
/Volumes/methlab_data/HBN/EEG-ET/NDARDC987BMU/NDARDC987BMU_Video1_Samples_ET.mat, Diary, 60, 3214123196, 3331516525, 117393329
/Volumes/methlab_data/HBN/EEG-ET/NDARDC987BMU/NDARDC987BMU_Video3_Samples_ET.mat, Despicable, 60, 3585672669, 3756217445, 170544776
/Volumes/methlab_data/HBN/EEG-ET/NDARDD073JKZ/NDARDD073JKZ_Video-DM_Samples_ET.mat, Despicable, 120, 4427918718, 4598465949, 170547231
/Volumes/methlab_data/HBN/EEG-ET/NDARDD073JKZ/NDARDD073JKZ_Video-FF_Samples_ET.mat, Fractals, 120, 3681773968, 3844770858, 162996890
/Volumes/methlab_data/HBN/EEG-ET/NDARDD073JKZ/NDARDD073JKZ_Video-TP_Samples_ET.mat, Present, 120, 5561082720, 5764145122, 203062402
/Volumes/methlab_data/HBN/EEG-ET/NDARDD073JKZ/NDARDD073JKZ_Video-WK_Samples_ET.mat, Diary, 120, 4888095930, 5005503765, 117407835
/Volumes/methlab_data/HBN/EEG-ET/NDARDD128NWL/NDARDD128NWL_Video-DM_Samples_ET.mat, Despicable, 120, 4332572619, 4503119821, 170547202
/Volumes/methlab_data/HBN/EEG-ET/NDARDD128NWL/NDARDD128NWL_Video-FF_Samples_ET.mat, Fractals, 120, 3648796856, 3811783712, 162986856
/Volumes/methlab_data/HBN/EEG-ET/NDARDD128NWL/NDARDD128NWL_Video-TP_Samples_ET.mat, Present, 120, 5423926297, 5626993978, 203067681
/Volumes/methlab_data/HBN/EEG-ET/NDARDD128NWL/NDARDD128NWL_Video-WK_Samples_ET.mat, Diary, 120, 4775120179, 4892517442, 117397263
/Volumes/methlab_data/HBN/EEG-ET/NDARDD193HUP/NDARDD193HUP_Video-DM_Samples_ET.mat, Despicable, 120, 3645993305, 3816534769, 170541464
/Volumes/methlab_data/HBN/EEG-ET/NDARDD193HUP/NDARDD193HUP_Video-FF_Samples_ET.mat, Fractals, 120, 2913098731, 3076085710, 162986979
/Volumes/methlab_data/HBN/EEG-ET/NDARDD193HUP/NDARDD193HUP_Video-TP_Samples_ET.mat, Present, 120, 4759636881, 4962703921, 203067040
/Volumes/methlab_data/HBN/EEG-ET/NDARDD193HUP/NDARDD193HUP_Video-WK_Samples_ET.mat, Diary, 120, 4130361606, 4247758023, 117396417
/Volumes/methlab_data/HBN/EEG-ET/NDARDD531EP2/NDARDD531EP2_Video1_Samples_ET.mat, Diary, 60, 4028934037, 4146326825, 117392788
/Volumes/methlab_data/HBN/EEG-ET/NDARDD531EP2/NDARDD531EP2_Video3_Samples_ET.mat, Despicable, 60, 3575876535, 3746419813, 170543278
/Volumes/methlab_data/HBN/EEG-ET/NDARDD854GF8/NDARDD854GF8_Video-DM_Samples_ET.mat, Despicable, 120, 2827735609, 2998282558, 170546949
/Volumes/methlab_data/HBN/EEG-ET/NDARDD854GF8/NDARDD854GF8_Video-FF_Samples_ET.mat, Fractals, 120, 2103241194, 2266227778, 162986584
/Volumes/methlab_data/HBN/EEG-ET/NDARDD854GF8/NDARDD854GF8_Video-TP_Samples_ET.mat, Present, 120, 3964399293, 4167466538, 203067245
/Volumes/methlab_data/HBN/EEG-ET/NDARDD854GF8/NDARDD854GF8_Video-WK_Samples_ET.mat, Diary, 120, 3341312174, 3458710761, 117398587
/Volumes/methlab_data/HBN/EEG-ET/NDARDE283PLC/NDARDE283PLC_Video1_Samples_ET.mat, Despicable, 120, 2810181415, 2980729074, 170547659
/Volumes/methlab_data/HBN/EEG-ET/NDARDE283PLC/NDARDE283PLC_Video2_Samples_ET.mat, Fractals, 120, 3123478721, 3286466414, 162987693
/Volumes/methlab_data/HBN/EEG-ET/NDARDE283PLC/NDARDE283PLC_Video3_Samples_ET.mat, Diary, 120, 3435958077, 3553356068, 117397991
/Volumes/methlab_data/HBN/EEG-ET/NDARDE283PLC/NDARDE283PLC_Video4_Samples_ET.mat, Present, 120, 3678566681, 3881633317, 203066636
/Volumes/methlab_data/HBN/EEG-ET/NDARDE319VD1/NDARDE319VD1_Video-DM_Samples_ET.mat, Despicable, 120, 2284825588, 2455380098, 170554510
/Volumes/methlab_data/HBN/EEG-ET/NDARDE319VD1/NDARDE319VD1_Video-FF_Samples_ET.mat, Fractals, 120, 2819711943, 2982699714, 162987771
/Volumes/methlab_data/HBN/EEG-ET/NDARDE319VD1/NDARDE319VD1_Video-TP_Samples_ET.mat, Present, 120, 3350618808, 3553686221, 203067413
/Volumes/methlab_data/HBN/EEG-ET/NDARDE319VD1/NDARDE319VD1_Video-WK_Samples_ET.mat, Diary, 120, 3135251487, 3252648430, 117396943
/Volumes/methlab_data/HBN/EEG-ET/NDARDE502TEU/NDARDE502TEU_Video-DM_Samples_ET.mat, Despicable, 60, 3159253332, 3329802773, 170549441
/Volumes/methlab_data/HBN/EEG-ET/NDARDE502TEU/NDARDE502TEU_Video-FF_Samples_ET.mat, Fractals, 60, 2648838800, 2811829943, 162991143
/Volumes/methlab_data/HBN/EEG-ET/NDARDE597GKQ/NDARDE597GKQ_Video1_Samples_ET.mat, Diary, 60, 4202042730, 4319438783, 117396053
/Volumes/methlab_data/HBN/EEG-ET/NDARDE597GKQ/NDARDE597GKQ_Video2_Samples_ET.mat, Fractals, 60, 4832442790, 4995435014, 162992224
/Volumes/methlab_data/HBN/EEG-ET/NDARDE597GKQ/NDARDE597GKQ_Video3_Samples_ET.mat, Despicable, 60, 5290954883, 5461498542, 170543659
/Volumes/methlab_data/HBN/EEG-ET/NDARDE597GKQ/NDARDE597GKQ_Video4_Samples_ET.mat, Present, 60, 5771351660, 5974421362, 203069702
/Volumes/methlab_data/HBN/EEG-ET/NDARDE681UEX/NDARDE681UEX_Video-DM_Samples_ET.mat, Despicable, 60, 2611396393, 2781934862, 170538469
/Volumes/methlab_data/HBN/EEG-ET/NDARDE681UEX/NDARDE681UEX_Video-TP_Samples_ET.mat, Present, 60, 3572065903, 3775336492, 203270589
/Volumes/methlab_data/HBN/EEG-ET/NDARDE681UEX/NDARDE681UEX_Video-WK_Samples_ET.mat, Diary, 60, 3030955730, 3148344642, 117388912
/Volumes/methlab_data/HBN/EEG-ET/NDARDE877RFH/NDARDE877RFH_Video1_Samples_ET.mat, Diary, 60, 3907788536, 4025182425, 117393889
/Volumes/methlab_data/HBN/EEG-ET/NDARDE877RFH/NDARDE877RFH_Video2_Samples_ET.mat, Fractals, 60, 2514035631, 2677018735, 162983104
/Volumes/methlab_data/HBN/EEG-ET/NDARDE877RFH/NDARDE877RFH_Video3_Samples_ET.mat, Despicable, 60, 3416904052, 3587458428, 170554376
/Volumes/methlab_data/HBN/EEG-ET/NDARDE877RFH/NDARDE877RFH_Video4_Samples_ET.mat, Present, 60, 4345672639, 4548747033, 203074394
/Volumes/methlab_data/HBN/EEG-ET/NDARDF373ZDW/NDARDF373ZDW_Video1_Samples_ET.mat, Despicable, 120, 3750227443, 3920773979, 170546536
/Volumes/methlab_data/HBN/EEG-ET/NDARDF373ZDW/NDARDF373ZDW_Video2_Samples_ET.mat, Diary, 120, 5031930107, 5149326433, 117396326
/Volumes/methlab_data/HBN/EEG-ET/NDARDF373ZDW/NDARDF373ZDW_Video3_Samples_ET.mat, Fractals, 120, 5304856080, 5467854536, 162998456
/Volumes/methlab_data/HBN/EEG-ET/NDARDF373ZDW/NDARDF373ZDW_Video4_Samples_ET.mat, Present, 120, 5667253710, 5870321588, 203067878
/Volumes/methlab_data/HBN/EEG-ET/NDARDF374LGN/NDARDF374LGN_Video1_Samples_ET.mat, Despicable, 120, 2253661111, 2424206802, 170545691
/Volumes/methlab_data/HBN/EEG-ET/NDARDF374LGN/NDARDF374LGN_Video2_Samples_ET.mat, Fractals, 120, 2568427444, 2731414381, 162986937
/Volumes/methlab_data/HBN/EEG-ET/NDARDF374LGN/NDARDF374LGN_Video3_Samples_ET.mat, Diary, 120, 2858195204, 2975593360, 117398156
/Volumes/methlab_data/HBN/EEG-ET/NDARDF374LGN/NDARDF374LGN_Video4_Samples_ET.mat, Present, 120, 3123774032, 3326841463, 203067431
/Volumes/methlab_data/HBN/EEG-ET/NDARDF560NND/NDARDF560NND_Video-DM_Samples_ET.mat, Despicable, 60, 5287757333, 5458305685, 170548352
/Volumes/methlab_data/HBN/EEG-ET/NDARDF560NND/NDARDF560NND_Video-TP_Samples_ET.mat, Present, 60, 5944293327, 6147570726, 203277399
/Volumes/methlab_data/HBN/EEG-ET/NDARDF560NND/NDARDF560NND_Video-WK_Samples_ET.mat, Diary, 60, 3802816116, 3920201914, 117385798
/Volumes/methlab_data/HBN/EEG-ET/NDARDF568GL5/NDARDF568GL5_Video1_Samples_ET.mat, Diary, 120, 3932483005, 4049879857, 117396852
/Volumes/methlab_data/HBN/EEG-ET/NDARDF568GL5/NDARDF568GL5_Video2_Samples_ET.mat, Despicable, 120, 5098606131, 5269162950, 170556819
/Volumes/methlab_data/HBN/EEG-ET/NDARDF568GL5/NDARDF568GL5_Video3_Samples_ET.mat, Fractals, 120, 5666302212, 5829290218, 162988006
/Volumes/methlab_data/HBN/EEG-ET/NDARDF568GL5/NDARDF568GL5_Video4_Samples_ET.mat, Present, 120, 6431878154, 6634946359, 203068205
/Volumes/methlab_data/HBN/EEG-ET/NDARDG484ZJ1/NDARDG484ZJ1_Video-DM_Samples_ET.mat, Despicable, 120, 7168705104, 7339259232, 170554128
/Volumes/methlab_data/HBN/EEG-ET/NDARDG484ZJ1/NDARDG484ZJ1_Video-FF_Samples_ET.mat, Fractals, 120, 5877852917, 6040840742, 162987825
/Volumes/methlab_data/HBN/EEG-ET/NDARDG484ZJ1/NDARDG484ZJ1_Video-TP_Samples_ET.mat, Present, 120, 8836253964, 9039321556, 203067592
/Volumes/methlab_data/HBN/EEG-ET/NDARDG484ZJ1/NDARDG484ZJ1_Video-WK_Samples_ET.mat, Diary, 120, 8287727581, 8405125629, 117398048
/Volumes/methlab_data/HBN/EEG-ET/NDARDG747ULB/NDARDG747ULB_Video-DM_Samples_ET.mat, Despicable, 60, 4699713391, 4870256864, 170543473
/Volumes/methlab_data/HBN/EEG-ET/NDARDG747ULB/NDARDG747ULB_Video-FF_Samples_ET.mat, Fractals, 60, 3638341748, 3801322896, 162981148
/Volumes/methlab_data/HBN/EEG-ET/NDARDG747ULB/NDARDG747ULB_Video-TP_Samples_ET.mat, Present, 60, 5211137598, 5414196048, 203058450
/Volumes/methlab_data/HBN/EEG-ET/NDARDG747ULB/NDARDG747ULB_Video-WK_Samples_ET.mat, Diary, 60, 4305998317, 4423397254, 117398937
/Volumes/methlab_data/HBN/EEG-ET/NDARDG929LYJ/NDARDG929LYJ_Video1_Samples_ET.mat, Despicable, 120, 5311312244, 5481855469, 170543225
/Volumes/methlab_data/HBN/EEG-ET/NDARDG929LYJ/NDARDG929LYJ_Video2_Samples_ET.mat, Diary, 120, 5740663087, 5858050180, 117387093
/Volumes/methlab_data/HBN/EEG-ET/NDARDG929LYJ/NDARDG929LYJ_Video3_Samples_ET.mat, Fractals, 120, 5904280329, 6067267472, 162987143
/Volumes/methlab_data/HBN/EEG-ET/NDARDG929LYJ/NDARDG929LYJ_Video4_Samples_ET.mat, Present, 120, 6163727911, 6366795027, 203067116
/Volumes/methlab_data/HBN/EEG-ET/NDARDH086ZKK/NDARDH086ZKK_Video1_Samples_ET.mat, Fractals, 120, 5435847861, 5598835058, 162987197
/Volumes/methlab_data/HBN/EEG-ET/NDARDH086ZKK/NDARDH086ZKK_Video2_Samples_ET.mat, Despicable, 120, 6161443893, 6332001127, 170557234
/Volumes/methlab_data/HBN/EEG-ET/NDARDH086ZKK/NDARDH086ZKK_Video3_Samples_ET.mat, Diary, 120, 6556191165, 6673589497, 117398332
/Volumes/methlab_data/HBN/EEG-ET/NDARDH086ZKK/NDARDH086ZKK_Video4_Samples_ET.mat, Present, 120, 7116818059, 7319885689, 203067630
/Volumes/methlab_data/HBN/EEG-ET/NDARDH214UVC/NDARDH214UVC_Video-DM_Samples_ET.mat, Despicable, 60, 5155652344, 5326197839, 170545495
/Volumes/methlab_data/HBN/EEG-ET/NDARDH214UVC/NDARDH214UVC_Video-FF_Samples_ET.mat, Fractals, 60, 4664648555, 4827634695, 162986140
/Volumes/methlab_data/HBN/EEG-ET/NDARDH214UVC/NDARDH214UVC_Video-TP_Samples_ET.mat, Present, 60, 5730786566, 5933845003, 203058437
/Volumes/methlab_data/HBN/EEG-ET/NDARDH214UVC/NDARDH214UVC_Video-WK_Samples_ET.mat, Diary, 60, 4022016677, 4139408602, 117391925
/Volumes/methlab_data/HBN/EEG-ET/NDARDH220WVH/NDARDH220WVH_Video-DM_Samples_ET.mat, Despicable, 60, 5588753866, 5759296669, 170542803
/Volumes/methlab_data/HBN/EEG-ET/NDARDH220WVH/NDARDH220WVH_Video-FF_Samples_ET.mat, Fractals, 60, 4231905754, 4394891300, 162985546
/Volumes/methlab_data/HBN/EEG-ET/NDARDH220WVH/NDARDH220WVH_Video-TP_Samples_ET.mat, Present, 60, 6583022147, 6786084000, 203061853
/Volumes/methlab_data/HBN/EEG-ET/NDARDH220WVH/NDARDH220WVH_Video-WK_Samples_ET.mat, Diary, 60, 6080447136, 6197842349, 117395213
/Volumes/methlab_data/HBN/EEG-ET/NDARDH305AV2/NDARDH305AV2_Video-DM_Samples_ET.mat, Despicable, 60, 2314016338, 2484555798, 170539460
/Volumes/methlab_data/HBN/EEG-ET/NDARDH305AV2/NDARDH305AV2_Video-FF_Samples_ET.mat, Fractals, 60, 1699593400, 1862580496, 162987096
/Volumes/methlab_data/HBN/EEG-ET/NDARDH305AV2/NDARDH305AV2_Video-TP_Samples_ET.mat, Present, 60, 3249191820, 3452262285, 203070465
/Volumes/methlab_data/HBN/EEG-ET/NDARDH305AV2/NDARDH305AV2_Video-WK_Samples_ET.mat, Diary, 60, 2797498811, 2914888735, 117389924
/Volumes/methlab_data/HBN/EEG-ET/NDARDH670PXH/NDARDH670PXH_Video1_Samples_ET.mat, Despicable, 120, 3589223770, 3759770442, 170546672
/Volumes/methlab_data/HBN/EEG-ET/NDARDH670PXH/NDARDH670PXH_Video2_Samples_ET.mat, Diary, 120, 4695605839, 4813003338, 117397499
/Volumes/methlab_data/HBN/EEG-ET/NDARDH670PXH/NDARDH670PXH_Video3_Samples_ET.mat, Fractals, 120, 5292082749, 5455079775, 162997026
/Volumes/methlab_data/HBN/EEG-ET/NDARDH670PXH/NDARDH670PXH_Video4_Samples_ET.mat, Present, 120, 5875878051, 6078955524, 203077473
/Volumes/methlab_data/HBN/EEG-ET/NDARDH934MUV/NDARDH934MUV_Video1_Samples_ET.mat, Diary, 60, 5479766544, 5597160446, 117393902
/Volumes/methlab_data/HBN/EEG-ET/NDARDH934MUV/NDARDH934MUV_Video3_Samples_ET.mat, Despicable, 60, 5055042835, 5225582180, 170539345
/Volumes/methlab_data/HBN/EEG-ET/NDARDJ092YKH/NDARDJ092YKH_Video1_Samples_ET.mat, Diary, 60, 19514368749, 19631767040, 117398291
/Volumes/methlab_data/HBN/EEG-ET/NDARDJ092YKH/NDARDJ092YKH_Video3_Samples_ET.mat, Despicable, 60, 19068046172, 19238587240, 170541068
/Volumes/methlab_data/HBN/EEG-ET/NDARDJ092YKH/NDARDJ092YKH_Video4_Samples_ET.mat, Present, 60, 20187738396, 20390802446, 203064050
/Volumes/methlab_data/HBN/EEG-ET/NDARDJ204EPU/NDARDJ204EPU_Video-DM_Samples_ET.mat, Despicable, 60, 4459439030, 4629976615, 170537585
/Volumes/methlab_data/HBN/EEG-ET/NDARDJ204EPU/NDARDJ204EPU_Video-TP_Samples_ET.mat, Present, 60, 5035544097, 5238810766, 203266669
/Volumes/methlab_data/HBN/EEG-ET/NDARDJ204EPU/NDARDJ204EPU_Video-WK_Samples_ET.mat, Diary, 60, 3183131099, 3300520087, 117388988
/Volumes/methlab_data/HBN/EEG-ET/NDARDJ544BU5/NDARDJ544BU5_Video-DM_Samples_ET.mat, Despicable, 60, 3887390114, 4057930818, 170540704
/Volumes/methlab_data/HBN/EEG-ET/NDARDJ544BU5/NDARDJ544BU5_Video-TP_Samples_ET.mat, Present, 60, 4393385163, 4596656040, 203270877
/Volumes/methlab_data/HBN/EEG-ET/NDARDJ544BU5/NDARDJ544BU5_Video-WK_Samples_ET.mat, Diary, 60, 2740141308, 2857530405, 117389097
/Volumes/methlab_data/HBN/EEG-ET/NDARDJ585AVY/NDARDJ585AVY_Video1_Samples_ET.mat, Diary, 120, 6728493304, 6845890176, 117396872
/Volumes/methlab_data/HBN/EEG-ET/NDARDJ585AVY/NDARDJ585AVY_Video2_Samples_ET.mat, Fractals, 120, 6919410447, 7082407947, 162997500
/Volumes/methlab_data/HBN/EEG-ET/NDARDJ585AVY/NDARDJ585AVY_Video3_Samples_ET.mat, Despicable, 120, 7111029549, 7281577398, 170547849
/Volumes/methlab_data/HBN/EEG-ET/NDARDJ825GBP/NDARDJ825GBP_Video1_Samples_ET.mat, Diary, 60, 2488686230, 2606084373, 117398143
/Volumes/methlab_data/HBN/EEG-ET/NDARDJ825GBP/NDARDJ825GBP_Video3_Samples_ET.mat, Despicable, 60, 2113710765, 2284262536, 170551771
/Volumes/methlab_data/HBN/EEG-ET/NDARDJ947WXC/NDARDJ947WXC_Video1_Samples_ET.mat, Despicable, 120, 3470161374, 3640708951, 170547577
/Volumes/methlab_data/HBN/EEG-ET/NDARDJ947WXC/NDARDJ947WXC_Video2_Samples_ET.mat, Fractals, 120, 4313166094, 4476153360, 162987266
/Volumes/methlab_data/HBN/EEG-ET/NDARDJ947WXC/NDARDJ947WXC_Video3_Samples_ET.mat, Diary, 120, 4527345034, 4644741589, 117396555
/Volumes/methlab_data/HBN/EEG-ET/NDARDJ947WXC/NDARDJ947WXC_Video4_Samples_ET.mat, Present, 120, 4690143730, 4893210898, 203067168
/Volumes/methlab_data/HBN/EEG-ET/NDARDJ970ELG/NDARDJ970ELG_Video-DM_Samples_ET.mat, Despicable, 60, 4948582183, 5119120001, 170537818
/Volumes/methlab_data/HBN/EEG-ET/NDARDJ970ELG/NDARDJ970ELG_Video-FF_Samples_ET.mat, Fractals, 60, 5386886071, 5549872317, 162986246
/Volumes/methlab_data/HBN/EEG-ET/NDARDJ970ELG/NDARDJ970ELG_Video-TP_Samples_ET.mat, Present, 60, 5871735870, 6074806450, 203070580
/Volumes/methlab_data/HBN/EEG-ET/NDARDJ970ELG/NDARDJ970ELG_Video-WK_Samples_ET.mat, Diary, 60, 4354898457, 4472285465, 117387008
/Volumes/methlab_data/HBN/EEG-ET/NDARDK197BHM/NDARDK197BHM_Video1_Samples_ET.mat, Diary, 120, 3096307073, 3213703531, 117396458
/Volumes/methlab_data/HBN/EEG-ET/NDARDK197BHM/NDARDK197BHM_Video2_Samples_ET.mat, Fractals, 120, 4003459843, 4166447770, 162987927
/Volumes/methlab_data/HBN/EEG-ET/NDARDK197BHM/NDARDK197BHM_Video3_Samples_ET.mat, Despicable, 120, 4379248595, 4549805628, 170557033
/Volumes/methlab_data/HBN/EEG-ET/NDARDK197BHM/NDARDK197BHM_Video4_Samples_ET.mat, Present, 120, 5015274950, 5218341425, 203066475
/Volumes/methlab_data/HBN/EEG-ET/NDARDK794WV3/NDARDK794WV3_Video-DM_Samples_ET.mat, Despicable, 30, 4432198741, 4602736308, 170537567
/Volumes/methlab_data/HBN/EEG-ET/NDARDK794WV3/NDARDK794WV3_Video-TP_Samples_ET.mat, Present, 30, 5309301844, 5512569584, 203267740
/Volumes/methlab_data/HBN/EEG-ET/NDARDK794WV3/NDARDK794WV3_Video-WK_Samples_ET.mat, Diary, 30, 4859565878, 4976952885, 117387007
/Volumes/methlab_data/HBN/EEG-ET/NDARDL129FV3/NDARDL129FV3_Video1_Samples_ET.mat, Diary, 60, 4699511390, 4816900479, 117389089
/Volumes/methlab_data/HBN/EEG-ET/NDARDL129FV3/NDARDL129FV3_Video3_Samples_ET.mat, Despicable, 60, 4167358834, 4337907542, 170548708
/Volumes/methlab_data/HBN/EEG-ET/NDARDL129FV3/NDARDL129FV3_Video4_Samples_ET.mat, Present, 60, 5136394556, 5339466291, 203071735
/Volumes/methlab_data/HBN/EEG-ET/NDARDL305BT8/NDARDL305BT8_Video1_Samples_ET.mat, Diary, 120, 4913468904, 5030855449, 117386545
/Volumes/methlab_data/HBN/EEG-ET/NDARDL305BT8/NDARDL305BT8_Video2_Samples_ET.mat, Fractals, 120, 5652702774, 5815691543, 162988769
/Volumes/methlab_data/HBN/EEG-ET/NDARDL305BT8/NDARDL305BT8_Video3_Samples_ET.mat, Despicable, 120, 6354948716, 6525491757, 170543041
/Volumes/methlab_data/HBN/EEG-ET/NDARDL305BT8/NDARDL305BT8_Video4_Samples_ET.mat, Present, 120, 7381124195, 7584192556, 203068361
/Volumes/methlab_data/HBN/EEG-ET/NDARDL377ZT7/NDARDL377ZT7_Video-DM_Samples_ET.mat, Despicable, 30, 5213282332, 5383818920, 170536588
/Volumes/methlab_data/HBN/EEG-ET/NDARDL377ZT7/NDARDL377ZT7_Video-TP_Samples_ET.mat, Present, 30, 5692208934, 5895475665, 203266731
/Volumes/methlab_data/HBN/EEG-ET/NDARDL377ZT7/NDARDL377ZT7_Video-WK_Samples_ET.mat, Diary, 30, 4329252328, 4446640345, 117388017
/Volumes/methlab_data/HBN/EEG-ET/NDARDL389KT5/NDARDL389KT5_Video-DM_Samples_ET.mat, Despicable, 30, 5190711797, 5361247096, 170535299
/Volumes/methlab_data/HBN/EEG-ET/NDARDL389KT5/NDARDL389KT5_Video-TP_Samples_ET.mat, Present, 30, 6130762723, 6334035128, 203272405
/Volumes/methlab_data/HBN/EEG-ET/NDARDL389KT5/NDARDL389KT5_Video-WK_Samples_ET.mat, Diary, 30, 5683124076, 5800513910, 117389834
/Volumes/methlab_data/HBN/EEG-ET/NDARDL511UND/NDARDL511UND_Video1_Samples_ET.mat, Diary, 120, 2967824178, 3085222121, 117397943
/Volumes/methlab_data/HBN/EEG-ET/NDARDL511UND/NDARDL511UND_Video2_Samples_ET.mat, Despicable, 120, 4335329820, 4505873017, 170543197
/Volumes/methlab_data/HBN/EEG-ET/NDARDL511UND/NDARDL511UND_Video3_Samples_ET.mat, Fractals, 120, 4778661774, 4941648804, 162987030
/Volumes/methlab_data/HBN/EEG-ET/NDARDL511UND/NDARDL511UND_Video4_Samples_ET.mat, Present, 120, 5443768058, 5646835079, 203067021
/Volumes/methlab_data/HBN/EEG-ET/NDARDL862DP6/NDARDL862DP6_Video1_Samples_ET.mat, Diary, 60, 6832160717, 6949556235, 117395518
/Volumes/methlab_data/HBN/EEG-ET/NDARDL862DP6/NDARDL862DP6_Video3_Samples_ET.mat, Despicable, 60, 7916598867, 8087140161, 170541294
/Volumes/methlab_data/HBN/EEG-ET/NDARDM118LR6/NDARDM118LR6_Video1_Samples_ET.mat, Diary, 60, 1895764645, 2013153659, 117389014
/Volumes/methlab_data/HBN/EEG-ET/NDARDM118LR6/NDARDM118LR6_Video2_Samples_ET.mat, Fractals, 60, 2878619516, 3041610811, 162991295
/Volumes/methlab_data/HBN/EEG-ET/NDARDM118LR6/NDARDM118LR6_Video3_Samples_ET.mat, Despicable, 60, 2434778733, 2605317309, 170538576
/Volumes/methlab_data/HBN/EEG-ET/NDARDM118LR6/NDARDM118LR6_Video4_Samples_ET.mat, Present, 60, 3355298540, 3558363120, 203064580
/Volumes/methlab_data/HBN/EEG-ET/NDARDM156AVJ/NDARDM156AVJ_Video-DM_Samples_ET.mat, Despicable, 120, 13600654033, 13771200902, 170546869
/Volumes/methlab_data/HBN/EEG-ET/NDARDM156AVJ/NDARDM156AVJ_Video-FF_Samples_ET.mat, Fractals, 120, 13017808640, 13180794575, 162985935
/Volumes/methlab_data/HBN/EEG-ET/NDARDM156AVJ/NDARDM156AVJ_Video-TP_Samples_ET.mat, Present, 120, 14740457637, 14943524193, 203066556
/Volumes/methlab_data/HBN/EEG-ET/NDARDM156AVJ/NDARDM156AVJ_Video-WK_Samples_ET.mat, Diary, 120, 14115321284, 14232718367, 117397083
/Volumes/methlab_data/HBN/EEG-ET/NDARDM385EK2/NDARDM385EK2_Video1_Samples_ET.mat, Diary, 60, 28166984700, 28284387993, 117403293
/Volumes/methlab_data/HBN/EEG-ET/NDARDM385EK2/NDARDM385EK2_Video3_Samples_ET.mat, Despicable, 60, 27666642247, 27837187711, 170545464
/Volumes/methlab_data/HBN/EEG-ET/NDARDM425CG2/NDARDM425CG2_Video1_Samples_ET.mat, Diary, 60, 2969476470, 3086872399, 117395929
/Volumes/methlab_data/HBN/EEG-ET/NDARDM425CG2/NDARDM425CG2_Video3_Samples_ET.mat, Despicable, 60, 2524695297, 2695235775, 170540478
/Volumes/methlab_data/HBN/EEG-ET/NDARDM756PPD/NDARDM756PPD_Video-DM_Samples_ET.mat, Despicable, 30, 2053578311, 2224115468, 170537157
/Volumes/methlab_data/HBN/EEG-ET/NDARDM756PPD/NDARDM756PPD_Video-TP_Samples_ET.mat, Present, 30, 2656603691, 2859882109, 203278418
/Volumes/methlab_data/HBN/EEG-ET/NDARDM756PPD/NDARDM756PPD_Video-WK_Samples_ET.mat, Diary, 30, 2494893817, 2612281228, 117387411
/Volumes/methlab_data/HBN/EEG-ET/NDARDN393BJH/NDARDN393BJH_Video1_Samples_ET.mat, Diary, 60, 2689494133, 2806888160, 117394027
/Volumes/methlab_data/HBN/EEG-ET/NDARDN393BJH/NDARDN393BJH_Video2_Samples_ET.mat, Fractals, 60, 3363231486, 3526223730, 162992244
/Volumes/methlab_data/HBN/EEG-ET/NDARDN393BJH/NDARDN393BJH_Video3_Samples_ET.mat, Despicable, 60, 3800854874, 3971397460, 170542586
/Volumes/methlab_data/HBN/EEG-ET/NDARDN393BJH/NDARDN393BJH_Video4_Samples_ET.mat, Present, 60, 4263011609, 4466082203, 203070594
/Volumes/methlab_data/HBN/EEG-ET/NDARDN489EXJ/NDARDN489EXJ_Video1_Samples_ET.mat, Diary, 60, 3605543857, 3722941883, 117398026
/Volumes/methlab_data/HBN/EEG-ET/NDARDN489EXJ/NDARDN489EXJ_Video3_Samples_ET.mat, Despicable, 60, 3183257440, 3353813029, 170555589
/Volumes/methlab_data/HBN/EEG-ET/NDARDN489EXJ/NDARDN489EXJ_Video4_Samples_ET.mat, Present, 60, 4030954471, 4234024972, 203070501
/Volumes/methlab_data/HBN/EEG-ET/NDARDN702GXX/NDARDN702GXX_Video1_Samples_ET.mat, Diary, 60, 2568091389, 2685485445, 117394056
/Volumes/methlab_data/HBN/EEG-ET/NDARDN702GXX/NDARDN702GXX_Video3_Samples_ET.mat, Despicable, 60, 3840661432, 4011204068, 170542636
/Volumes/methlab_data/HBN/EEG-ET/NDARDN924BV2/NDARDN924BV2_Video1_Samples_ET.mat, Fractals, 120, 6736007799, 6898992893, 162985094
/Volumes/methlab_data/HBN/EEG-ET/NDARDN924BV2/NDARDN924BV2_Video2_Samples_ET.mat, Despicable, 120, 7694150124, 7864691545, 170541421
/Volumes/methlab_data/HBN/EEG-ET/NDARDN924BV2/NDARDN924BV2_Video3_Samples_ET.mat, Diary, 120, 8192523244, 8309920518, 117397274
/Volumes/methlab_data/HBN/EEG-ET/NDARDN924BV2/NDARDN924BV2_Video4_Samples_ET.mat, Present, 120, 8776519390, 8979586743, 203067353
/Volumes/methlab_data/HBN/EEG-ET/NDARDN996CPF/NDARDN996CPF_Video-DM_Samples_ET.mat, Despicable, 60, 4569291307, 4739828888, 170537581
/Volumes/methlab_data/HBN/EEG-ET/NDARDN996CPF/NDARDN996CPF_Video-FF_Samples_ET.mat, Fractals, 60, 5024302977, 5187291267, 162988290
/Volumes/methlab_data/HBN/EEG-ET/NDARDN996CPF/NDARDN996CPF_Video-TP_Samples_ET.mat, Present, 60, 5524953978, 5728024526, 203070548
/Volumes/methlab_data/HBN/EEG-ET/NDARDN996CPF/NDARDN996CPF_Video-WK_Samples_ET.mat, Diary, 60, 4013876608, 4131263628, 117387020
/Volumes/methlab_data/HBN/EEG-ET/NDARDP292DVC/NDARDP292DVC_Video-DM_Samples_ET.mat, Despicable, 60, 2898879067, 3069427448, 170548381
/Volumes/methlab_data/HBN/EEG-ET/NDARDP292DVC/NDARDP292DVC_Video-FF_Samples_ET.mat, Fractals, 60, 2440513492, 2603499601, 162986109
/Volumes/methlab_data/HBN/EEG-ET/NDARDP292DVC/NDARDP292DVC_Video-TP_Samples_ET.mat, Present, 60, 3361492618, 3564562012, 203069394
/Volumes/methlab_data/HBN/EEG-ET/NDARDP292DVC/NDARDP292DVC_Video-WK_Samples_ET.mat, Diary, 60, 2027096630, 2144482501, 117385871
/Volumes/methlab_data/HBN/EEG-ET/NDARDP495PY2/NDARDP495PY2_Video-DM_Samples_ET.mat, Despicable, 60, 4694902968, 4865440231, 170537263
/Volumes/methlab_data/HBN/EEG-ET/NDARDP495PY2/NDARDP495PY2_Video-TP_Samples_ET.mat, Present, 60, 5773601673, 5976869039, 203267366
/Volumes/methlab_data/HBN/EEG-ET/NDARDP495PY2/NDARDP495PY2_Video-WK_Samples_ET.mat, Diary, 60, 3940574983, 4057962788, 117387805
/Volumes/methlab_data/HBN/EEG-ET/NDARDP725ZVY/NDARDP725ZVY_Video-DM_Samples_ET.mat, Despicable, 60, 3318825210, 3489362502, 170537292
/Volumes/methlab_data/HBN/EEG-ET/NDARDP725ZVY/NDARDP725ZVY_Video-FF_Samples_ET.mat, Fractals, 60, 3092041353, 3255029225, 162987872
/Volumes/methlab_data/HBN/EEG-ET/NDARDP725ZVY/NDARDP725ZVY_Video-TP_Samples_ET.mat, Present, 60, 4182889565, 4385960790, 203071225
/Volumes/methlab_data/HBN/EEG-ET/NDARDP725ZVY/NDARDP725ZVY_Video-WK_Samples_ET.mat, Diary, 60, 3540692667, 3658086467, 117393800
/Volumes/methlab_data/HBN/EEG-ET/NDARDR067YMC/NDARDR067YMC_Video1_Samples_ET.mat, Diary, 120, 2789332755, 2906721374, 117388619
/Volumes/methlab_data/HBN/EEG-ET/NDARDR067YMC/NDARDR067YMC_Video2_Samples_ET.mat, Fractals, 120, 4786869781, 4949857253, 162987472
/Volumes/methlab_data/HBN/EEG-ET/NDARDR067YMC/NDARDR067YMC_Video3_Samples_ET.mat, Despicable, 120, 5229537947, 5400084437, 170546490
/Volumes/methlab_data/HBN/EEG-ET/NDARDR067YMC/NDARDR067YMC_Video4_Samples_ET.mat, Present, 120, 5897523411, 6100590589, 203067178
/Volumes/methlab_data/HBN/EEG-ET/NDARDR103FJQ/NDARDR103FJQ_Video-DM_Samples_ET.mat, Despicable, 30, 4372218426, 4542755777, 170537351
/Volumes/methlab_data/HBN/EEG-ET/NDARDR103FJQ/NDARDR103FJQ_Video-TP_Samples_ET.mat, Present, 30, 4976670927, 5179948368, 203277441
/Volumes/methlab_data/HBN/EEG-ET/NDARDR103FJQ/NDARDR103FJQ_Video-WK_Samples_ET.mat, Diary, 30, 3185351012, 3302737856, 117386844
/Volumes/methlab_data/HBN/EEG-ET/NDARDR236FWH/NDARDR236FWH_Video-DM_Samples_ET.mat, Despicable, 60, 6474044517, 6644596312, 170551795
/Volumes/methlab_data/HBN/EEG-ET/NDARDR236FWH/NDARDR236FWH_Video-FF_Samples_ET.mat, Fractals, 60, 6008251770, 6171240174, 162988404
/Volumes/methlab_data/HBN/EEG-ET/NDARDR236FWH/NDARDR236FWH_Video-TP_Samples_ET.mat, Present, 60, 6994865265, 7197926094, 203060829
/Volumes/methlab_data/HBN/EEG-ET/NDARDR236FWH/NDARDR236FWH_Video-WK_Samples_ET.mat, Diary, 60, 5089421241, 5206813379, 117392138
/Volumes/methlab_data/HBN/EEG-ET/NDARDR240WKM/NDARDR240WKM_Video-DM_Samples_ET.mat, Despicable, 120, 12427787663, 12598333443, 170545780
/Volumes/methlab_data/HBN/EEG-ET/NDARDR240WKM/NDARDR240WKM_Video-FF_Samples_ET.mat, Fractals, 120, 11724951800, 11887947631, 162995831
/Volumes/methlab_data/HBN/EEG-ET/NDARDR240WKM/NDARDR240WKM_Video-TP_Samples_ET.mat, Present, 120, 13657508569, 13860575635, 203067066
/Volumes/methlab_data/HBN/EEG-ET/NDARDR296XHN/NDARDR296XHN_Video1_Samples_ET.mat, Diary, 60, 7633193384, 7750584707, 117391323
/Volumes/methlab_data/HBN/EEG-ET/NDARDR296XHN/NDARDR296XHN_Video3_Samples_ET.mat, Despicable, 60, 7201520032, 7372071081, 170551049
/Volumes/methlab_data/HBN/EEG-ET/NDARDR304HHJ/NDARDR304HHJ_Video-DM_Samples_ET.mat, Despicable, 60, 4044891686, 4215428209, 170536523
/Volumes/methlab_data/HBN/EEG-ET/NDARDR304HHJ/NDARDR304HHJ_Video-TP_Samples_ET.mat, Present, 60, 4887394142, 5090660679, 203266537
/Volumes/methlab_data/HBN/EEG-ET/NDARDR304HHJ/NDARDR304HHJ_Video-WK_Samples_ET.mat, Diary, 60, 4473395463, 4590786453, 117390990
/Volumes/methlab_data/HBN/EEG-ET/NDARDR439HY2/NDARDR439HY2_Video-DM_Samples_ET.mat, Despicable, 120, 5147878682, 5318424565, 170545883
/Volumes/methlab_data/HBN/EEG-ET/NDARDR439HY2/NDARDR439HY2_Video-FF_Samples_ET.mat, Fractals, 120, 4168154510, 4331140805, 162986295
/Volumes/methlab_data/HBN/EEG-ET/NDARDR439HY2/NDARDR439HY2_Video-TP_Samples_ET.mat, Present, 120, 6162771224, 6365839041, 203067817
/Volumes/methlab_data/HBN/EEG-ET/NDARDR439HY2/NDARDR439HY2_Video-WK_Samples_ET.mat, Diary, 120, 5581823095, 5699212655, 117389560
/Volumes/methlab_data/HBN/EEG-ET/NDARDR458MR7/NDARDR458MR7_Video1_Samples_ET.mat, Diary, 60, 5515288608, 5632679123, 117390515
/Volumes/methlab_data/HBN/EEG-ET/NDARDR458MR7/NDARDR458MR7_Video3_Samples_ET.mat, Despicable, 60, 4982211394, 5152754747, 170543353
/Volumes/methlab_data/HBN/EEG-ET/NDARDR458MR7/NDARDR458MR7_Video4_Samples_ET.mat, Present, 60, 5958164676, 6161224102, 203059426
/Volumes/methlab_data/HBN/EEG-ET/NDARDR591AUC/NDARDR591AUC_Video-DM_Samples_ET.mat, Despicable, 60, 3320169286, 3490714831, 170545545
/Volumes/methlab_data/HBN/EEG-ET/NDARDR591AUC/NDARDR591AUC_Video-FF_Samples_ET.mat, Fractals, 60, 2108674186, 2271659425, 162985239
/Volumes/methlab_data/HBN/EEG-ET/NDARDR591AUC/NDARDR591AUC_Video-TP_Samples_ET.mat, Present, 60, 3839293124, 4042362649, 203069525
/Volumes/methlab_data/HBN/EEG-ET/NDARDR591AUC/NDARDR591AUC_Video-WK_Samples_ET.mat, Diary, 60, 2865727162, 2983122156, 117394994
/Volumes/methlab_data/HBN/EEG-ET/NDARDR595ZE5/NDARDR595ZE5_Video-DM_Samples_ET.mat, Despicable, 120, 4120539835, 4291086370, 170546535
/Volumes/methlab_data/HBN/EEG-ET/NDARDR595ZE5/NDARDR595ZE5_Video-FF_Samples_ET.mat, Fractals, 120, 2811338251, 2974324594, 162986343
/Volumes/methlab_data/HBN/EEG-ET/NDARDR595ZE5/NDARDR595ZE5_Video-TP_Samples_ET.mat, Present, 120, 4824664681, 5027731913, 203067232
/Volumes/methlab_data/HBN/EEG-ET/NDARDR595ZE5/NDARDR595ZE5_Video-WK_Samples_ET.mat, Diary, 120, 3590232611, 3707629247, 117396636
/Volumes/methlab_data/HBN/EEG-ET/NDARDR804MFE/NDARDR804MFE_Video1_Samples_ET.mat, Diary, 120, 8939261618, 9056651336, 117389718
/Volumes/methlab_data/HBN/EEG-ET/NDARDR804MFE/NDARDR804MFE_Video2_Samples_ET.mat, Fractals, 120, 9606716116, 9769707003, 162990887
/Volumes/methlab_data/HBN/EEG-ET/NDARDR804MFE/NDARDR804MFE_Video3_Samples_ET.mat, Despicable, 120, 10119966967, 10290514695, 170547728
/Volumes/methlab_data/HBN/EEG-ET/NDARDR804MFE/NDARDR804MFE_Video4_Samples_ET.mat, Present, 120, 10788908605, 10991970689, 203062084
/Volumes/methlab_data/HBN/EEG-ET/NDARDT499DWP/NDARDT499DWP_Video1_Samples_ET.mat, Diary, 60, 4605598749, 4722993893, 117395144
/Volumes/methlab_data/HBN/EEG-ET/NDARDT499DWP/NDARDT499DWP_Video2_Samples_ET.mat, Fractals, 60, 3693459961, 3856451395, 162991434
/Volumes/methlab_data/HBN/EEG-ET/NDARDT499DWP/NDARDT499DWP_Video3_Samples_ET.mat, Despicable, 60, 4974598987, 5145149756, 170550769
/Volumes/methlab_data/HBN/EEG-ET/NDARDT499DWP/NDARDT499DWP_Video4_Samples_ET.mat, Present, 60, 5443072659, 5646144441, 203071782
/Volumes/methlab_data/HBN/EEG-ET/NDARDT528ZZJ/NDARDT528ZZJ_Video1_Samples_ET.mat, Diary, 60, 1939831858, 2057225960, 117394102
/Volumes/methlab_data/HBN/EEG-ET/NDARDT528ZZJ/NDARDT528ZZJ_Video3_Samples_ET.mat, Despicable, 60, 1495864584, 1666388020, 170523436
/Volumes/methlab_data/HBN/EEG-ET/NDARDT550XYX/NDARDT550XYX_Video-TP_Samples_ET.mat, Present, 30, 3538615924, 3741886335, 203270411
/Volumes/methlab_data/HBN/EEG-ET/NDARDT550XYX/NDARDT550XYX_Video-WK_Samples_ET.mat, Diary, 30, 2090854472, 2208241839, 117387367
/Volumes/methlab_data/HBN/EEG-ET/NDARDU314YVY/NDARDU314YVY_Video-DM_Samples_ET.mat, Despicable, 30, 4001248064, 4171785654, 170537590
/Volumes/methlab_data/HBN/EEG-ET/NDARDU314YVY/NDARDU314YVY_Video-WK_Samples_ET.mat, Diary, 30, 3697473295, 3814860310, 117387015
/Volumes/methlab_data/HBN/EEG-ET/NDARDU482DGK/NDARDU482DGK_Video-DM_Samples_ET.mat, Despicable, 120, 4418808637, 4589355975, 170547338
/Volumes/methlab_data/HBN/EEG-ET/NDARDU482DGK/NDARDU482DGK_Video-FF_Samples_ET.mat, Fractals, 120, 3922990965, 4085978763, 162987798
/Volumes/methlab_data/HBN/EEG-ET/NDARDU482DGK/NDARDU482DGK_Video-TP_Samples_ET.mat, Present, 120, 5110074547, 5313140959, 203066412
/Volumes/methlab_data/HBN/EEG-ET/NDARDU482DGK/NDARDU482DGK_Video-WK_Samples_ET.mat, Diary, 120, 3100708005, 3218104862, 117396857
/Volumes/methlab_data/HBN/EEG-ET/NDARDU566NUY/NDARDU566NUY_Video-DM_Samples_ET.mat, Despicable, 60, 5755380596, 5925931018, 170550422
/Volumes/methlab_data/HBN/EEG-ET/NDARDU566NUY/NDARDU566NUY_Video-FF_Samples_ET.mat, Fractals, 60, 6151782441, 6314770519, 162988078
/Volumes/methlab_data/HBN/EEG-ET/NDARDU566NUY/NDARDU566NUY_Video-TP_Samples_ET.mat, Present, 60, 6359962395, 6563032769, 203070374
/Volumes/methlab_data/HBN/EEG-ET/NDARDU566NUY/NDARDU566NUY_Video-WK_Samples_ET.mat, Diary, 60, 5991094004, 6108480889, 117386885
/Volumes/methlab_data/HBN/EEG-ET/NDARDU602LPX/NDARDU602LPX_Video-DM_Samples_ET.mat, Despicable, 120, 3324270693, 3494817070, 170546377
/Volumes/methlab_data/HBN/EEG-ET/NDARDU602LPX/NDARDU602LPX_Video-FF_Samples_ET.mat, Fractals, 120, 4827020812, 4990017001, 162996189
/Volumes/methlab_data/HBN/EEG-ET/NDARDU602LPX/NDARDU602LPX_Video-TP_Samples_ET.mat, Present, 120, 5512547275, 5715610872, 203063597
/Volumes/methlab_data/HBN/EEG-ET/NDARDU602LPX/NDARDU602LPX_Video-WK_Samples_ET.mat, Diary, 120, 4289045344, 4406434923, 117389579
/Volumes/methlab_data/HBN/EEG-ET/NDARDU617ZW1/NDARDU617ZW1_Video-DM_Samples_ET.mat, Despicable, 60, 4248453229, 4418994830, 170541601
/Volumes/methlab_data/HBN/EEG-ET/NDARDU617ZW1/NDARDU617ZW1_Video-FF_Samples_ET.mat, Fractals, 60, 3633411376, 3796393623, 162982247
/Volumes/methlab_data/HBN/EEG-ET/NDARDU617ZW1/NDARDU617ZW1_Video-TP_Samples_ET.mat, Present, 60, 5134021348, 5337091903, 203070555
/Volumes/methlab_data/HBN/EEG-ET/NDARDU617ZW1/NDARDU617ZW1_Video-WK_Samples_ET.mat, Diary, 60, 4687216431, 4804610451, 117394020
/Volumes/methlab_data/HBN/EEG-ET/NDARDU760YZC/NDARDU760YZC_Video1_Samples_ET.mat, Diary, 60, 3315652456, 3433049458, 117397002
/Volumes/methlab_data/HBN/EEG-ET/NDARDU760YZC/NDARDU760YZC_Video3_Samples_ET.mat, Despicable, 60, 4282591773, 4453145293, 170553520
/Volumes/methlab_data/HBN/EEG-ET/NDARDU760YZC/NDARDU760YZC_Video4_Samples_ET.mat, Present, 60, 4773287500, 4976357997, 203070497
/Volumes/methlab_data/HBN/EEG-ET/NDARDU853XZ6/NDARDU853XZ6_Video1_Samples_ET.mat, Diary, 60, 2895144818, 3012537565, 117392747
/Volumes/methlab_data/HBN/EEG-ET/NDARDU853XZ6/NDARDU853XZ6_Video2_Samples_ET.mat, Fractals, 60, 3425809266, 3588802546, 162993280
/Volumes/methlab_data/HBN/EEG-ET/NDARDU853XZ6/NDARDU853XZ6_Video3_Samples_ET.mat, Despicable, 60, 3892003740, 4062549382, 170545642
/Volumes/methlab_data/HBN/EEG-ET/NDARDU853XZ6/NDARDU853XZ6_Video4_Samples_ET.mat, Present, 60, 4392502664, 4595577504, 203074840
/Volumes/methlab_data/HBN/EEG-ET/NDARDV204BYM/NDARDV204BYM_Video-DM_Samples_ET.mat, Despicable, 120, 4141083948, 4311631122, 170547174
/Volumes/methlab_data/HBN/EEG-ET/NDARDV204BYM/NDARDV204BYM_Video-FF_Samples_ET.mat, Fractals, 120, 3330889794, 3493876291, 162986497
/Volumes/methlab_data/HBN/EEG-ET/NDARDV204BYM/NDARDV204BYM_Video-TP_Samples_ET.mat, Present, 120, 5365806593, 5568873135, 203066542
/Volumes/methlab_data/HBN/EEG-ET/NDARDV204BYM/NDARDV204BYM_Video-WK_Samples_ET.mat, Diary, 120, 4699869919, 4817277498, 117407579
/Volumes/methlab_data/HBN/EEG-ET/NDARDV222JZ6/NDARDV222JZ6_Video1_Samples_ET.mat, Diary, 120, 2618586075, 2735981648, 117395573
/Volumes/methlab_data/HBN/EEG-ET/NDARDV222JZ6/NDARDV222JZ6_Video2_Samples_ET.mat, Fractals, 120, 3434709085, 3597696577, 162987492
/Volumes/methlab_data/HBN/EEG-ET/NDARDV222JZ6/NDARDV222JZ6_Video3_Samples_ET.mat, Despicable, 120, 3927896771, 4098438244, 170541473
/Volumes/methlab_data/HBN/EEG-ET/NDARDV222JZ6/NDARDV222JZ6_Video4_Samples_ET.mat, Present, 120, 4541982326, 4745049481, 203067155
/Volumes/methlab_data/HBN/EEG-ET/NDARDV245WJG/NDARDV245WJG_Video1_Samples_ET.mat, Fractals, 120, 4937478328, 5100464753, 162986425
/Volumes/methlab_data/HBN/EEG-ET/NDARDV245WJG/NDARDV245WJG_Video2_Samples_ET.mat, Despicable, 120, 5518888377, 5689435680, 170547303
/Volumes/methlab_data/HBN/EEG-ET/NDARDV245WJG/NDARDV245WJG_Video3_Samples_ET.mat, Diary, 120, 6031306255, 6148703280, 117397025
/Volumes/methlab_data/HBN/EEG-ET/NDARDV245WJG/NDARDV245WJG_Video4_Samples_ET.mat, Present, 120, 6714519797, 6917581597, 203061800
/Volumes/methlab_data/HBN/EEG-ET/NDARDV648WB5/NDARDV648WB5_Video-DM_Samples_ET.mat, Despicable, 60, 11058341972, 11228881228, 170539256
/Volumes/methlab_data/HBN/EEG-ET/NDARDV648WB5/NDARDV648WB5_Video-TP_Samples_ET.mat, Present, 60, 11528937715, 11732216065, 203278350
/Volumes/methlab_data/HBN/EEG-ET/NDARDV648WB5/NDARDV648WB5_Video-WK_Samples_ET.mat, Diary, 60, 8809868937, 8927257683, 117388746
/Volumes/methlab_data/HBN/EEG-ET/NDARDW178AC6/NDARDW178AC6_Video-DM_Samples_ET.mat, Despicable, 60, 4748186653, 4918723286, 170536633
/Volumes/methlab_data/HBN/EEG-ET/NDARDW178AC6/NDARDW178AC6_Video-TP_Samples_ET.mat, Present, 60, 5753496690, 5956765477, 203268787
/Volumes/methlab_data/HBN/EEG-ET/NDARDW178AC6/NDARDW178AC6_Video-WK_Samples_ET.mat, Diary, 60, 5333860885, 5451249932, 117389047
/Volumes/methlab_data/HBN/EEG-ET/NDARDW416KWZ/NDARDW416KWZ_Video1_Samples_ET.mat, Diary, 60, 3048627726, 3166025830, 117398104
/Volumes/methlab_data/HBN/EEG-ET/NDARDW416KWZ/NDARDW416KWZ_Video3_Samples_ET.mat, Despicable, 60, 2563113649, 2733661167, 170547518
/Volumes/methlab_data/HBN/EEG-ET/NDARDW741HCF/NDARDW741HCF_Video1_Samples_ET.mat, Diary, 60, 5367921450, 5485308428, 117386978
/Volumes/methlab_data/HBN/EEG-ET/NDARDW741HCF/NDARDW741HCF_Video3_Samples_ET.mat, Despicable, 60, 4879024018, 5049573777, 170549759
/Volumes/methlab_data/HBN/EEG-ET/NDARDX173WLD/NDARDX173WLD_Video-DM_Samples_ET.mat, Despicable, 30, 4126727985, 4297272467, 170544482
/Volumes/methlab_data/HBN/EEG-ET/NDARDX173WLD/NDARDX173WLD_Video-TP_Samples_ET.mat, Present, 30, 4695496706, 4898763274, 203266568
/Volumes/methlab_data/HBN/EEG-ET/NDARDX173WLD/NDARDX173WLD_Video-WK_Samples_ET.mat, Diary, 30, 2957861444, 3075251349, 117389905
/Volumes/methlab_data/HBN/EEG-ET/NDARDX451ZGM/NDARDX451ZGM_Video1_Samples_ET.mat, Diary, 120, 4050677449, 4168074092, 117396643
/Volumes/methlab_data/HBN/EEG-ET/NDARDX451ZGM/NDARDX451ZGM_Video2_Samples_ET.mat, Fractals, 120, 4687272744, 4850260339, 162987595
/Volumes/methlab_data/HBN/EEG-ET/NDARDX451ZGM/NDARDX451ZGM_Video3_Samples_ET.mat, Despicable, 120, 5214150061, 5384707350, 170557289
/Volumes/methlab_data/HBN/EEG-ET/NDARDX451ZGM/NDARDX451ZGM_Video4_Samples_ET.mat, Present, 120, 5889815746, 6092883810, 203068064
/Volumes/methlab_data/HBN/EEG-ET/NDARDX469TC1/NDARDX469TC1_Video1_Samples_ET.mat, Diary, 60, 5177325992, 5294722017, 117396025
/Volumes/methlab_data/HBN/EEG-ET/NDARDX469TC1/NDARDX469TC1_Video3_Samples_ET.mat, Despicable, 60, 5604671150, 5775218727, 170547577
/Volumes/methlab_data/HBN/EEG-ET/NDARDX770PJK/NDARDX770PJK_Video1_Samples_ET.mat, Diary, 120, 17778485769, 17895871592, 117385823
/Volumes/methlab_data/HBN/EEG-ET/NDARDX770PJK/NDARDX770PJK_Video2_Samples_ET.mat, Fractals, 120, 19230891758, 19393878687, 162986929
/Volumes/methlab_data/HBN/EEG-ET/NDARDX770PJK/NDARDX770PJK_Video3_Samples_ET.mat, Despicable, 120, 19448940932, 19619487326, 170546394
/Volumes/methlab_data/HBN/EEG-ET/NDARDX857DLB/NDARDX857DLB_Video1_Samples_ET.mat, Diary, 60, 4854662430, 4972059388, 117396958
/Volumes/methlab_data/HBN/EEG-ET/NDARDX857DLB/NDARDX857DLB_Video2_Samples_ET.mat, Fractals, 60, 3805698768, 3968692026, 162993258
/Volumes/methlab_data/HBN/EEG-ET/NDARDX857DLB/NDARDX857DLB_Video3_Samples_ET.mat, Despicable, 60, 4390508224, 4561053804, 170545580
/Volumes/methlab_data/HBN/EEG-ET/NDARDX857DLB/NDARDX857DLB_Video4_Samples_ET.mat, Present, 60, 5326517010, 5529592561, 203075551
/Volumes/methlab_data/HBN/EEG-ET/NDARDX872VH6/NDARDX872VH6_Video1_Samples_ET.mat, Diary, 60, 3240941455, 3358335917, 117394462
/Volumes/methlab_data/HBN/EEG-ET/NDARDX872VH6/NDARDX872VH6_Video2_Samples_ET.mat, Fractals, 60, 3969189100, 4132183909, 162994809
/Volumes/methlab_data/HBN/EEG-ET/NDARDX872VH6/NDARDX872VH6_Video3_Samples_ET.mat, Despicable, 60, 4395935401, 4566481587, 170546186
/Volumes/methlab_data/HBN/EEG-ET/NDARDX872VH6/NDARDX872VH6_Video4_Samples_ET.mat, Present, 60, 4881023140, 5084094481, 203071341
/Volumes/methlab_data/HBN/EEG-ET/NDARDY150ZP9/NDARDY150ZP9_Video1_Samples_ET.mat, Diary, 60, 5756258412, 5873651189, 117392777
/Volumes/methlab_data/HBN/EEG-ET/NDARDY150ZP9/NDARDY150ZP9_Video3_Samples_ET.mat, Despicable, 60, 5333594444, 5504144697, 170550253
/Volumes/methlab_data/HBN/EEG-ET/NDARDY421HTK/NDARDY421HTK_Video-DM_Samples_ET.mat, Despicable, 60, 2159689940, 2330230517, 170540577
/Volumes/methlab_data/HBN/EEG-ET/NDARDY421HTK/NDARDY421HTK_Video-FF_Samples_ET.mat, Fractals, 60, 2387652035, 2550634412, 162982377
/Volumes/methlab_data/HBN/EEG-ET/NDARDY421HTK/NDARDY421HTK_Video-TP_Samples_ET.mat, Present, 60, 2757399350, 2960469850, 203070500
/Volumes/methlab_data/HBN/EEG-ET/NDARDY421HTK/NDARDY421HTK_Video-WK_Samples_ET.mat, Diary, 60, 2592493781, 2709887762, 117393981
/Volumes/methlab_data/HBN/EEG-ET/NDARDY714NV9/NDARDY714NV9_Video1_Samples_ET.mat, Fractals, 120, 4196369755, 4359355128, 162985373
/Volumes/methlab_data/HBN/EEG-ET/NDARDY714NV9/NDARDY714NV9_Video2_Samples_ET.mat, Despicable, 120, 5214527132, 5385071642, 170544510
/Volumes/methlab_data/HBN/EEG-ET/NDARDY714NV9/NDARDY714NV9_Video3_Samples_ET.mat, Diary, 120, 5804935503, 5922333217, 117397714
/Volumes/methlab_data/HBN/EEG-ET/NDARDY714NV9/NDARDY714NV9_Video4_Samples_ET.mat, Present, 120, 6507622174, 6710687327, 203065153
/Volumes/methlab_data/HBN/EEG-ET/NDARDY741VEB/NDARDY741VEB_Video-DM_Samples_ET.mat, Despicable, 120, 8842871409, 9013419353, 170547944
/Volumes/methlab_data/HBN/EEG-ET/NDARDY741VEB/NDARDY741VEB_Video-FF_Samples_ET.mat, Fractals, 120, 8178736792, 8341723245, 162986453
/Volumes/methlab_data/HBN/EEG-ET/NDARDY741VEB/NDARDY741VEB_Video-TP_Samples_ET.mat, Present, 120, 9934812830, 10137882836, 203070006
/Volumes/methlab_data/HBN/EEG-ET/NDARDY741VEB/NDARDY741VEB_Video-WK_Samples_ET.mat, Diary, 120, 9339702619, 9457096838, 117394219
/Volumes/methlab_data/HBN/EEG-ET/NDARDY776AKH/NDARDY776AKH_Video1_Samples_ET.mat, Diary, 120, 6584961443, 6702359423, 117397980
/Volumes/methlab_data/HBN/EEG-ET/NDARDY776AKH/NDARDY776AKH_Video2_Samples_ET.mat, Fractals, 120, 7270388654, 7433385231, 162996577
/Volumes/methlab_data/HBN/EEG-ET/NDARDY776AKH/NDARDY776AKH_Video3_Samples_ET.mat, Despicable, 120, 7757410155, 7927962322, 170552167
/Volumes/methlab_data/HBN/EEG-ET/NDARDY776AKH/NDARDY776AKH_Video4_Samples_ET.mat, Present, 120, 8366088742, 8569159465, 203070723
/Volumes/methlab_data/HBN/EEG-ET/NDARDZ058NZN/NDARDZ058NZN_Video1_Samples_ET.mat, Diary, 60, 3756020357, 3873420497, 117400140
/Volumes/methlab_data/HBN/EEG-ET/NDARDZ058NZN/NDARDZ058NZN_Video3_Samples_ET.mat, Despicable, 60, 3319797504, 3490347306, 170549802
/Volumes/methlab_data/HBN/EEG-ET/NDARDZ147ETZ/NDARDZ147ETZ_Video1_Samples_ET.mat, Diary, 60, 3684231627, 3801627682, 117396055
/Volumes/methlab_data/HBN/EEG-ET/NDARDZ147ETZ/NDARDZ147ETZ_Video2_Samples_ET.mat, Fractals, 60, 4409438372, 4572429629, 162991257
/Volumes/methlab_data/HBN/EEG-ET/NDARDZ147ETZ/NDARDZ147ETZ_Video3_Samples_ET.mat, Despicable, 60, 4850933483, 5021476105, 170542622
/Volumes/methlab_data/HBN/EEG-ET/NDARDZ147ETZ/NDARDZ147ETZ_Video4_Samples_ET.mat, Present, 60, 5390305881, 5593364452, 203058571
/Volumes/methlab_data/HBN/EEG-ET/NDARDZ266KET/NDARDZ266KET_Video-DM_Samples_ET.mat, Despicable, 120, 5806733126, 5977280616, 170547490
/Volumes/methlab_data/HBN/EEG-ET/NDARDZ266KET/NDARDZ266KET_Video-FF_Samples_ET.mat, Fractals, 120, 5326755410, 5489742306, 162986896
/Volumes/methlab_data/HBN/EEG-ET/NDARDZ266KET/NDARDZ266KET_Video-TP_Samples_ET.mat, Present, 120, 6444652668, 6647719300, 203066632
/Volumes/methlab_data/HBN/EEG-ET/NDARDZ266KET/NDARDZ266KET_Video-WK_Samples_ET.mat, Diary, 120, 4751309850, 4868706437, 117396587
/Volumes/methlab_data/HBN/EEG-ET/NDARDZ321FMY/NDARDZ321FMY_Video1_Samples_ET.mat, Diary, 60, 5540130520, 5657524539, 117394019
/Volumes/methlab_data/HBN/EEG-ET/NDARDZ321FMY/NDARDZ321FMY_Video2_Samples_ET.mat, Fractals, 60, 6053685610, 6216667862, 162982252
/Volumes/methlab_data/HBN/EEG-ET/NDARDZ321FMY/NDARDZ321FMY_Video3_Samples_ET.mat, Despicable, 60, 6488468992, 6659012604, 170543612
/Volumes/methlab_data/HBN/EEG-ET/NDARDZ321FMY/NDARDZ321FMY_Video4_Samples_ET.mat, Present, 60, 7016155066, 7219213663, 203058597
/Volumes/methlab_data/HBN/EEG-ET/NDARDZ440NGK/NDARDZ440NGK_Video-DM_Samples_ET.mat, Despicable, 60, 5409164911, 5579713243, 170548332
/Volumes/methlab_data/HBN/EEG-ET/NDARDZ440NGK/NDARDZ440NGK_Video-FF_Samples_ET.mat, Fractals, 60, 4959692773, 5122682816, 162990043
/Volumes/methlab_data/HBN/EEG-ET/NDARDZ440NGK/NDARDZ440NGK_Video-TP_Samples_ET.mat, Present, 60, 5932537182, 6135608471, 203071289
/Volumes/methlab_data/HBN/EEG-ET/NDARDZ440NGK/NDARDZ440NGK_Video-WK_Samples_ET.mat, Diary, 60, 4337051438, 4454438296, 117386858
/Volumes/methlab_data/HBN/EEG-ET/NDARDZ528DLZ/NDARDZ528DLZ_Video1_Samples_ET.mat, Diary, 60, 5385553444, 5502948723, 117395279
/Volumes/methlab_data/HBN/EEG-ET/NDARDZ528DLZ/NDARDZ528DLZ_Video2_Samples_ET.mat, Fractals, 60, 5178819801, 5341803435, 162983634
/Volumes/methlab_data/HBN/EEG-ET/NDARDZ528DLZ/NDARDZ528DLZ_Video3_Samples_ET.mat, Despicable, 60, 4898146711, 5068691702, 170544991
/Volumes/methlab_data/HBN/EEG-ET/NDARDZ528DLZ/NDARDZ528DLZ_Video4_Samples_ET.mat, Present, 60, 5545729041, 5748801119, 203072078
/Volumes/methlab_data/HBN/EEG-ET/NDARDZ627XFA/NDARDZ627XFA_Video1_Samples_ET.mat, Diary, 60, 5381709418, 5499103312, 117393894
/Volumes/methlab_data/HBN/EEG-ET/NDARDZ627XFA/NDARDZ627XFA_Video3_Samples_ET.mat, Despicable, 60, 4875618171, 5046168569, 170550398
/Volumes/methlab_data/HBN/EEG-ET/NDARDZ627XFA/NDARDZ627XFA_Video4_Samples_ET.mat, Present, 60, 5825304573, 6028366959, 203062386
/Volumes/methlab_data/HBN/EEG-ET/NDARDZ946KVL/NDARDZ946KVL_Video1_Samples_ET.mat, Diary, 60, 2327208487, 2444600491, 117392004
/Volumes/methlab_data/HBN/EEG-ET/NDARDZ946KVL/NDARDZ946KVL_Video3_Samples_ET.mat, Despicable, 60, 3606414893, 3776961486, 170546593
/Volumes/methlab_data/HBN/EEG-ET/NDAREA730YXX/NDAREA730YXX_Video-DM_Samples_ET.mat, Despicable, 30, 4089042553, 4259592095, 170549542
/Volumes/methlab_data/HBN/EEG-ET/NDAREA730YXX/NDAREA730YXX_Video-WK_Samples_ET.mat, Diary, 30, 3670909080, 3788294058, 117384978
/Volumes/methlab_data/HBN/EEG-ET/NDAREB093GH6/NDAREB093GH6_Video1_Samples_ET.mat, Fractals, 120, 5053668734, 5216656272, 162987538
/Volumes/methlab_data/HBN/EEG-ET/NDAREB093GH6/NDAREB093GH6_Video2_Samples_ET.mat, Diary, 120, 6285060733, 6402458425, 117397692
/Volumes/methlab_data/HBN/EEG-ET/NDAREB093GH6/NDAREB093GH6_Video3_Samples_ET.mat, Despicable, 120, 6737308540, 6907855471, 170546931
/Volumes/methlab_data/HBN/EEG-ET/NDAREB093GH6/NDAREB093GH6_Video4_Samples_ET.mat, Present, 120, 7456052649, 7659119690, 203067041
/Volumes/methlab_data/HBN/EEG-ET/NDAREB290UCN/NDAREB290UCN_Video1_Samples_ET.mat, Diary, 60, 4346389741, 4463782763, 117393022
/Volumes/methlab_data/HBN/EEG-ET/NDAREB290UCN/NDAREB290UCN_Video3_Samples_ET.mat, Despicable, 60, 4099927495, 4270471099, 170543604
/Volumes/methlab_data/HBN/EEG-ET/NDAREB303XDC/NDAREB303XDC_Video-DM_Samples_ET.mat, Despicable, 60, 6533401472, 6703954732, 170553260
/Volumes/methlab_data/HBN/EEG-ET/NDAREB303XDC/NDAREB303XDC_Video-FF_Samples_ET.mat, Fractals, 60, 6070066177, 6233059038, 162992861
/Volumes/methlab_data/HBN/EEG-ET/NDAREB303XDC/NDAREB303XDC_Video-TP_Samples_ET.mat, Present, 60, 7041649705, 7244717093, 203067388
/Volumes/methlab_data/HBN/EEG-ET/NDAREB303XDC/NDAREB303XDC_Video-WK_Samples_ET.mat, Diary, 60, 5143294437, 5260688921, 117394484
/Volumes/methlab_data/HBN/EEG-ET/NDAREB662RLE/NDAREB662RLE_Video1_Samples_ET.mat, Diary, 60, 699946653, 817337615, 117390962
/Volumes/methlab_data/HBN/EEG-ET/NDAREB662RLE/NDAREB662RLE_Video3_Samples_ET.mat, Despicable, 60, 1272820384, 1443362658, 170542274
/Volumes/methlab_data/HBN/EEG-ET/NDAREB953UMY/NDAREB953UMY_Video-DM_Samples_ET.mat, Despicable, 60, 1270387044, 1440923755, 170536711
/Volumes/methlab_data/HBN/EEG-ET/NDAREB953UMY/NDAREB953UMY_Video-TP_Samples_ET.mat, Present, 60, 1933403222, 2136669076, 203265854
/Volumes/methlab_data/HBN/EEG-ET/NDAREB953UMY/NDAREB953UMY_Video-WK_Samples_ET.mat, Diary, 60, 693030533, 810421604, 117391071
/Volumes/methlab_data/HBN/EEG-ET/NDAREC078VFT/NDAREC078VFT_Video1_Samples_ET.mat, Diary, 60, 3039701871, 3157098466, 117396595
/Volumes/methlab_data/HBN/EEG-ET/NDAREC078VFT/NDAREC078VFT_Video2_Samples_ET.mat, Fractals, 60, 3254529781, 3417519832, 162990051
/Volumes/methlab_data/HBN/EEG-ET/NDAREC078VFT/NDAREC078VFT_Video3_Samples_ET.mat, Despicable, 60, 2736210952, 2906755292, 170544340
/Volumes/methlab_data/HBN/EEG-ET/NDAREC078VFT/NDAREC078VFT_Video4_Samples_ET.mat, Present, 60, 3468208852, 3671280397, 203071545
/Volumes/methlab_data/HBN/EEG-ET/NDAREC182WW2/NDAREC182WW2_Video1_Samples_ET.mat, Diary, 120, 4408033223, 4525430268, 117397045
/Volumes/methlab_data/HBN/EEG-ET/NDAREC182WW2/NDAREC182WW2_Video2_Samples_ET.mat, Fractals, 120, 5221563080, 5384551482, 162988402
/Volumes/methlab_data/HBN/EEG-ET/NDAREC182WW2/NDAREC182WW2_Video3_Samples_ET.mat, Despicable, 120, 5730179588, 5900725013, 170545425
/Volumes/methlab_data/HBN/EEG-ET/NDAREC238AY4/NDAREC238AY4_Video-DM_Samples_ET.mat, Despicable, 120, 3335643176, 3506190273, 170547097
/Volumes/methlab_data/HBN/EEG-ET/NDAREC238AY4/NDAREC238AY4_Video-FF_Samples_ET.mat, Fractals, 120, 2693064209, 2856047673, 162983464
/Volumes/methlab_data/HBN/EEG-ET/NDAREC238AY4/NDAREC238AY4_Video-TP_Samples_ET.mat, Present, 120, 3998688827, 4201755890, 203067063
/Volumes/methlab_data/HBN/EEG-ET/NDAREC238AY4/NDAREC238AY4_Video-WK_Samples_ET.mat, Diary, 120, 2299115523, 2416503473, 117387950
/Volumes/methlab_data/HBN/EEG-ET/NDAREC277JCP/NDAREC277JCP_Video1_Samples_ET.mat, Diary, 60, 1502715652, 1620106556, 117390904
/Volumes/methlab_data/HBN/EEG-ET/NDAREC277JCP/NDAREC277JCP_Video2_Samples_ET.mat, Fractals, 60, 1658288462, 1821280560, 162992098
/Volumes/methlab_data/HBN/EEG-ET/NDAREC277JCP/NDAREC277JCP_Video3_Samples_ET.mat, Despicable, 60, 1251641417, 1422184819, 170543402
/Volumes/methlab_data/HBN/EEG-ET/NDAREC277JCP/NDAREC277JCP_Video4_Samples_ET.mat, Present, 60, 1871551026, 2074611380, 203060354
/Volumes/methlab_data/HBN/EEG-ET/NDAREC377AU2/NDAREC377AU2_Video1_Samples_ET.mat, Diary, 60, 2150450267, 2267843665, 117393398
/Volumes/methlab_data/HBN/EEG-ET/NDAREC377AU2/NDAREC377AU2_Video3_Samples_ET.mat, Despicable, 60, 1710508449, 1881057172, 170548723
/Volumes/methlab_data/HBN/EEG-ET/NDAREC480KFA/NDAREC480KFA_Video1_Samples_ET.mat, Diary, 60, 2992559324, 3109951250, 117391926
/Volumes/methlab_data/HBN/EEG-ET/NDAREC480KFA/NDAREC480KFA_Video2_Samples_ET.mat, Fractals, 60, 1830910887, 1993906010, 162995123
/Volumes/methlab_data/HBN/EEG-ET/NDAREC480KFA/NDAREC480KFA_Video3_Samples_ET.mat, Despicable, 60, 2420286149, 2590835613, 170549464
/Volumes/methlab_data/HBN/EEG-ET/NDAREC480KFA/NDAREC480KFA_Video4_Samples_ET.mat, Present, 60, 3425864366, 3628923797, 203059431
/Volumes/methlab_data/HBN/EEG-ET/NDAREC486ZPV/NDAREC486ZPV_Video-DM_Samples_ET.mat, Despicable, 60, 6655876472, 6826417087, 170540615
/Volumes/methlab_data/HBN/EEG-ET/NDAREC486ZPV/NDAREC486ZPV_Video-FF_Samples_ET.mat, Fractals, 60, 6222771144, 6385763455, 162992311
/Volumes/methlab_data/HBN/EEG-ET/NDAREC486ZPV/NDAREC486ZPV_Video-TP_Samples_ET.mat, Present, 60, 7177966719, 7381028364, 203061645
/Volumes/methlab_data/HBN/EEG-ET/NDAREC486ZPV/NDAREC486ZPV_Video-WK_Samples_ET.mat, Diary, 60, 5543173483, 5660567564, 117394081
/Volumes/methlab_data/HBN/EEG-ET/NDAREC542MH3/NDAREC542MH3_Video1_Samples_ET.mat, Diary, 120, 4640639583, 4758036506, 117396923
/Volumes/methlab_data/HBN/EEG-ET/NDAREC542MH3/NDAREC542MH3_Video2_Samples_ET.mat, Fractals, 120, 5643912189, 5806900206, 162988017
/Volumes/methlab_data/HBN/EEG-ET/NDAREC542MH3/NDAREC542MH3_Video3_Samples_ET.mat, Despicable, 120, 6238693079, 6409243329, 170550250
/Volumes/methlab_data/HBN/EEG-ET/NDAREC542MH3/NDAREC542MH3_Video4_Samples_ET.mat, Present, 120, 6945345564, 7148413484, 203067920
/Volumes/methlab_data/HBN/EEG-ET/NDAREC647MKW/NDAREC647MKW_Video1_Samples_ET.mat, Diary, 60, 6796668919, 6914061906, 117392987
/Volumes/methlab_data/HBN/EEG-ET/NDAREC647MKW/NDAREC647MKW_Video3_Samples_ET.mat, Despicable, 60, 6366816172, 6537357696, 170541524
/Volumes/methlab_data/HBN/EEG-ET/NDAREC647MKW/NDAREC647MKW_Video4_Samples_ET.mat, Present, 60, 7225826185, 7428894738, 203068553
/Volumes/methlab_data/HBN/EEG-ET/NDAREC648WEL/NDAREC648WEL_Video1_Samples_ET.mat, Diary, 60, 3836970433, 3954362424, 117391991
/Volumes/methlab_data/HBN/EEG-ET/NDAREC648WEL/NDAREC648WEL_Video3_Samples_ET.mat, Despicable, 60, 3413830437, 3584367006, 170536569
/Volumes/methlab_data/HBN/EEG-ET/NDAREC648WEL/NDAREC648WEL_Video4_Samples_ET.mat, Present, 60, 4250094368, 4453166913, 203072545
/Volumes/methlab_data/HBN/EEG-ET/NDARED047DTH/NDARED047DTH_Video1_Samples_ET.mat, Diary, 60, 2018716317, 2136111317, 117395000
/Volumes/methlab_data/HBN/EEG-ET/NDARED047DTH/NDARED047DTH_Video3_Samples_ET.mat, Despicable, 60, 3632714400, 3803259008, 170544608
/Volumes/methlab_data/HBN/EEG-ET/NDARED628HMQ/NDARED628HMQ_Video1_Samples_ET.mat, Diary, 60, 3365147094, 3482540272, 117393178
/Volumes/methlab_data/HBN/EEG-ET/NDARED628HMQ/NDARED628HMQ_Video2_Samples_ET.mat, Fractals, 60, 3864839024, 4027831515, 162992491
/Volumes/methlab_data/HBN/EEG-ET/NDARED628HMQ/NDARED628HMQ_Video3_Samples_ET.mat, Despicable, 60, 4297587569, 4468125376, 170537807
/Volumes/methlab_data/HBN/EEG-ET/NDARED628HMQ/NDARED628HMQ_Video4_Samples_ET.mat, Present, 60, 4778609301, 4981671172, 203061871
/Volumes/methlab_data/HBN/EEG-ET/NDAREE015WGU/NDAREE015WGU_Video-DM_Samples_ET.mat, Despicable, 120, 2880627490, 3051174742, 170547252
/Volumes/methlab_data/HBN/EEG-ET/NDAREE015WGU/NDAREE015WGU_Video-FF_Samples_ET.mat, Fractals, 120, 2355628012, 2518617470, 162989458
/Volumes/methlab_data/HBN/EEG-ET/NDAREE015WGU/NDAREE015WGU_Video-TP_Samples_ET.mat, Present, 120, 3828941645, 4032009329, 203067684
/Volumes/methlab_data/HBN/EEG-ET/NDAREE015WGU/NDAREE015WGU_Video-WK_Samples_ET.mat, Diary, 120, 3325414688, 3442812457, 117397769
/Volumes/methlab_data/HBN/EEG-ET/NDAREE196FEG/NDAREE196FEG_Video1_Samples_ET.mat, Diary, 60, 752077469, 869475301, 117397832
/Volumes/methlab_data/HBN/EEG-ET/NDAREE196FEG/NDAREE196FEG_Video3_Samples_ET.mat, Despicable, 60, 1941018359, 2111564714, 170546355
/Volumes/methlab_data/HBN/EEG-ET/NDAREE675XRY/NDAREE675XRY_Video1_Samples_ET.mat, Diary, 60, 4339506893, 4456899771, 117392878
/Volumes/methlab_data/HBN/EEG-ET/NDAREE675XRY/NDAREE675XRY_Video2_Samples_ET.mat, Fractals, 60, 5375480524, 5538461464, 162980940
/Volumes/methlab_data/HBN/EEG-ET/NDAREE675XRY/NDAREE675XRY_Video3_Samples_ET.mat, Despicable, 60, 4814398794, 4984941069, 170542275
/Volumes/methlab_data/HBN/EEG-ET/NDAREE675XRY/NDAREE675XRY_Video4_Samples_ET.mat, Present, 60, 5924738814, 6127810065, 203071251
/Volumes/methlab_data/HBN/EEG-ET/NDAREF057VX5/NDAREF057VX5_Video1_Samples_ET.mat, Diary, 60, 2611619388, 2729014416, 117395028
/Volumes/methlab_data/HBN/EEG-ET/NDAREF057VX5/NDAREF057VX5_Video3_Samples_ET.mat, Despicable, 60, 4087133566, 4257678176, 170544610
/Volumes/methlab_data/HBN/EEG-ET/NDAREF074ZAQ/NDAREF074ZAQ_Video-DM_Samples_ET.mat, Despicable, 60, 6138413746, 6308963472, 170549726
/Volumes/methlab_data/HBN/EEG-ET/NDAREF074ZAQ/NDAREF074ZAQ_Video-TP_Samples_ET.mat, Present, 60, 7227615496, 7435330532, 207715036
/Volumes/methlab_data/HBN/EEG-ET/NDAREF074ZAQ/NDAREF074ZAQ_Video-WK_Samples_ET.mat, Diary, 60, 6605150025, 6722539116, 117389091
/Volumes/methlab_data/HBN/EEG-ET/NDAREF164ZVJ/NDAREF164ZVJ_Video1_Samples_ET.mat, Diary, 60, 5642202903, 5759601884, 117398981
/Volumes/methlab_data/HBN/EEG-ET/NDAREF164ZVJ/NDAREF164ZVJ_Video3_Samples_ET.mat, Despicable, 60, 5216827315, 5387382856, 170555541
/Volumes/methlab_data/HBN/EEG-ET/NDAREF389RY2/NDAREF389RY2_Video3_Samples_ET.mat, Despicable, 60, 2687892862, 2858441299, 170548437
/Volumes/methlab_data/HBN/EEG-ET/NDAREF624KJN/NDAREF624KJN_Video1_Samples_ET.mat, Diary, 60, 3480182523, 3597581815, 117399292
/Volumes/methlab_data/HBN/EEG-ET/NDAREF624KJN/NDAREF624KJN_Video2_Samples_ET.mat, Fractals, 60, 2214602813, 2377585451, 162982638
/Volumes/methlab_data/HBN/EEG-ET/NDAREF624KJN/NDAREF624KJN_Video3_Samples_ET.mat, Despicable, 60, 3024923602, 3195460734, 170537132
/Volumes/methlab_data/HBN/EEG-ET/NDAREF624KJN/NDAREF624KJN_Video4_Samples_ET.mat, Present, 60, 3943668289, 4146730340, 203062051
/Volumes/methlab_data/HBN/EEG-ET/NDAREF662XZT/NDAREF662XZT_Video-DM_Samples_ET.mat, Despicable, 60, 3920246525, 4090795378, 170548853
/Volumes/methlab_data/HBN/EEG-ET/NDAREF662XZT/NDAREF662XZT_Video-FF_Samples_ET.mat, Fractals, 60, 3692004850, 3854995342, 162990492
/Volumes/methlab_data/HBN/EEG-ET/NDAREF662XZT/NDAREF662XZT_Video-TP_Samples_ET.mat, Present, 60, 4627413436, 4830483324, 203069888
/Volumes/methlab_data/HBN/EEG-ET/NDAREF662XZT/NDAREF662XZT_Video-WK_Samples_ET.mat, Diary, 60, 4167738837, 4285127014, 117388177
/Volumes/methlab_data/HBN/EEG-ET/NDAREF848YWD/NDAREF848YWD_Video1_Samples_ET.mat, Diary, 60, 3753841391, 3871230393, 117389002
/Volumes/methlab_data/HBN/EEG-ET/NDAREF848YWD/NDAREF848YWD_Video2_Samples_ET.mat, Fractals, 60, 3117969043, 3280962256, 162993213
/Volumes/methlab_data/HBN/EEG-ET/NDAREF848YWD/NDAREF848YWD_Video3_Samples_ET.mat, Despicable, 60, 4136623899, 4307166419, 170542520
/Volumes/methlab_data/HBN/EEG-ET/NDAREF848YWD/NDAREF848YWD_Video4_Samples_ET.mat, Present, 60, 4613039535, 4816100042, 203060507
/Volumes/methlab_data/HBN/EEG-ET/NDAREF888EVV/NDAREF888EVV_Video1_Samples_ET.mat, Fractals, 120, 7502074324, 7665060206, 162985882
/Volumes/methlab_data/HBN/EEG-ET/NDAREF888EVV/NDAREF888EVV_Video2_Samples_ET.mat, Diary, 120, 8874454661, 8991843760, 117389099
/Volumes/methlab_data/HBN/EEG-ET/NDAREF888EVV/NDAREF888EVV_Video3_Samples_ET.mat, Despicable, 120, 9349461682, 9520008430, 170546748
/Volumes/methlab_data/HBN/EEG-ET/NDAREF888EVV/NDAREF888EVV_Video4_Samples_ET.mat, Present, 120, 10014404115, 10217468938, 203064823
/Volumes/methlab_data/HBN/EEG-ET/NDAREF893ZM8/NDAREF893ZM8_Video1_Samples_ET.mat, Diary, 60, 3244191943, 3361582038, 117390095
/Volumes/methlab_data/HBN/EEG-ET/NDAREF893ZM8/NDAREF893ZM8_Video3_Samples_ET.mat, Despicable, 60, 3674994811, 3845545513, 170550702
/Volumes/methlab_data/HBN/EEG-ET/NDAREG013BLG/NDAREG013BLG_Video-DM_Samples_ET.mat, Despicable, 60, 3721528456, 3892071177, 170542721
/Volumes/methlab_data/HBN/EEG-ET/NDAREG013BLG/NDAREG013BLG_Video-FF_Samples_ET.mat, Fractals, 60, 3075810545, 3238790955, 162980410
/Volumes/methlab_data/HBN/EEG-ET/NDAREG013BLG/NDAREG013BLG_Video-TP_Samples_ET.mat, Present, 60, 4711721137, 4914783863, 203062726
/Volumes/methlab_data/HBN/EEG-ET/NDAREG013BLG/NDAREG013BLG_Video-WK_Samples_ET.mat, Diary, 60, 4236390794, 4353783892, 117393098
/Volumes/methlab_data/HBN/EEG-ET/NDAREG350WZ4/NDAREG350WZ4_Video-DM_Samples_ET.mat, Despicable, 30, 5151583786, 5322136120, 170552334
/Volumes/methlab_data/HBN/EEG-ET/NDAREG350WZ4/NDAREG350WZ4_Video-TP_Samples_ET.mat, Present, 30, 5780705670, 5983986117, 203280447
/Volumes/methlab_data/HBN/EEG-ET/NDAREG350WZ4/NDAREG350WZ4_Video-WK_Samples_ET.mat, Diary, 30, 3902931759, 4020322615, 117390856
/Volumes/methlab_data/HBN/EEG-ET/NDAREG408DJ5/NDAREG408DJ5_Video1_Samples_ET.mat, Diary, 60, 3449820634, 3567215653, 117395019
/Volumes/methlab_data/HBN/EEG-ET/NDAREG408DJ5/NDAREG408DJ5_Video3_Samples_ET.mat, Despicable, 60, 2993094736, 3163639356, 170544620
/Volumes/methlab_data/HBN/EEG-ET/NDAREG408DJ5/NDAREG408DJ5_Video4_Samples_ET.mat, Present, 60, 3873136923, 4076199525, 203062602
/Volumes/methlab_data/HBN/EEG-ET/NDAREG561ML5/NDAREG561ML5_Video1_Samples_ET.mat, Diary, 120, 3098633344, 3216025750, 117392406
/Volumes/methlab_data/HBN/EEG-ET/NDAREG561ML5/NDAREG561ML5_Video2_Samples_ET.mat, Despicable, 120, 4245241460, 4415788053, 170546593
/Volumes/methlab_data/HBN/EEG-ET/NDAREG561ML5/NDAREG561ML5_Video3_Samples_ET.mat, Fractals, 120, 4707546859, 4870530574, 162983715
/Volumes/methlab_data/HBN/EEG-ET/NDAREG561ML5/NDAREG561ML5_Video4_Samples_ET.mat, Present, 120, 5381093521, 5584159969, 203066448
/Volumes/methlab_data/HBN/EEG-ET/NDAREG590BNY/NDAREG590BNY_Video1_Samples_ET.mat, Diary, 60, 3689419459, 3806811467, 117392008
/Volumes/methlab_data/HBN/EEG-ET/NDAREG590BNY/NDAREG590BNY_Video2_Samples_ET.mat, Fractals, 60, 356718843, 519715074, 162996231
/Volumes/methlab_data/HBN/EEG-ET/NDAREG590BNY/NDAREG590BNY_Video3_Samples_ET.mat, Despicable, 60, 822133874, 992675452, 170541578
/Volumes/methlab_data/HBN/EEG-ET/NDAREG590BNY/NDAREG590BNY_Video4_Samples_ET.mat, Present, 60, 1332607819, 1535671357, 203063538
/Volumes/methlab_data/HBN/EEG-ET/NDAREG930XPP/NDAREG930XPP_Video1_Samples_ET.mat, Diary, 120, 3184972296, 3302369417, 117397121
/Volumes/methlab_data/HBN/EEG-ET/NDAREG930XPP/NDAREG930XPP_Video2_Samples_ET.mat, Despicable, 120, 4356514381, 4527061833, 170547452
/Volumes/methlab_data/HBN/EEG-ET/NDAREG930XPP/NDAREG930XPP_Video3_Samples_ET.mat, Fractals, 120, 4865091281, 5028079009, 162987728
/Volumes/methlab_data/HBN/EEG-ET/NDAREG930XPP/NDAREG930XPP_Video4_Samples_ET.mat, Present, 120, 5498177728, 5701246093, 203068365
/Volumes/methlab_data/HBN/EEG-ET/NDAREH074NG8/NDAREH074NG8_Video1_Samples_ET.mat, Diary, 60, 4289485094, 4406878032, 117392938
/Volumes/methlab_data/HBN/EEG-ET/NDAREH074NG8/NDAREH074NG8_Video3_Samples_ET.mat, Despicable, 60, 4077617531, 4248164963, 170547432
/Volumes/methlab_data/HBN/EEG-ET/NDAREH852JE0/NDAREH852JE0_Video1_Samples_ET.mat, Diary, 120, 2567451188, 2684839431, 117388243
/Volumes/methlab_data/HBN/EEG-ET/NDAREH852JE0/NDAREH852JE0_Video2_Samples_ET.mat, Fractals, 120, 3465384712, 3628372707, 162987995
/Volumes/methlab_data/HBN/EEG-ET/NDAREH852JE0/NDAREH852JE0_Video3_Samples_ET.mat, Despicable, 120, 4166442315, 4336988762, 170546447
/Volumes/methlab_data/HBN/EEG-ET/NDAREH852JE0/NDAREH852JE0_Video4_Samples_ET.mat, Present, 120, 4784086783, 4987154263, 203067480
/Volumes/methlab_data/HBN/EEG-ET/NDAREH876HG2/NDAREH876HG2_Video1_Samples_ET.mat, Diary, 120, 4385056935, 4502452715, 117395780
/Volumes/methlab_data/HBN/EEG-ET/NDAREH876HG2/NDAREH876HG2_Video2_Samples_ET.mat, Fractals, 120, 5615356646, 5778340204, 162983558
/Volumes/methlab_data/HBN/EEG-ET/NDAREH876HG2/NDAREH876HG2_Video3_Samples_ET.mat, Despicable, 120, 6049152242, 6219693787, 170541545
/Volumes/methlab_data/HBN/EEG-ET/NDAREH905REB/NDAREH905REB_Video1_Samples_ET.mat, Diary, 60, 3909331061, 4026728122, 117397061
/Volumes/methlab_data/HBN/EEG-ET/NDAREH905REB/NDAREH905REB_Video3_Samples_ET.mat, Despicable, 60, 4443225841, 4613769528, 170543687
/Volumes/methlab_data/HBN/EEG-ET/NDAREJ309NL8/NDAREJ309NL8_Video-DM_Samples_ET.mat, Despicable, 60, 5373563131, 5544102780, 170539649
/Volumes/methlab_data/HBN/EEG-ET/NDAREJ309NL8/NDAREJ309NL8_Video-TP_Samples_ET.mat, Present, 60, 6327662924, 6530931729, 203268805
/Volumes/methlab_data/HBN/EEG-ET/NDAREJ309NL8/NDAREJ309NL8_Video-WK_Samples_ET.mat, Diary, 60, 5798316530, 5915706594, 117390064
/Volumes/methlab_data/HBN/EEG-ET/NDAREJ327AH7/NDAREJ327AH7_Video-DM_Samples_ET.mat, Despicable, 120, 3774887851, 3945435044, 170547193
/Volumes/methlab_data/HBN/EEG-ET/NDAREJ327AH7/NDAREJ327AH7_Video-FF_Samples_ET.mat, Fractals, 120, 4309124421, 4472111893, 162987472
/Volumes/methlab_data/HBN/EEG-ET/NDAREJ327AH7/NDAREJ327AH7_Video-TP_Samples_ET.mat, Present, 120, 5036160390, 5239237576, 203077186
/Volumes/methlab_data/HBN/EEG-ET/NDAREJ327AH7/NDAREJ327AH7_Video-WK_Samples_ET.mat, Diary, 120, 3188732147, 3306128468, 117396321
/Volumes/methlab_data/HBN/EEG-ET/NDAREJ923AYR/NDAREJ923AYR_Video1_Samples_ET.mat, Despicable, 120, 2197044792, 2367590846, 170546054
/Volumes/methlab_data/HBN/EEG-ET/NDAREJ923AYR/NDAREJ923AYR_Video2_Samples_ET.mat, Fractals, 120, 2506920172, 2669909232, 162989060
/Volumes/methlab_data/HBN/EEG-ET/NDAREJ923AYR/NDAREJ923AYR_Video3_Samples_ET.mat, Diary, 120, 2792449387, 2909846702, 117397315
/Volumes/methlab_data/HBN/EEG-ET/NDAREJ923AYR/NDAREJ923AYR_Video4_Samples_ET.mat, Present, 120, 3007027805, 3210088788, 203060983
/Volumes/methlab_data/HBN/EEG-ET/NDAREJ923FZU/NDAREJ923FZU_Video1_Samples_ET.mat, Diary, 30, 3500495227, 3617884005, 117388778
/Volumes/methlab_data/HBN/EEG-ET/NDAREJ923FZU/NDAREJ923FZU_Video3_Samples_ET.mat, Despicable, 30, 3080297035, 3250834250, 170537215
/Volumes/methlab_data/HBN/EEG-ET/NDAREJ923FZU/NDAREJ923FZU_Video4_Samples_ET.mat, Present, 30, 3918067658, 4121135779, 203068121
/Volumes/methlab_data/HBN/EEG-ET/NDAREK255DEE/NDAREK255DEE_Video1_Samples_ET.mat, Diary, 60, 3859874562, 3977270037, 117395475
/Volumes/methlab_data/HBN/EEG-ET/NDAREK255DEE/NDAREK255DEE_Video3_Samples_ET.mat, Despicable, 60, 4222194188, 4392736874, 170542686
/Volumes/methlab_data/HBN/EEG-ET/NDAREK255DEE/NDAREK255DEE_Video4_Samples_ET.mat, Present, 60, 4690632290, 4893694754, 203062464
/Volumes/methlab_data/HBN/EEG-ET/NDAREK395BM3/NDAREK395BM3_Video1_Samples_ET.mat, Despicable, 120, 22730056591, 22900603792, 170547201
/Volumes/methlab_data/HBN/EEG-ET/NDAREK395BM3/NDAREK395BM3_Video2_Samples_ET.mat, Fractals, 120, 23005092644, 23168080247, 162987603
/Volumes/methlab_data/HBN/EEG-ET/NDAREK395BM3/NDAREK395BM3_Video3_Samples_ET.mat, Diary, 120, 23312332104, 23429729041, 117396937
/Volumes/methlab_data/HBN/EEG-ET/NDAREK395BM3/NDAREK395BM3_Video4_Samples_ET.mat, Present, 120, 23530859788, 23733926579, 203066791
/Volumes/methlab_data/HBN/EEG-ET/NDAREK544ENR/NDAREK544ENR_Video1_Samples_ET.mat, Diary, 120, 4777336559, 4894723624, 117387065
/Volumes/methlab_data/HBN/EEG-ET/NDAREK544ENR/NDAREK544ENR_Video2_Samples_ET.mat, Fractals, 120, 5645372890, 5808361076, 162988186
/Volumes/methlab_data/HBN/EEG-ET/NDAREK544ENR/NDAREK544ENR_Video3_Samples_ET.mat, Despicable, 120, 6192359996, 6362907403, 170547407
/Volumes/methlab_data/HBN/EEG-ET/NDAREK549XUQ/NDAREK549XUQ_Video1_Samples_ET.mat, Diary, 120, 2645464937, 2762861667, 117396730
/Volumes/methlab_data/HBN/EEG-ET/NDAREK549XUQ/NDAREK549XUQ_Video2_Samples_ET.mat, Fractals, 120, 3551118357, 3714106733, 162988376
/Volumes/methlab_data/HBN/EEG-ET/NDAREK549XUQ/NDAREK549XUQ_Video3_Samples_ET.mat, Despicable, 120, 4111125684, 4281672281, 170546597
/Volumes/methlab_data/HBN/EEG-ET/NDAREK549XUQ/NDAREK549XUQ_Video4_Samples_ET.mat, Present, 120, 4801621912, 5004688183, 203066271
/Volumes/methlab_data/HBN/EEG-ET/NDAREK575JNM/NDAREK575JNM_Video1_Samples_ET.mat, Diary, 60, 1717316765, 1834708728, 117391963
/Volumes/methlab_data/HBN/EEG-ET/NDAREK575JNM/NDAREK575JNM_Video2_Samples_ET.mat, Fractals, 60, 2483916476, 2646909665, 162993189
/Volumes/methlab_data/HBN/EEG-ET/NDAREK575JNM/NDAREK575JNM_Video3_Samples_ET.mat, Despicable, 60, 2926145981, 3096684498, 170538517
/Volumes/methlab_data/HBN/EEG-ET/NDAREK575JNM/NDAREK575JNM_Video4_Samples_ET.mat, Present, 60, 3399057148, 3602117673, 203060525
/Volumes/methlab_data/HBN/EEG-ET/NDAREK801BPB/NDAREK801BPB_Video1_Samples_ET.mat, Diary, 60, 4327467634, 4444858563, 117390929
/Volumes/methlab_data/HBN/EEG-ET/NDAREK801BPB/NDAREK801BPB_Video3_Samples_ET.mat, Despicable, 60, 5297014420, 5467554887, 170540467
/Volumes/methlab_data/HBN/EEG-ET/NDAREK947FYP/NDAREK947FYP_Video1_Samples_ET.mat, Diary, 60, 3428391332, 3545781421, 117390089
/Volumes/methlab_data/HBN/EEG-ET/NDAREK947FYP/NDAREK947FYP_Video3_Samples_ET.mat, Despicable, 60, 4750115618, 4920656309, 170540691
/Volumes/methlab_data/HBN/EEG-ET/NDAREL0366HL/NDAREL0366HL_Video-DM_Samples_ET.mat, Despicable, 30, 4728449057, 4898989359, 170540302
/Volumes/methlab_data/HBN/EEG-ET/NDAREL0366HL/NDAREL0366HL_Video-TP_Samples_ET.mat, Present, 30, 5192947648, 5396211990, 203264342
/Volumes/methlab_data/HBN/EEG-ET/NDAREL0366HL/NDAREL0366HL_Video-WK_Samples_ET.mat, Diary, 30, 3100418942, 3217819762, 117400820
/Volumes/methlab_data/HBN/EEG-ET/NDAREL164JM1/NDAREL164JM1_Video1_Samples_ET.mat, Diary, 60, 2848395016, 2965802040, 117407024
/Volumes/methlab_data/HBN/EEG-ET/NDAREL164JM1/NDAREL164JM1_Video3_Samples_ET.mat, Despicable, 60, 3890849028, 4061396624, 170547596
/Volumes/methlab_data/HBN/EEG-ET/NDAREL164JM1/NDAREL164JM1_Video4_Samples_ET.mat, Present, 60, 4382091340, 4585152940, 203061600
/Volumes/methlab_data/HBN/EEG-ET/NDAREL410HHK/NDAREL410HHK_Video1_Samples_ET.mat, Diary, 120, 4228231557, 4345627899, 117396342
/Volumes/methlab_data/HBN/EEG-ET/NDAREL410HHK/NDAREL410HHK_Video2_Samples_ET.mat, Fractals, 120, 4920885844, 5083873500, 162987656
/Volumes/methlab_data/HBN/EEG-ET/NDAREL410HHK/NDAREL410HHK_Video3_Samples_ET.mat, Despicable, 120, 5419303053, 5589850795, 170547742
/Volumes/methlab_data/HBN/EEG-ET/NDAREL410HHK/NDAREL410HHK_Video4_Samples_ET.mat, Present, 120, 6066839368, 6269907106, 203067738
/Volumes/methlab_data/HBN/EEG-ET/NDAREL622FA6/NDAREL622FA6_Video1_Samples_ET.mat, Diary, 60, 3252216811, 3369602895, 117386084
/Volumes/methlab_data/HBN/EEG-ET/NDAREL622FA6/NDAREL622FA6_Video3_Samples_ET.mat, Despicable, 60, 2820539377, 2991081051, 170541674
/Volumes/methlab_data/HBN/EEG-ET/NDAREL721PGQ/NDAREL721PGQ_Video-DM_Samples_ET.mat, Despicable, 120, 12634854603, 12805411038, 170556435
/Volumes/methlab_data/HBN/EEG-ET/NDAREL721PGQ/NDAREL721PGQ_Video-FF_Samples_ET.mat, Fractals, 120, 11811908918, 11974896223, 162987305
/Volumes/methlab_data/HBN/EEG-ET/NDAREL721PGQ/NDAREL721PGQ_Video-TP_Samples_ET.mat, Present, 120, 13661047233, 13864124382, 203077149
/Volumes/methlab_data/HBN/EEG-ET/NDAREL721PGQ/NDAREL721PGQ_Video-WK_Samples_ET.mat, Diary, 120, 13072040491, 13189438631, 117398140
/Volumes/methlab_data/HBN/EEG-ET/NDAREL767XXM/NDAREL767XXM_Video-WK_Samples_ET.mat, Diary, 60, 2900071724, 3017468734, 117397010
/Volumes/methlab_data/HBN/EEG-ET/NDAREM018TJQ/NDAREM018TJQ_Video1_Samples_ET.mat, Diary, 60, 2210315333, 2327708390, 117393057
/Volumes/methlab_data/HBN/EEG-ET/NDAREM018TJQ/NDAREM018TJQ_Video3_Samples_ET.mat, Despicable, 60, 3276895683, 3447440353, 170544670
/Volumes/methlab_data/HBN/EEG-ET/NDAREM141CKP/NDAREM141CKP_Video1_Samples_ET.mat, Diary, 60, 1310948675, 1428340567, 117391892
/Volumes/methlab_data/HBN/EEG-ET/NDAREM141CKP/NDAREM141CKP_Video3_Samples_ET.mat, Despicable, 60, 822353783, 992907176, 170553393
/Volumes/methlab_data/HBN/EEG-ET/NDAREM155HGQ/NDAREM155HGQ_Video1_Samples_ET.mat, Fractals, 120, 3887696913, 4050682267, 162985354
/Volumes/methlab_data/HBN/EEG-ET/NDAREM155HGQ/NDAREM155HGQ_Video2_Samples_ET.mat, Diary, 120, 4831168977, 4948559931, 117390954
/Volumes/methlab_data/HBN/EEG-ET/NDAREM155HGQ/NDAREM155HGQ_Video3_Samples_ET.mat, Despicable, 120, 5012909139, 5183455672, 170546533
/Volumes/methlab_data/HBN/EEG-ET/NDAREM155HGQ/NDAREM155HGQ_Video4_Samples_ET.mat, Present, 120, 5731126586, 5934191957, 203065371
/Volumes/methlab_data/HBN/EEG-ET/NDAREM356FXV/NDAREM356FXV_Video-DM_Samples_ET.mat, Despicable, 30, 2969364061, 3139900461, 170536400
/Volumes/methlab_data/HBN/EEG-ET/NDAREM356FXV/NDAREM356FXV_Video-TP_Samples_ET.mat, Present, 30, 3579286627, 3782553146, 203266519
/Volumes/methlab_data/HBN/EEG-ET/NDAREM356FXV/NDAREM356FXV_Video-WK_Samples_ET.mat, Diary, 30, 1895412937, 2012800846, 117387909
/Volumes/methlab_data/HBN/EEG-ET/NDAREM500WWH/NDAREM500WWH_Video1_Samples_ET.mat, Diary, 120, 2931527189, 3048925165, 117397976
/Volumes/methlab_data/HBN/EEG-ET/NDAREM500WWH/NDAREM500WWH_Video2_Samples_ET.mat, Fractals, 120, 4687015848, 4850003029, 162987181
/Volumes/methlab_data/HBN/EEG-ET/NDAREM500WWH/NDAREM500WWH_Video3_Samples_ET.mat, Despicable, 120, 5473942036, 5644488824, 170546788
/Volumes/methlab_data/HBN/EEG-ET/NDAREM500WWH/NDAREM500WWH_Video4_Samples_ET.mat, Present, 120, 6244569936, 6447636059, 203066123
/Volumes/methlab_data/HBN/EEG-ET/NDAREM565ADW/NDAREM565ADW_Video-DM_Samples_ET.mat, Despicable, 60, 10657900236, 10828445074, 170544838
/Volumes/methlab_data/HBN/EEG-ET/NDAREM565ADW/NDAREM565ADW_Video-FF_Samples_ET.mat, Fractals, 60, 10894153596, 11057146065, 162992469
/Volumes/methlab_data/HBN/EEG-ET/NDAREM565ADW/NDAREM565ADW_Video-TP_Samples_ET.mat, Present, 60, 11301373067, 11504432905, 203059838
/Volumes/methlab_data/HBN/EEG-ET/NDAREM565ADW/NDAREM565ADW_Video-WK_Samples_ET.mat, Diary, 60, 11134336731, 11251730892, 117394161
/Volumes/methlab_data/HBN/EEG-ET/NDAREM609ZXW/NDAREM609ZXW_Video-DM_Samples_ET.mat, Despicable, 60, 3704186862, 3874729256, 170542394
/Volumes/methlab_data/HBN/EEG-ET/NDAREM609ZXW/NDAREM609ZXW_Video-FF_Samples_ET.mat, Fractals, 60, 4136121761, 4299107841, 162986080
/Volumes/methlab_data/HBN/EEG-ET/NDAREM609ZXW/NDAREM609ZXW_Video-TP_Samples_ET.mat, Present, 60, 4609078631, 4812198051, 203119420
/Volumes/methlab_data/HBN/EEG-ET/NDAREM609ZXW/NDAREM609ZXW_Video-WK_Samples_ET.mat, Diary, 60, 3145693620, 3263083469, 117389849
/Volumes/methlab_data/HBN/EEG-ET/NDAREM703YFD/NDAREM703YFD_Video1_Samples_ET.mat, Diary, 60, 266060328038, 266177722041, 117394003
/Volumes/methlab_data/HBN/EEG-ET/NDAREM703YFD/NDAREM703YFD_Video3_Samples_ET.mat, Despicable, 60, 265626813557, 265797355143, 170541586
/Volumes/methlab_data/HBN/EEG-ET/NDAREM703YFD/NDAREM703YFD_Video4_Samples_ET.mat, Present, 60, 266475495554, 266678557149, 203061595
/Volumes/methlab_data/HBN/EEG-ET/NDAREM731BYM/NDAREM731BYM_Video1_Samples_ET.mat, Diary, 60, 2132315380, 2249713301, 117397921
/Volumes/methlab_data/HBN/EEG-ET/NDAREM731BYM/NDAREM731BYM_Video3_Samples_ET.mat, Despicable, 60, 3242311313, 3412862793, 170551480
/Volumes/methlab_data/HBN/EEG-ET/NDAREM887YY8/NDAREM887YY8_Video1_Samples_ET.mat, Diary, 60, 3934158155, 4051547166, 117389011
/Volumes/methlab_data/HBN/EEG-ET/NDAREM887YY8/NDAREM887YY8_Video3_Samples_ET.mat, Despicable, 60, 3504613467, 3675154056, 170540589
/Volumes/methlab_data/HBN/EEG-ET/NDAREN151YXN/NDAREN151YXN_Video-DM_Samples_ET.mat, Despicable, 120, 5585466176, 5756009997, 170543821
/Volumes/methlab_data/HBN/EEG-ET/NDAREN151YXN/NDAREN151YXN_Video-FF_Samples_ET.mat, Fractals, 120, 4785595123, 4948580174, 162985051
/Volumes/methlab_data/HBN/EEG-ET/NDAREN151YXN/NDAREN151YXN_Video-TP_Samples_ET.mat, Present, 120, 6649470854, 6852538951, 203068097
/Volumes/methlab_data/HBN/EEG-ET/NDAREN151YXN/NDAREN151YXN_Video-WK_Samples_ET.mat, Diary, 120, 6061334451, 6178732621, 117398170
/Volumes/methlab_data/HBN/EEG-ET/NDAREN417DJE/NDAREN417DJE_Video1_Samples_ET.mat, Fractals, 120, 3043867453, 3206861123, 162993670
/Volumes/methlab_data/HBN/EEG-ET/NDAREN417DJE/NDAREN417DJE_Video2_Samples_ET.mat, Despicable, 120, 4687219166, 4857762663, 170543497
/Volumes/methlab_data/HBN/EEG-ET/NDAREN417DJE/NDAREN417DJE_Video3_Samples_ET.mat, Diary, 120, 5361065233, 5478459245, 117394012
/Volumes/methlab_data/HBN/EEG-ET/NDAREN417DJE/NDAREN417DJE_Video4_Samples_ET.mat, Present, 120, 6203258549, 6406324506, 203065957
/Volumes/methlab_data/HBN/EEG-ET/NDAREN519BLJ/NDAREN519BLJ_Video1_Samples_ET.mat, Diary, 60, 3386872071, 3504255859, 117383788
/Volumes/methlab_data/HBN/EEG-ET/NDAREN519BLJ/NDAREN519BLJ_Video3_Samples_ET.mat, Despicable, 60, 2821044363, 2991585328, 170540965
/Volumes/methlab_data/HBN/EEG-ET/NDAREN667YTZ/NDAREN667YTZ_Video1_Samples_ET.mat, Diary, 120, 3366260045, 3483657197, 117397152
/Volumes/methlab_data/HBN/EEG-ET/NDAREN667YTZ/NDAREN667YTZ_Video2_Samples_ET.mat, Fractals, 120, 4556893597, 4719877672, 162984075
/Volumes/methlab_data/HBN/EEG-ET/NDAREN667YTZ/NDAREN667YTZ_Video3_Samples_ET.mat, Despicable, 120, 5054568949, 5225116502, 170547553
/Volumes/methlab_data/HBN/EEG-ET/NDAREN667YTZ/NDAREN667YTZ_Video4_Samples_ET.mat, Present, 120, 5889014413, 6092081383, 203066970
/Volumes/methlab_data/HBN/EEG-ET/NDAREN969HF7/NDAREN969HF7_Video-DM_Samples_ET.mat, Despicable, 120, 8283398935, 8453945709, 170546774
/Volumes/methlab_data/HBN/EEG-ET/NDAREN969HF7/NDAREN969HF7_Video-FF_Samples_ET.mat, Fractals, 120, 9073090947, 9236073929, 162982982
/Volumes/methlab_data/HBN/EEG-ET/NDAREN969HF7/NDAREN969HF7_Video-TP_Samples_ET.mat, Present, 120, 9274722093, 9477789560, 203067467
/Volumes/methlab_data/HBN/EEG-ET/NDAREN969HF7/NDAREN969HF7_Video-WK_Samples_ET.mat, Diary, 120, 8896267337, 9013655414, 117388077
/Volumes/methlab_data/HBN/EEG-ET/NDAREN999ERM/NDAREN999ERM_Video-DM_Samples_ET.mat, Despicable, 120, 3650010911, 3820557813, 170546902
/Volumes/methlab_data/HBN/EEG-ET/NDAREN999ERM/NDAREN999ERM_Video-FF_Samples_ET.mat, Fractals, 120, 2988204356, 3151201636, 162997280
/Volumes/methlab_data/HBN/EEG-ET/NDAREN999ERM/NDAREN999ERM_Video-TP_Samples_ET.mat, Present, 120, 4829684766, 5032750792, 203066026
/Volumes/methlab_data/HBN/EEG-ET/NDAREN999ERM/NDAREN999ERM_Video-WK_Samples_ET.mat, Diary, 120, 4108718042, 4226116069, 117398027
/Volumes/methlab_data/HBN/EEG-ET/NDAREP061MTY/NDAREP061MTY_Video-DM_Samples_ET.mat, Despicable, 30, 82853500595, 83024042311, 170541716
/Volumes/methlab_data/HBN/EEG-ET/NDAREP061MTY/NDAREP061MTY_Video-TP_Samples_ET.mat, Present, 30, 83847313848, 84050584705, 203270857
/Volumes/methlab_data/HBN/EEG-ET/NDAREP061MTY/NDAREP061MTY_Video-WK_Samples_ET.mat, Diary, 30, 82151678975, 82269064052, 117385077
/Volumes/methlab_data/HBN/EEG-ET/NDAREP505XAD/NDAREP505XAD_Video-DM_Samples_ET.mat, Despicable, 60, 3294429718, 3464974866, 170545148
/Volumes/methlab_data/HBN/EEG-ET/NDAREP505XAD/NDAREP505XAD_Video-FF_Samples_ET.mat, Fractals, 60, 2556700171, 2719694858, 162994687
/Volumes/methlab_data/HBN/EEG-ET/NDAREP505XAD/NDAREP505XAD_Video-TP_Samples_ET.mat, Present, 60, 4183596745, 4386669922, 203073177
/Volumes/methlab_data/HBN/EEG-ET/NDAREP505XAD/NDAREP505XAD_Video-WK_Samples_ET.mat, Diary, 60, 3752969145, 3870364473, 117395328
/Volumes/methlab_data/HBN/EEG-ET/NDARER115FTJ/NDARER115FTJ_Video-DM_Samples_ET.mat, Despicable, 120, 2075260876, 2245808287, 170547411
/Volumes/methlab_data/HBN/EEG-ET/NDARER115FTJ/NDARER115FTJ_Video-FF_Samples_ET.mat, Fractals, 120, 2287289369, 2450271754, 162982385
/Volumes/methlab_data/HBN/EEG-ET/NDARER115FTJ/NDARER115FTJ_Video-TP_Samples_ET.mat, Present, 120, 2733442098, 2936506590, 203064492
/Volumes/methlab_data/HBN/EEG-ET/NDARER115FTJ/NDARER115FTJ_Video-WK_Samples_ET.mat, Diary, 120, 2561307057, 2678704660, 117397603
/Volumes/methlab_data/HBN/EEG-ET/NDARER379GTP/NDARER379GTP_Video-DM_Samples_ET.mat, Despicable, 60, 5271511220, 5442052567, 170541347
/Volumes/methlab_data/HBN/EEG-ET/NDARER379GTP/NDARER379GTP_Video-FF_Samples_ET.mat, Fractals, 60, 4668890017, 4831873081, 162983064
/Volumes/methlab_data/HBN/EEG-ET/NDARER379GTP/NDARER379GTP_Video-TP_Samples_ET.mat, Present, 60, 5852288014, 6055349297, 203061283
/Volumes/methlab_data/HBN/EEG-ET/NDARER379GTP/NDARER379GTP_Video-WK_Samples_ET.mat, Diary, 60, 3902110013, 4019501854, 117391841
/Volumes/methlab_data/HBN/EEG-ET/NDARER840MKU/NDARER840MKU_Video3_Samples_ET.mat, Despicable, 60, 1987774062, 2158317693, 170543631
/Volumes/methlab_data/HBN/EEG-ET/NDARET067PK6/NDARET067PK6_Video-DM_Samples_ET.mat, Despicable, 30, 3610909959, 3781445467, 170535508
/Volumes/methlab_data/HBN/EEG-ET/NDARET067PK6/NDARET067PK6_Video-TP_Samples_ET.mat, Present, 30, 4585330505, 4788606169, 203275664
/Volumes/methlab_data/HBN/EEG-ET/NDARET067PK6/NDARET067PK6_Video-WK_Samples_ET.mat, Diary, 30, 4133713373, 4251101340, 117387967
/Volumes/methlab_data/HBN/EEG-ET/NDARET332CTB/NDARET332CTB_Video1_Samples_ET.mat, Diary, 60, 782227740, 899621546, 117393806
/Volumes/methlab_data/HBN/EEG-ET/NDARET332CTB/NDARET332CTB_Video3_Samples_ET.mat, Despicable, 60, 567184093, 737727380, 170543287
/Volumes/methlab_data/HBN/EEG-ET/NDARET484TTP/NDARET484TTP_Video-DM_Samples_ET.mat, Despicable, 30, 2833954960, 3004490551, 170535591
/Volumes/methlab_data/HBN/EEG-ET/NDARET484TTP/NDARET484TTP_Video-TP_Samples_ET.mat, Present, 30, 3833331526, 4036608254, 203276728
/Volumes/methlab_data/HBN/EEG-ET/NDARET484TTP/NDARET484TTP_Video-WK_Samples_ET.mat, Diary, 30, 2416445784, 2533846813, 117401029
/Volumes/methlab_data/HBN/EEG-ET/NDARET550NXC/NDARET550NXC_Video1_Samples_ET.mat, Diary, 120, 3324310148, 3441708059, 117397911
/Volumes/methlab_data/HBN/EEG-ET/NDARET550NXC/NDARET550NXC_Video2_Samples_ET.mat, Fractals, 120, 4933838547, 5096835911, 162997364
/Volumes/methlab_data/HBN/EEG-ET/NDARET550NXC/NDARET550NXC_Video3_Samples_ET.mat, Despicable, 120, 5711464555, 5882011849, 170547294
/Volumes/methlab_data/HBN/EEG-ET/NDARET550NXC/NDARET550NXC_Video4_Samples_ET.mat, Present, 120, 6275661510, 6478728209, 203066699
/Volumes/methlab_data/HBN/EEG-ET/NDARET558NB3/NDARET558NB3_Video-DM_Samples_ET.mat, Despicable, 60, 3183905200, 3354446618, 170541418
/Volumes/methlab_data/HBN/EEG-ET/NDARET558NB3/NDARET558NB3_Video-FF_Samples_ET.mat, Fractals, 60, 3855409271, 4018404328, 162995057
/Volumes/methlab_data/HBN/EEG-ET/NDARET558NB3/NDARET558NB3_Video-TP_Samples_ET.mat, Present, 60, 4333464754, 4536524084, 203059330
/Volumes/methlab_data/HBN/EEG-ET/NDARET558NB3/NDARET558NB3_Video-WK_Samples_ET.mat, Diary, 60, 2280536501, 2397932391, 117395890
/Volumes/methlab_data/HBN/EEG-ET/NDARET632ELD/NDARET632ELD_Video1_Samples_ET.mat, Diary, 120, 2906203183, 3023600601, 117397418
/Volumes/methlab_data/HBN/EEG-ET/NDARET632ELD/NDARET632ELD_Video2_Samples_ET.mat, Fractals, 120, 4045474713, 4208462323, 162987610
/Volumes/methlab_data/HBN/EEG-ET/NDARET632ELD/NDARET632ELD_Video3_Samples_ET.mat, Despicable, 120, 4538562089, 4709109170, 170547081
/Volumes/methlab_data/HBN/EEG-ET/NDARET632ELD/NDARET632ELD_Video4_Samples_ET.mat, Present, 120, 5266136830, 5469204239, 203067409
/Volumes/methlab_data/HBN/EEG-ET/NDARET653TAM/NDARET653TAM_Video1_Samples_ET.mat, Diary, 60, 1692328025, 1809725079, 117397054
/Volumes/methlab_data/HBN/EEG-ET/NDARET653TAM/NDARET653TAM_Video3_Samples_ET.mat, Despicable, 60, 3108213449, 3278763099, 170549650
/Volumes/methlab_data/HBN/EEG-ET/NDARET888KD2/NDARET888KD2_Video-DM_Samples_ET.mat, Despicable, 60, 8060095729, 8230633258, 170537529
/Volumes/methlab_data/HBN/EEG-ET/NDARET888KD2/NDARET888KD2_Video-TP_Samples_ET.mat, Present, 60, 8970559109, 9173837792, 203278683
/Volumes/methlab_data/HBN/EEG-ET/NDARET888KD2/NDARET888KD2_Video-WK_Samples_ET.mat, Diary, 60, 8550751457, 8668141438, 117389981
/Volumes/methlab_data/HBN/EEG-ET/NDARET949LMU/NDARET949LMU_Video1_Samples_ET.mat, Diary, 60, 2750692378, 2868085251, 117392873
/Volumes/methlab_data/HBN/EEG-ET/NDARET949LMU/NDARET949LMU_Video3_Samples_ET.mat, Despicable, 60, 4042305159, 4212848556, 170543397
/Volumes/methlab_data/HBN/EEG-ET/NDAREU438HAF/NDAREU438HAF_Video-DM_Samples_ET.mat, Despicable, 60, 2941397668, 3111941307, 170543639
/Volumes/methlab_data/HBN/EEG-ET/NDAREU438HAF/NDAREU438HAF_Video-FF_Samples_ET.mat, Fractals, 60, 2483495824, 2646478124, 162982300
/Volumes/methlab_data/HBN/EEG-ET/NDAREU438HAF/NDAREU438HAF_Video-TP_Samples_ET.mat, Present, 60, 3416002343, 3619065997, 203063654
/Volumes/methlab_data/HBN/EEG-ET/NDAREU551GPC/NDAREU551GPC_Video1_Samples_ET.mat, Diary, 60, 2435136462, 2552531337, 117394875
/Volumes/methlab_data/HBN/EEG-ET/NDAREU551GPC/NDAREU551GPC_Video3_Samples_ET.mat, Despicable, 60, 3644844414, 3815394856, 170550442
/Volumes/methlab_data/HBN/EEG-ET/NDAREU591YYA/NDAREU591YYA_Video1_Samples_ET.mat, Diary, 120, 3120801941, 3238197859, 117395918
/Volumes/methlab_data/HBN/EEG-ET/NDAREU591YYA/NDAREU591YYA_Video2_Samples_ET.mat, Fractals, 120, 3936954922, 4099952704, 162997782
/Volumes/methlab_data/HBN/EEG-ET/NDAREU591YYA/NDAREU591YYA_Video3_Samples_ET.mat, Despicable, 120, 4427563333, 4598110231, 170546898
/Volumes/methlab_data/HBN/EEG-ET/NDAREU591YYA/NDAREU591YYA_Video4_Samples_ET.mat, Present, 120, 4995810211, 5198876741, 203066530
/Volumes/methlab_data/HBN/EEG-ET/NDAREU890CYJ/NDAREU890CYJ_Video-DM_Samples_ET.mat, Despicable, 30, 3134518422, 3305054962, 170536540
/Volumes/methlab_data/HBN/EEG-ET/NDAREU890CYJ/NDAREU890CYJ_Video-TP_Samples_ET.mat, Present, 30, 4628279978, 4831546632, 203266654
/Volumes/methlab_data/HBN/EEG-ET/NDAREU890CYJ/NDAREU890CYJ_Video-WK_Samples_ET.mat, Diary, 30, 3795806719, 3913194685, 117387966
/Volumes/methlab_data/HBN/EEG-ET/NDAREV342ABE/NDAREV342ABE_Video1_Samples_ET.mat, Despicable, 120, 2203641361, 2374188126, 170546765
/Volumes/methlab_data/HBN/EEG-ET/NDAREV342ABE/NDAREV342ABE_Video2_Samples_ET.mat, Diary, 120, 2416449663, 2533846954, 117397291
/Volumes/methlab_data/HBN/EEG-ET/NDAREV342ABE/NDAREV342ABE_Video3_Samples_ET.mat, Fractals, 120, 2570055097, 2733039767, 162984670
/Volumes/methlab_data/HBN/EEG-ET/NDAREV342ABE/NDAREV342ABE_Video4_Samples_ET.mat, Present, 120, 2773997768, 2977064338, 203066570
/Volumes/methlab_data/HBN/EEG-ET/NDAREV372WDG/NDAREV372WDG_Video-DM_Samples_ET.mat, Despicable, 60, 5097077383, 5267621147, 170543764
/Volumes/methlab_data/HBN/EEG-ET/NDAREV372WDG/NDAREV372WDG_Video-FF_Samples_ET.mat, Fractals, 60, 3984630780, 4147618217, 162987437
/Volumes/methlab_data/HBN/EEG-ET/NDAREV372WDG/NDAREV372WDG_Video-TP_Samples_ET.mat, Present, 60, 5698177966, 5901246751, 203068785
/Volumes/methlab_data/HBN/EEG-ET/NDAREV372WDG/NDAREV372WDG_Video-WK_Samples_ET.mat, Diary, 60, 4665802036, 4783195197, 117393161
/Volumes/methlab_data/HBN/EEG-ET/NDAREV527ZRF/NDAREV527ZRF_Video1_Samples_ET.mat, Diary, 120, 3051387412, 3168776250, 117388838
/Volumes/methlab_data/HBN/EEG-ET/NDAREV527ZRF/NDAREV527ZRF_Video2_Samples_ET.mat, Fractals, 120, 6055286970, 6218275092, 162988122
/Volumes/methlab_data/HBN/EEG-ET/NDAREV527ZRF/NDAREV527ZRF_Video3_Samples_ET.mat, Despicable, 120, 6764493056, 6935039837, 170546781
/Volumes/methlab_data/HBN/EEG-ET/NDAREV527ZRF/NDAREV527ZRF_Video4_Samples_ET.mat, Present, 120, 7420609418, 7623685924, 203076506
/Volumes/methlab_data/HBN/EEG-ET/NDAREV601CE7/NDAREV601CE7_Video1_Samples_ET.mat, Diary, 120, 3460224552, 3577620966, 117396414
/Volumes/methlab_data/HBN/EEG-ET/NDAREV601CE7/NDAREV601CE7_Video2_Samples_ET.mat, Fractals, 120, 4939743066, 5102740993, 162997927
/Volumes/methlab_data/HBN/EEG-ET/NDAREV601CE7/NDAREV601CE7_Video3_Samples_ET.mat, Despicable, 120, 5496868979, 5667416880, 170547901
/Volumes/methlab_data/HBN/EEG-ET/NDAREV601CE7/NDAREV601CE7_Video4_Samples_ET.mat, Present, 120, 6221754603, 6424821440, 203066837
/Volumes/methlab_data/HBN/EEG-ET/NDAREV617HAP/NDAREV617HAP_Video1_Samples_ET.mat, Diary, 60, 5076003080, 5193394278, 117391198
/Volumes/methlab_data/HBN/EEG-ET/NDAREV617HAP/NDAREV617HAP_Video3_Samples_ET.mat, Despicable, 60, 4641117866, 4811667780, 170549914
/Volumes/methlab_data/HBN/EEG-ET/NDAREV617HAP/NDAREV617HAP_Video4_Samples_ET.mat, Present, 60, 5502625390, 5705696338, 203070948
/Volumes/methlab_data/HBN/EEG-ET/NDAREV848HWX/NDAREV848HWX_Video-DM_Samples_ET.mat, Despicable, 120, 5569163170, 5739711438, 170548268
/Volumes/methlab_data/HBN/EEG-ET/NDAREV848HWX/NDAREV848HWX_Video-FF_Samples_ET.mat, Fractals, 120, 5136348911, 5299335873, 162986962
/Volumes/methlab_data/HBN/EEG-ET/NDAREV848HWX/NDAREV848HWX_Video-TP_Samples_ET.mat, Present, 120, 6239851303, 6442916118, 203064815
/Volumes/methlab_data/HBN/EEG-ET/NDAREV848HWX/NDAREV848HWX_Video-WK_Samples_ET.mat, Diary, 120, 4293672719, 4411070152, 117397433
/Volumes/methlab_data/HBN/EEG-ET/NDAREV970HAN/NDAREV970HAN_Video1_Samples_ET.mat, Diary, 60, 2156477071, 2273870965, 117393894
/Volumes/methlab_data/HBN/EEG-ET/NDAREV970HAN/NDAREV970HAN_Video3_Samples_ET.mat, Despicable, 60, 3295707284, 3466248706, 170541422
/Volumes/methlab_data/HBN/EEG-ET/NDAREW074ZM2/NDAREW074ZM2_Video-DM_Samples_ET.mat, Despicable, 60, 4390235676, 4560780271, 170544595
/Volumes/methlab_data/HBN/EEG-ET/NDAREW074ZM2/NDAREW074ZM2_Video-FF_Samples_ET.mat, Fractals, 60, 3953423870, 4116416256, 162992386
/Volumes/methlab_data/HBN/EEG-ET/NDAREW074ZM2/NDAREW074ZM2_Video-TP_Samples_ET.mat, Present, 60, 4873701487, 5076772097, 203070610
/Volumes/methlab_data/HBN/EEG-ET/NDAREW074ZM2/NDAREW074ZM2_Video-WK_Samples_ET.mat, Diary, 60, 3320715517, 3438111532, 117396015
/Volumes/methlab_data/HBN/EEG-ET/NDAREW201WD9/NDAREW201WD9_Video1_Samples_ET.mat, Diary, 60, 18800766254, 18918157000, 117390746
/Volumes/methlab_data/HBN/EEG-ET/NDAREW201WD9/NDAREW201WD9_Video3_Samples_ET.mat, Despicable, 60, 18365575090, 18536124421, 170549331
/Volumes/methlab_data/HBN/EEG-ET/NDAREW201WD9/NDAREW201WD9_Video4_Samples_ET.mat, Present, 60, 19285688278, 19488756583, 203068305
/Volumes/methlab_data/HBN/EEG-ET/NDAREW430AYU/NDAREW430AYU_Video-DM_Samples_ET.mat, Despicable, 60, 1615212447, 1785751222, 170538775
/Volumes/methlab_data/HBN/EEG-ET/NDAREW430AYU/NDAREW430AYU_Video-TP_Samples_ET.mat, Present, 60, 2256556689, 2459828724, 203272035
/Volumes/methlab_data/HBN/EEG-ET/NDAREW430AYU/NDAREW430AYU_Video-WK_Samples_ET.mat, Diary, 60, 2093398126, 2210790292, 117392166
/Volumes/methlab_data/HBN/EEG-ET/NDAREW531JV9/NDAREW531JV9_Video-DM_Samples_ET.mat, Despicable, 60, 5070160492, 5240699132, 170538640
/Volumes/methlab_data/HBN/EEG-ET/NDAREW531JV9/NDAREW531JV9_Video-TP_Samples_ET.mat, Present, 60, 6147082163, 6350359969, 203277806
/Volumes/methlab_data/HBN/EEG-ET/NDAREW531JV9/NDAREW531JV9_Video-WK_Samples_ET.mat, Diary, 60, 4421853973, 4539245029, 117391056
/Volumes/methlab_data/HBN/EEG-ET/NDAREW557WZM/NDAREW557WZM_Video-DM_Samples_ET.mat, Despicable, 30, 3962042905, 4132579540, 170536635
/Volumes/methlab_data/HBN/EEG-ET/NDAREW557WZM/NDAREW557WZM_Video-TP_Samples_ET.mat, Present, 30, 4803101773, 5006373570, 203271797
/Volumes/methlab_data/HBN/EEG-ET/NDAREW557WZM/NDAREW557WZM_Video-WK_Samples_ET.mat, Diary, 30, 4387407748, 4504793851, 117386103
/Volumes/methlab_data/HBN/EEG-ET/NDAREW594DC5/NDAREW594DC5_Video-DM_Samples_ET.mat, Despicable, 30, 3419885096, 3590420564, 170535468
/Volumes/methlab_data/HBN/EEG-ET/NDAREW594DC5/NDAREW594DC5_Video-TP_Samples_ET.mat, Present, 30, 4399114713, 4602380289, 203265576
/Volumes/methlab_data/HBN/EEG-ET/NDAREW594DC5/NDAREW594DC5_Video-WK_Samples_ET.mat, Diary, 30, 3923067527, 4040457406, 117389879
/Volumes/methlab_data/HBN/EEG-ET/NDAREW671HZW/NDAREW671HZW_Video1_Samples_ET.mat, Diary, 60, 9311116790, 9418432721, 107315931
/Volumes/methlab_data/HBN/EEG-ET/NDAREW671HZW/NDAREW671HZW_Video2_Samples_ET.mat, Fractals, 60, 7914794209, 8077783512, 162989303
/Volumes/methlab_data/HBN/EEG-ET/NDAREW671HZW/NDAREW671HZW_Video3_Samples_ET.mat, Despicable, 60, 8707432812, 8877970454, 170537642
/Volumes/methlab_data/HBN/EEG-ET/NDAREW671HZW/NDAREW671HZW_Video4_Samples_ET.mat, Present, 60, 9836949671, 10040025472, 203075801
/Volumes/methlab_data/HBN/EEG-ET/NDAREW937RMY/NDAREW937RMY_Video-DM_Samples_ET.mat, Despicable, 120, 3207575187, 3378120885, 170545698
/Volumes/methlab_data/HBN/EEG-ET/NDAREW937RMY/NDAREW937RMY_Video-FF_Samples_ET.mat, Fractals, 120, 2692887806, 2855884051, 162996245
/Volumes/methlab_data/HBN/EEG-ET/NDAREW937RMY/NDAREW937RMY_Video-TP_Samples_ET.mat, Present, 120, 3849360219, 4052426516, 203066297
/Volumes/methlab_data/HBN/EEG-ET/NDAREW937RMY/NDAREW937RMY_Video-WK_Samples_ET.mat, Diary, 120, 3027854185, 3145252153, 117397968
/Volumes/methlab_data/HBN/EEG-ET/NDAREW976FNL/NDAREW976FNL_Video1_Samples_ET.mat, Diary, 120, 4641987258, 4759384657, 117397399
/Volumes/methlab_data/HBN/EEG-ET/NDAREW976FNL/NDAREW976FNL_Video2_Samples_ET.mat, Fractals, 120, 5821900474, 5984887068, 162986594
/Volumes/methlab_data/HBN/EEG-ET/NDAREX065KJU/NDAREX065KJU_Video1_Samples_ET.mat, Diary, 60, 76061434263, 76178828263, 117394000
/Volumes/methlab_data/HBN/EEG-ET/NDAREX065KJU/NDAREX065KJU_Video2_Samples_ET.mat, Fractals, 60, 76824652861, 76987630094, 162977233
/Volumes/methlab_data/HBN/EEG-ET/NDAREX065KJU/NDAREX065KJU_Video3_Samples_ET.mat, Despicable, 60, 77281734002, 77452275617, 170541615
/Volumes/methlab_data/HBN/EEG-ET/NDAREX065KJU/NDAREX065KJU_Video4_Samples_ET.mat, Present, 60, 77818230315, 78021284892, 203054577
/Volumes/methlab_data/HBN/EEG-ET/NDAREX091KUR/NDAREX091KUR_Video1_Samples_ET.mat, Diary, 60, 2639582285, 2756978431, 117396146
/Volumes/methlab_data/HBN/EEG-ET/NDAREX091KUR/NDAREX091KUR_Video3_Samples_ET.mat, Despicable, 60, 3332352781, 3502905511, 170552730
/Volumes/methlab_data/HBN/EEG-ET/NDAREX336AC1/NDAREX336AC1_Video1_Samples_ET.mat, Diary, 120, 3453840162, 3571236854, 117396692
/Volumes/methlab_data/HBN/EEG-ET/NDAREX336AC1/NDAREX336AC1_Video2_Samples_ET.mat, Despicable, 120, 4387994329, 4558541114, 170546785
/Volumes/methlab_data/HBN/EEG-ET/NDAREX336AC1/NDAREX336AC1_Video3_Samples_ET.mat, Fractals, 120, 4937090381, 5100077345, 162986964
/Volumes/methlab_data/HBN/EEG-ET/NDAREX336AC1/NDAREX336AC1_Video4_Samples_ET.mat, Present, 120, 5694782672, 5897846475, 203063803
/Volumes/methlab_data/HBN/EEG-ET/NDAREX589EXG/NDAREX589EXG_Video1_Samples_ET.mat, Diary, 60, 3406584038, 3523978991, 117394953
/Volumes/methlab_data/HBN/EEG-ET/NDAREX589EXG/NDAREX589EXG_Video2_Samples_ET.mat, Fractals, 60, 4059399102, 4222394272, 162995170
/Volumes/methlab_data/HBN/EEG-ET/NDAREX589EXG/NDAREX589EXG_Video3_Samples_ET.mat, Despicable, 60, 4567533996, 4738075520, 170541524
/Volumes/methlab_data/HBN/EEG-ET/NDAREX589EXG/NDAREX589EXG_Video4_Samples_ET.mat, Present, 60, 5083064103, 5286135565, 203071462
/Volumes/methlab_data/HBN/EEG-ET/NDAREY512KVX/NDAREY512KVX_Video1_Samples_ET.mat, Fractals, 120, 5450071238, 5613067732, 162996494
/Volumes/methlab_data/HBN/EEG-ET/NDAREY512KVX/NDAREY512KVX_Video2_Samples_ET.mat, Despicable, 120, 6377474960, 6548021635, 170546675
/Volumes/methlab_data/HBN/EEG-ET/NDAREY512KVX/NDAREY512KVX_Video3_Samples_ET.mat, Diary, 120, 6610963717, 6728361175, 117397458
/Volumes/methlab_data/HBN/EEG-ET/NDAREY512KVX/NDAREY512KVX_Video4_Samples_ET.mat, Present, 120, 6774302635, 6977369360, 203066725
/Volumes/methlab_data/HBN/EEG-ET/NDAREY741MG9/NDAREY741MG9_Video1_Samples_ET.mat, Diary, 60, 2908388854, 3025782036, 117393182
/Volumes/methlab_data/HBN/EEG-ET/NDAREY741MG9/NDAREY741MG9_Video3_Samples_ET.mat, Despicable, 60, 2450893277, 2621438001, 170544724
/Volumes/methlab_data/HBN/EEG-ET/NDAREY778CR9/NDAREY778CR9_Video1_Samples_ET.mat, Diary, 60, 3440976299, 3558366389, 117390090
/Volumes/methlab_data/HBN/EEG-ET/NDAREY778CR9/NDAREY778CR9_Video3_Samples_ET.mat, Despicable, 60, 2717813862, 2888354405, 170540543
/Volumes/methlab_data/HBN/EEG-ET/NDAREY897LB1/NDAREY897LB1_Video1_Samples_ET.mat, Diary, 60, 18178999964, 18296386202, 117386238
/Volumes/methlab_data/HBN/EEG-ET/NDAREY897LB1/NDAREY897LB1_Video2_Samples_ET.mat, Fractals, 60, 19229684315, 19392671345, 162987030
/Volumes/methlab_data/HBN/EEG-ET/NDAREY897LB1/NDAREY897LB1_Video3_Samples_ET.mat, Despicable, 60, 18759021213, 18929558578, 170537365
/Volumes/methlab_data/HBN/EEG-ET/NDAREY897LB1/NDAREY897LB1_Video4_Samples_ET.mat, Present, 60, 212181508, 415249826, 203068318
/Volumes/methlab_data/HBN/EEG-ET/NDAREZ060XH6/NDAREZ060XH6_Video-DM_Samples_ET.mat, Despicable, 60, 4118361419, 4288913096, 170551677
/Volumes/methlab_data/HBN/EEG-ET/NDAREZ060XH6/NDAREZ060XH6_Video-FF_Samples_ET.mat, Fractals, 60, 4585943127, 4748937414, 162994287
/Volumes/methlab_data/HBN/EEG-ET/NDAREZ060XH6/NDAREZ060XH6_Video-TP_Samples_ET.mat, Present, 60, 5177872783, 5380934433, 203061650
/Volumes/methlab_data/HBN/EEG-ET/NDAREZ060XH6/NDAREZ060XH6_Video-WK_Samples_ET.mat, Diary, 60, 3577588945, 3694985987, 117397042
/Volumes/methlab_data/HBN/EEG-ET/NDAREZ098ZPE/NDAREZ098ZPE_Video1_Samples_ET.mat, Diary, 60, 1947632994, 2065028951, 117395957
/Volumes/methlab_data/HBN/EEG-ET/NDAREZ098ZPE/NDAREZ098ZPE_Video3_Samples_ET.mat, Despicable, 60, 3202800533, 3373342974, 170542441
/Volumes/methlab_data/HBN/EEG-ET/NDAREZ416XDW/NDAREZ416XDW_Video-DM_Samples_ET.mat, Despicable, 120, 6450260821, 6620802175, 170541354
/Volumes/methlab_data/HBN/EEG-ET/NDAREZ416XDW/NDAREZ416XDW_Video-FF_Samples_ET.mat, Fractals, 120, 5297507057, 5460493609, 162986552
/Volumes/methlab_data/HBN/EEG-ET/NDAREZ416XDW/NDAREZ416XDW_Video-TP_Samples_ET.mat, Present, 120, 7100647138, 7303713040, 203065902
/Volumes/methlab_data/HBN/EEG-ET/NDAREZ416XDW/NDAREZ416XDW_Video-WK_Samples_ET.mat, Diary, 120, 6021922172, 6139319832, 117397660
/Volumes/methlab_data/HBN/EEG-ET/NDARFA089ZZG/NDARFA089ZZG_Video-DM_Samples_ET.mat, Despicable, 120, 5362309868, 5532856836, 170546968
/Volumes/methlab_data/HBN/EEG-ET/NDARFA089ZZG/NDARFA089ZZG_Video-FF_Samples_ET.mat, Fractals, 120, 4571794864, 4734782404, 162987540
/Volumes/methlab_data/HBN/EEG-ET/NDARFA089ZZG/NDARFA089ZZG_Video-TP_Samples_ET.mat, Present, 120, 6497158772, 6700222925, 203064153
/Volumes/methlab_data/HBN/EEG-ET/NDARFA089ZZG/NDARFA089ZZG_Video-WK_Samples_ET.mat, Diary, 120, 5943787400, 6061174459, 117387059
/Volumes/methlab_data/HBN/EEG-ET/NDARFA165XBV/NDARFA165XBV_Video1_Samples_ET.mat, Diary, 60, 2564018486, 2681413381, 117394895
/Volumes/methlab_data/HBN/EEG-ET/NDARFA165XBV/NDARFA165XBV_Video2_Samples_ET.mat, Fractals, 60, 1760158015, 1923142088, 162984073
/Volumes/methlab_data/HBN/EEG-ET/NDARFA165XBV/NDARFA165XBV_Video3_Samples_ET.mat, Despicable, 60, 2979827042, 3150369439, 170542397
/Volumes/methlab_data/HBN/EEG-ET/NDARFA165XBV/NDARFA165XBV_Video4_Samples_ET.mat, Present, 60, 3472467819, 3675530165, 203062346
/Volumes/methlab_data/HBN/EEG-ET/NDARFA233CUK/NDARFA233CUK_Video1_Samples_ET.mat, Fractals, 120, 5606417626, 5769413811, 162996185
/Volumes/methlab_data/HBN/EEG-ET/NDARFA233CUK/NDARFA233CUK_Video2_Samples_ET.mat, Despicable, 120, 6618001392, 6788548542, 170547150
/Volumes/methlab_data/HBN/EEG-ET/NDARFA233CUK/NDARFA233CUK_Video3_Samples_ET.mat, Diary, 120, 7068198714, 7185596162, 117397448
/Volumes/methlab_data/HBN/EEG-ET/NDARFA233CUK/NDARFA233CUK_Video4_Samples_ET.mat, Present, 120, 7644257988, 7847321084, 203063096
/Volumes/methlab_data/HBN/EEG-ET/NDARFA358RJJ/NDARFA358RJJ_Video-DM_Samples_ET.mat, Despicable, 30, 6148941535, 6319480297, 170538762
/Volumes/methlab_data/HBN/EEG-ET/NDARFA358RJJ/NDARFA358RJJ_Video-TP_Samples_ET.mat, Present, 30, 6650307513, 6853583465, 203275952
/Volumes/methlab_data/HBN/EEG-ET/NDARFA358RJJ/NDARFA358RJJ_Video-WK_Samples_ET.mat, Diary, 30, 4277878860, 4395265012, 117386152
/Volumes/methlab_data/HBN/EEG-ET/NDARFA402LMW/NDARFA402LMW_Video1_Samples_ET.mat, Diary, 60, 6623338295, 6740732289, 117393994
/Volumes/methlab_data/HBN/EEG-ET/NDARFA402LMW/NDARFA402LMW_Video3_Samples_ET.mat, Despicable, 60, 6087456629, 6257998160, 170541531
/Volumes/methlab_data/HBN/EEG-ET/NDARFA737TG6/NDARFA737TG6_Video1_Samples_ET.mat, Diary, 60, 4838044062, 4955437911, 117393849
/Volumes/methlab_data/HBN/EEG-ET/NDARFA737TG6/NDARFA737TG6_Video2_Samples_ET.mat, Fractals, 60, 4635543177, 4798534214, 162991037
/Volumes/methlab_data/HBN/EEG-ET/NDARFA737TG6/NDARFA737TG6_Video3_Samples_ET.mat, Despicable, 60, 4419309610, 4589851993, 170542383
/Volumes/methlab_data/HBN/EEG-ET/NDARFA737TG6/NDARFA737TG6_Video4_Samples_ET.mat, Present, 60, 4993447727, 5196519030, 203071303
/Volumes/methlab_data/HBN/EEG-ET/NDARFA804ZLW/NDARFA804ZLW_Video-DM_Samples_ET.mat, Despicable, 120, 5638832470, 5809375858, 170543388
/Volumes/methlab_data/HBN/EEG-ET/NDARFA804ZLW/NDARFA804ZLW_Video-FF_Samples_ET.mat, Fractals, 120, 5256002075, 5418989717, 162987642
/Volumes/methlab_data/HBN/EEG-ET/NDARFA804ZLW/NDARFA804ZLW_Video-TP_Samples_ET.mat, Present, 120, 6277612663, 6480674296, 203061633
/Volumes/methlab_data/HBN/EEG-ET/NDARFA804ZLW/NDARFA804ZLW_Video-WK_Samples_ET.mat, Diary, 120, 4520700048, 4638094623, 117394575
/Volumes/methlab_data/HBN/EEG-ET/NDARFA811KTX/NDARFA811KTX_Video1_Samples_ET.mat, Diary, 60, 3308892923, 3426284916, 117391993
/Volumes/methlab_data/HBN/EEG-ET/NDARFA811KTX/NDARFA811KTX_Video3_Samples_ET.mat, Despicable, 60, 2880297067, 3050841585, 170544518
/Volumes/methlab_data/HBN/EEG-ET/NDARFA811KTX/NDARFA811KTX_Video4_Samples_ET.mat, Present, 60, 3716696149, 3919768618, 203072469
/Volumes/methlab_data/HBN/EEG-ET/NDARFA815FXE/NDARFA815FXE_Video1_Samples_ET.mat, Diary, 60, 21258746272, 21376142289, 117396017
/Volumes/methlab_data/HBN/EEG-ET/NDARFA815FXE/NDARFA815FXE_Video3_Samples_ET.mat, Despicable, 60, 20735973971, 20906530397, 170556426
/Volumes/methlab_data/HBN/EEG-ET/NDARFA860RPD/NDARFA860RPD_Video1_Samples_ET.mat, Diary, 60, 2206788588, 2324179014, 117390426
/Volumes/methlab_data/HBN/EEG-ET/NDARFA860RPD/NDARFA860RPD_Video3_Samples_ET.mat, Despicable, 60, 1954669489, 2125217671, 170548182
/Volumes/methlab_data/HBN/EEG-ET/NDARFB146TG0/NDARFB146TG0_Video-DM_Samples_ET.mat, Despicable, 30, 4809525455, 4980059925, 170534470
/Volumes/methlab_data/HBN/EEG-ET/NDARFB371EMF/NDARFB371EMF_Video-DM_Samples_ET.mat, Despicable, 60, 4958201187, 5128743921, 170542734
/Volumes/methlab_data/HBN/EEG-ET/NDARFB371EMF/NDARFB371EMF_Video-FF_Samples_ET.mat, Fractals, 60, 5395474747, 5558468194, 162993447
/Volumes/methlab_data/HBN/EEG-ET/NDARFB371EMF/NDARFB371EMF_Video-TP_Samples_ET.mat, Present, 60, 5868251461, 6071313246, 203061785
/Volumes/methlab_data/HBN/EEG-ET/NDARFB371EMF/NDARFB371EMF_Video-WK_Samples_ET.mat, Diary, 60, 3945243001, 4062639144, 117396143
/Volumes/methlab_data/HBN/EEG-ET/NDARFB506UJ3/NDARFB506UJ3_Video1_Samples_ET.mat, Diary, 120, 5240747294, 5358144261, 117396967
/Volumes/methlab_data/HBN/EEG-ET/NDARFB506UJ3/NDARFB506UJ3_Video2_Samples_ET.mat, Fractals, 120, 6137212344, 6300198213, 162985869
/Volumes/methlab_data/HBN/EEG-ET/NDARFB506UJ3/NDARFB506UJ3_Video3_Samples_ET.mat, Despicable, 120, 6642926427, 6813469671, 170543244
/Volumes/methlab_data/HBN/EEG-ET/NDARFB506UJ3/NDARFB506UJ3_Video4_Samples_ET.mat, Present, 120, 7250025727, 7453092524, 203066797
/Volumes/methlab_data/HBN/EEG-ET/NDARFB528UVB/NDARFB528UVB_Video-DM_Samples_ET.mat, Despicable, 60, 6654901013, 6825436301, 170535288
/Volumes/methlab_data/HBN/EEG-ET/NDARFB528UVB/NDARFB528UVB_Video-TP_Samples_ET.mat, Present, 60, 7673000979, 7876269539, 203268560
/Volumes/methlab_data/HBN/EEG-ET/NDARFB528UVB/NDARFB528UVB_Video-WK_Samples_ET.mat, Diary, 60, 5828462329, 5945853831, 117391502
/Volumes/methlab_data/HBN/EEG-ET/NDARFB575BAT/NDARFB575BAT_Video1_Samples_ET.mat, Diary, 60, 2936726693, 3054120793, 117394100
/Volumes/methlab_data/HBN/EEG-ET/NDARFB575BAT/NDARFB575BAT_Video3_Samples_ET.mat, Despicable, 60, 4608887959, 4779429662, 170541703
/Volumes/methlab_data/HBN/EEG-ET/NDARFB757VY3/NDARFB757VY3_Video1_Samples_ET.mat, Diary, 60, 3998314495, 4115708953, 117394458
/Volumes/methlab_data/HBN/EEG-ET/NDARFB757VY3/NDARFB757VY3_Video2_Samples_ET.mat, Fractals, 60, 4633183733, 4796171576, 162987843
/Volumes/methlab_data/HBN/EEG-ET/NDARFB757VY3/NDARFB757VY3_Video3_Samples_ET.mat, Despicable, 60, 5084868762, 5255417986, 170549224
/Volumes/methlab_data/HBN/EEG-ET/NDARFB757VY3/NDARFB757VY3_Video4_Samples_ET.mat, Present, 60, 5550202485, 5753264845, 203062360
/Volumes/methlab_data/HBN/EEG-ET/NDARFB908HVX/NDARFB908HVX_Video1_Samples_ET.mat, Diary, 60, 4209833787, 4327228688, 117394901
/Volumes/methlab_data/HBN/EEG-ET/NDARFB908HVX/NDARFB908HVX_Video3_Samples_ET.mat, Despicable, 60, 3989970583, 4160516015, 170545432
/Volumes/methlab_data/HBN/EEG-ET/NDARFB969EMV/NDARFB969EMV_Video1_Samples_ET.mat, Diary, 120, 3857629171, 3975026669, 117397498
/Volumes/methlab_data/HBN/EEG-ET/NDARFB969EMV/NDARFB969EMV_Video2_Samples_ET.mat, Fractals, 120, 5130802153, 5293789951, 162987798
/Volumes/methlab_data/HBN/EEG-ET/NDARFB969EMV/NDARFB969EMV_Video3_Samples_ET.mat, Despicable, 120, 5710399953, 5880946743, 170546790
/Volumes/methlab_data/HBN/EEG-ET/NDARFB969EMV/NDARFB969EMV_Video4_Samples_ET.mat, Present, 120, 6381321949, 6584387956, 203066007
/Volumes/methlab_data/HBN/EEG-ET/NDARFC051FVC/NDARFC051FVC_Video-DM_Samples_ET.mat, Despicable, 60, 1012080085, 1182625919, 170545834
/Volumes/methlab_data/HBN/EEG-ET/NDARFC051FVC/NDARFC051FVC_Video-FF_Samples_ET.mat, Fractals, 60, 389632181, 552626655, 162994474
/Volumes/methlab_data/HBN/EEG-ET/NDARFC051FVC/NDARFC051FVC_Video-TP_Samples_ET.mat, Present, 60, 1902052497, 2105114346, 203061849
/Volumes/methlab_data/HBN/EEG-ET/NDARFC051FVC/NDARFC051FVC_Video-WK_Samples_ET.mat, Diary, 60, 1453318641, 1570710822, 117392181
/Volumes/methlab_data/HBN/EEG-ET/NDARFC203HCD/NDARFC203HCD_Video-DM_Samples_ET.mat, Despicable, 60, 4552815344, 4723359743, 170544399
/Volumes/methlab_data/HBN/EEG-ET/NDARFC203HCD/NDARFC203HCD_Video-FF_Samples_ET.mat, Fractals, 60, 4043225585, 4206217679, 162992094
/Volumes/methlab_data/HBN/EEG-ET/NDARFC203HCD/NDARFC203HCD_Video-TP_Samples_ET.mat, Present, 60, 5200064229, 5403128616, 203064387
/Volumes/methlab_data/HBN/EEG-ET/NDARFC203HCD/NDARFC203HCD_Video-WK_Samples_ET.mat, Diary, 60, 3604298742, 3721692635, 117393893
/Volumes/methlab_data/HBN/EEG-ET/NDARFC286KV1/NDARFC286KV1_Video-DM_Samples_ET.mat, Despicable, 60, 2781495748, 2952035108, 170539360
/Volumes/methlab_data/HBN/EEG-ET/NDARFC694PW2/NDARFC694PW2_Video-DM_Samples_ET.mat, Despicable, 30, 3462364531, 3632903954, 170539423
/Volumes/methlab_data/HBN/EEG-ET/NDARFC694PW2/NDARFC694PW2_Video-TP_Samples_ET.mat, Present, 30, 4348906417, 4552183913, 203277496
/Volumes/methlab_data/HBN/EEG-ET/NDARFC694PW2/NDARFC694PW2_Video-WK_Samples_ET.mat, Diary, 30, 2939600495, 3056989380, 117388885
/Volumes/methlab_data/HBN/EEG-ET/NDARFD069AW7/NDARFD069AW7_Video-WK_Samples_ET.mat, Diary, 60, 4191888959, 4309280129, 117391170
/Volumes/methlab_data/HBN/EEG-ET/NDARFD316UD2/NDARFD316UD2_Video1_Samples_ET.mat, Diary, 120, 2972609586, 3090007390, 117397804
/Volumes/methlab_data/HBN/EEG-ET/NDARFD316UD2/NDARFD316UD2_Video2_Samples_ET.mat, Fractals, 120, 4886305750, 5049303012, 162997262
/Volumes/methlab_data/HBN/EEG-ET/NDARFD316UD2/NDARFD316UD2_Video3_Samples_ET.mat, Despicable, 120, 5350314042, 5520859938, 170545896
/Volumes/methlab_data/HBN/EEG-ET/NDARFD316UD2/NDARFD316UD2_Video4_Samples_ET.mat, Present, 120, 6039998090, 6243065600, 203067510
/Volumes/methlab_data/HBN/EEG-ET/NDARFD620BUW/NDARFD620BUW_Video-DM_Samples_ET.mat, Despicable, 30, 4645239487, 4815778890, 170539403
/Volumes/methlab_data/HBN/EEG-ET/NDARFD620BUW/NDARFD620BUW_Video-TP_Samples_ET.mat, Present, 30, 5206338584, 5409603104, 203264520
/Volumes/methlab_data/HBN/EEG-ET/NDARFD620BUW/NDARFD620BUW_Video-WK_Samples_ET.mat, Diary, 30, 3504452170, 3621843066, 117390896
/Volumes/methlab_data/HBN/EEG-ET/NDARFE163HVN/NDARFE163HVN_Video1_Samples_ET.mat, Diary, 60, 3318179743, 3435569660, 117389917
/Volumes/methlab_data/HBN/EEG-ET/NDARFE163HVN/NDARFE163HVN_Video3_Samples_ET.mat, Despicable, 60, 2864031985, 3034576462, 170544477
/Volumes/methlab_data/HBN/EEG-ET/NDARFE299MWU/NDARFE299MWU_Video1_Samples_ET.mat, Diary, 60, 3871767567, 3989161804, 117394237
/Volumes/methlab_data/HBN/EEG-ET/NDARFE299MWU/NDARFE299MWU_Video2_Samples_ET.mat, Fractals, 60, 4740097962, 4903092488, 162994526
/Volumes/methlab_data/HBN/EEG-ET/NDARFE299MWU/NDARFE299MWU_Video3_Samples_ET.mat, Despicable, 60, 5205522827, 5376065698, 170542871
/Volumes/methlab_data/HBN/EEG-ET/NDARFE299MWU/NDARFE299MWU_Video4_Samples_ET.mat, Present, 60, 5675630958, 5878701892, 203070934
/Volumes/methlab_data/HBN/EEG-ET/NDARFE372VHL/NDARFE372VHL_Video1_Samples_ET.mat, Diary, 120, 3616391370, 3733780032, 117388662
/Volumes/methlab_data/HBN/EEG-ET/NDARFE372VHL/NDARFE372VHL_Video2_Samples_ET.mat, Despicable, 120, 4186784383, 4357331547, 170547164
/Volumes/methlab_data/HBN/EEG-ET/NDARFE372VHL/NDARFE372VHL_Video3_Samples_ET.mat, Fractals, 120, 4662050286, 4825047561, 162997275
/Volumes/methlab_data/HBN/EEG-ET/NDARFE372VHL/NDARFE372VHL_Video4_Samples_ET.mat, Present, 120, 5285447046, 5488512442, 203065396
/Volumes/methlab_data/HBN/EEG-ET/NDARFE526NK3/NDARFE526NK3_Video1_Samples_ET.mat, Diary, 60, 3161696931, 3279089707, 117392776
/Volumes/methlab_data/HBN/EEG-ET/NDARFE526NK3/NDARFE526NK3_Video2_Samples_ET.mat, Fractals, 60, 4131121556, 4294113519, 162991963
/Volumes/methlab_data/HBN/EEG-ET/NDARFE526NK3/NDARFE526NK3_Video3_Samples_ET.mat, Despicable, 60, 3695755522, 3866299827, 170544305
/Volumes/methlab_data/HBN/EEG-ET/NDARFE526NK3/NDARFE526NK3_Video4_Samples_ET.mat, Present, 60, 4602037682, 4805094883, 203057201
/Volumes/methlab_data/HBN/EEG-ET/NDARFE555KXB/NDARFE555KXB_Video-DM_Samples_ET.mat, Despicable, 60, 3796840201, 3967379963, 170539762
/Volumes/methlab_data/HBN/EEG-ET/NDARFE555KXB/NDARFE555KXB_Video-FF_Samples_ET.mat, Fractals, 60, 3068013213, 3231002631, 162989418
/Volumes/methlab_data/HBN/EEG-ET/NDARFE555KXB/NDARFE555KXB_Video-TP_Samples_ET.mat, Present, 60, 4711966097, 4915035879, 203069782
/Volumes/methlab_data/HBN/EEG-ET/NDARFE555KXB/NDARFE555KXB_Video-WK_Samples_ET.mat, Diary, 60, 4254432159, 4371822320, 117390161
/Volumes/methlab_data/HBN/EEG-ET/NDARFF070XHV/NDARFF070XHV_Video1_Samples_ET.mat, Diary, 120, 3884105071, 4001501358, 117396287
/Volumes/methlab_data/HBN/EEG-ET/NDARFF070XHV/NDARFF070XHV_Video2_Samples_ET.mat, Fractals, 120, 5637823261, 5800811029, 162987768
/Volumes/methlab_data/HBN/EEG-ET/NDARFF070XHV/NDARFF070XHV_Video3_Samples_ET.mat, Despicable, 120, 6073541771, 6244089738, 170547967
/Volumes/methlab_data/HBN/EEG-ET/NDARFF070XHV/NDARFF070XHV_Video4_Samples_ET.mat, Present, 120, 6808067114, 7011134039, 203066925
/Volumes/methlab_data/HBN/EEG-ET/NDARFF644ZGD/NDARFF644ZGD_Video1_Samples_ET.mat, Diary, 60, 3300388460, 3417780382, 117391922
/Volumes/methlab_data/HBN/EEG-ET/NDARFF644ZGD/NDARFF644ZGD_Video3_Samples_ET.mat, Despicable, 60, 4451005148, 4621548616, 170543468
/Volumes/methlab_data/HBN/EEG-ET/NDARFG114VB1/NDARFG114VB1_Video1_Samples_ET.mat, Diary, 120, 7170926967, 7288315164, 117388197
/Volumes/methlab_data/HBN/EEG-ET/NDARFG114VB1/NDARFG114VB1_Video2_Samples_ET.mat, Despicable, 120, 8256491062, 8427047938, 170556876
/Volumes/methlab_data/HBN/EEG-ET/NDARFG114VB1/NDARFG114VB1_Video3_Samples_ET.mat, Fractals, 120, 8843706319, 9006693691, 162987372
/Volumes/methlab_data/HBN/EEG-ET/NDARFG364YMG/NDARFG364YMG_Video-DM_Samples_ET.mat, Despicable, 120, 3538442685, 3708989125, 170546440
/Volumes/methlab_data/HBN/EEG-ET/NDARFG364YMG/NDARFG364YMG_Video-FF_Samples_ET.mat, Fractals, 120, 3120804760, 3283791824, 162987064
/Volumes/methlab_data/HBN/EEG-ET/NDARFG364YMG/NDARFG364YMG_Video-TP_Samples_ET.mat, Present, 120, 4195518907, 4398584641, 203065734
/Volumes/methlab_data/HBN/EEG-ET/NDARFG364YMG/NDARFG364YMG_Video-WK_Samples_ET.mat, Diary, 120, 4039558329, 4156956356, 117398027
/Volumes/methlab_data/HBN/EEG-ET/NDARFG568PXZ/NDARFG568PXZ_Video-DM_Samples_ET.mat, Despicable, 60, 4464380574, 4634925177, 170544603
/Volumes/methlab_data/HBN/EEG-ET/NDARFG568PXZ/NDARFG568PXZ_Video-FF_Samples_ET.mat, Fractals, 60, 3269154541, 3432136801, 162982260
/Volumes/methlab_data/HBN/EEG-ET/NDARFG568PXZ/NDARFG568PXZ_Video-TP_Samples_ET.mat, Present, 60, 5029445070, 5232512669, 203067599
/Volumes/methlab_data/HBN/EEG-ET/NDARFG568PXZ/NDARFG568PXZ_Video-WK_Samples_ET.mat, Diary, 60, 3958428867, 4075822889, 117394022
/Volumes/methlab_data/HBN/EEG-ET/NDARFG713PLR/NDARFG713PLR_Video1_Samples_ET.mat, Diary, 120, 3983687568, 4101083662, 117396094
/Volumes/methlab_data/HBN/EEG-ET/NDARFG713PLR/NDARFG713PLR_Video2_Samples_ET.mat, Fractals, 120, 5762376689, 5925364042, 162987353
/Volumes/methlab_data/HBN/EEG-ET/NDARFG713PLR/NDARFG713PLR_Video3_Samples_ET.mat, Despicable, 120, 6239185512, 6409731993, 170546481
/Volumes/methlab_data/HBN/EEG-ET/NDARFG713PLR/NDARFG713PLR_Video4_Samples_ET.mat, Present, 120, 6843740138, 7046802054, 203061916
/Volumes/methlab_data/HBN/EEG-ET/NDARFG757CEU/NDARFG757CEU_Video1_Samples_ET.mat, Diary, 120, 3370804456, 3488193082, 117388626
/Volumes/methlab_data/HBN/EEG-ET/NDARFG757CEU/NDARFG757CEU_Video2_Samples_ET.mat, Fractals, 120, 4617326620, 4780314811, 162988191
/Volumes/methlab_data/HBN/EEG-ET/NDARFG757CEU/NDARFG757CEU_Video3_Samples_ET.mat, Despicable, 120, 4823125234, 4993672733, 170547499
/Volumes/methlab_data/HBN/EEG-ET/NDARFG757CEU/NDARFG757CEU_Video4_Samples_ET.mat, Present, 120, 5037143748, 5240211094, 203067346
/Volumes/methlab_data/HBN/EEG-ET/NDARFG851ZNZ/NDARFG851ZNZ_Video1_Samples_ET.mat, Fractals, 120, 5703738878, 5866724605, 162985727
/Volumes/methlab_data/HBN/EEG-ET/NDARFG851ZNZ/NDARFG851ZNZ_Video2_Samples_ET.mat, Despicable, 120, 6587963034, 6758505385, 170542351
/Volumes/methlab_data/HBN/EEG-ET/NDARFG851ZNZ/NDARFG851ZNZ_Video3_Samples_ET.mat, Diary, 120, 7060785800, 7178173701, 117387901
/Volumes/methlab_data/HBN/EEG-ET/NDARFG851ZNZ/NDARFG851ZNZ_Video4_Samples_ET.mat, Present, 120, 7571236329, 7774303648, 203067319
/Volumes/methlab_data/HBN/EEG-ET/NDARFG943GVZ/NDARFG943GVZ_Video1_Samples_ET.mat, Diary, 120, 3746889083, 3864285537, 117396454
/Volumes/methlab_data/HBN/EEG-ET/NDARFG943GVZ/NDARFG943GVZ_Video2_Samples_ET.mat, Fractals, 120, 5091819903, 5254806626, 162986723
/Volumes/methlab_data/HBN/EEG-ET/NDARFG943GVZ/NDARFG943GVZ_Video3_Samples_ET.mat, Despicable, 120, 5696755584, 5867303143, 170547559
/Volumes/methlab_data/HBN/EEG-ET/NDARFG943GVZ/NDARFG943GVZ_Video4_Samples_ET.mat, Present, 120, 6394691312, 6597758960, 203067648
/Volumes/methlab_data/HBN/EEG-ET/NDARFH018DLG/NDARFH018DLG_Video1_Samples_ET.mat, Diary, 60, 4412237955, 4529624810, 117386855
/Volumes/methlab_data/HBN/EEG-ET/NDARFH018DLG/NDARFH018DLG_Video2_Samples_ET.mat, Fractals, 60, 3225899900, 3388887938, 162988038
/Volumes/methlab_data/HBN/EEG-ET/NDARFH018DLG/NDARFH018DLG_Video3_Samples_ET.mat, Despicable, 60, 3917872144, 4088411484, 170539340
/Volumes/methlab_data/HBN/EEG-ET/NDARFH018DLG/NDARFH018DLG_Video4_Samples_ET.mat, Present, 60, 4845300508, 5048368819, 203068311
/Volumes/methlab_data/HBN/EEG-ET/NDARFH674DWX/NDARFH674DWX_Video1_Samples_ET.mat, Diary, 60, 2122236261, 2239629222, 117392961
/Volumes/methlab_data/HBN/EEG-ET/NDARFH674DWX/NDARFH674DWX_Video3_Samples_ET.mat, Despicable, 60, 1910573793, 2081116265, 170542472
/Volumes/methlab_data/HBN/EEG-ET/NDARFJ000DCY/NDARFJ000DCY_Video-DM_Samples_ET.mat, Despicable, 120, 2469849604, 2640397102, 170547498
/Volumes/methlab_data/HBN/EEG-ET/NDARFJ000DCY/NDARFJ000DCY_Video-FF_Samples_ET.mat, Fractals, 120, 2686817552, 2849805177, 162987625
/Volumes/methlab_data/HBN/EEG-ET/NDARFJ000DCY/NDARFJ000DCY_Video-TP_Samples_ET.mat, Present, 120, 3124193238, 3327255705, 203062467
/Volumes/methlab_data/HBN/EEG-ET/NDARFJ000DCY/NDARFJ000DCY_Video-WK_Samples_ET.mat, Diary, 120, 2963676498, 3081073923, 117397425
/Volumes/methlab_data/HBN/EEG-ET/NDARFJ100BDZ/NDARFJ100BDZ_Video1_Samples_ET.mat, Diary, 60, 4870585924, 4987983032, 117397108
/Volumes/methlab_data/HBN/EEG-ET/NDARFJ100BDZ/NDARFJ100BDZ_Video3_Samples_ET.mat, Despicable, 60, 3928359186, 4098900879, 170541693
/Volumes/methlab_data/HBN/EEG-ET/NDARFJ179MG0/NDARFJ179MG0_Video1_Samples_ET.mat, Diary, 120, 3723556002, 3840953055, 117397053
/Volumes/methlab_data/HBN/EEG-ET/NDARFJ179MG0/NDARFJ179MG0_Video2_Samples_ET.mat, Fractals, 120, 4508850564, 4671836768, 162986204
/Volumes/methlab_data/HBN/EEG-ET/NDARFJ179MG0/NDARFJ179MG0_Video3_Samples_ET.mat, Despicable, 120, 5050177598, 5220725701, 170548103
/Volumes/methlab_data/HBN/EEG-ET/NDARFJ179MG0/NDARFJ179MG0_Video4_Samples_ET.mat, Present, 120, 5759599980, 5962666966, 203066986
/Volumes/methlab_data/HBN/EEG-ET/NDARFJ302HVD/NDARFJ302HVD_Video1_Samples_ET.mat, Diary, 60, 4378647025, 4496043924, 117396899
/Volumes/methlab_data/HBN/EEG-ET/NDARFJ302HVD/NDARFJ302HVD_Video3_Samples_ET.mat, Despicable, 60, 4136305842, 4306849316, 170543474
/Volumes/methlab_data/HBN/EEG-ET/NDARFJ372JDJ/NDARFJ372JDJ_Video-DM_Samples_ET.mat, Despicable, 60, 4145498773, 4316050220, 170551447
/Volumes/methlab_data/HBN/EEG-ET/NDARFJ372JDJ/NDARFJ372JDJ_Video-FF_Samples_ET.mat, Fractals, 60, 3922840468, 4085831624, 162991156
/Volumes/methlab_data/HBN/EEG-ET/NDARFJ372JDJ/NDARFJ372JDJ_Video-TP_Samples_ET.mat, Present, 60, 4375570262, 4578639677, 203069415
/Volumes/methlab_data/HBN/EEG-ET/NDARFJ372JDJ/NDARFJ372JDJ_Video-WK_Samples_ET.mat, Diary, 60, 3478314506, 3595706461, 117391955
/Volumes/methlab_data/HBN/EEG-ET/NDARFJ488VPT/NDARFJ488VPT_Video-DM_Samples_ET.mat, Despicable, 30, 4072250688, 4242786277, 170535589
/Volumes/methlab_data/HBN/EEG-ET/NDARFJ488VPT/NDARFJ488VPT_Video-TP_Samples_ET.mat, Present, 30, 4597215848, 4800493581, 203277733
/Volumes/methlab_data/HBN/EEG-ET/NDARFJ488VPT/NDARFJ488VPT_Video-WK_Samples_ET.mat, Diary, 30, 2783733714, 2901121716, 117388002
/Volumes/methlab_data/HBN/EEG-ET/NDARFJ651RMJ/NDARFJ651RMJ_Video-DM_Samples_ET.mat, Despicable, 60, 5049510322, 5220054859, 170544537
/Volumes/methlab_data/HBN/EEG-ET/NDARFJ651RMJ/NDARFJ651RMJ_Video-FF_Samples_ET.mat, Fractals, 60, 3998819860, 4161814046, 162994186
/Volumes/methlab_data/HBN/EEG-ET/NDARFJ651RMJ/NDARFJ651RMJ_Video-TP_Samples_ET.mat, Present, 60, 5500316886, 5703385389, 203068503
/Volumes/methlab_data/HBN/EEG-ET/NDARFJ651RMJ/NDARFJ651RMJ_Video-WK_Samples_ET.mat, Diary, 60, 5332653396, 5450046385, 117392989
/Volumes/methlab_data/HBN/EEG-ET/NDARFJ803JF7/NDARFJ803JF7_Video1_Samples_ET.mat, Diary, 120, 7054206256, 7171595236, 117388980
/Volumes/methlab_data/HBN/EEG-ET/NDARFJ803JF7/NDARFJ803JF7_Video2_Samples_ET.mat, Fractals, 120, 8397348505, 8560335756, 162987251
/Volumes/methlab_data/HBN/EEG-ET/NDARFJ803JF7/NDARFJ803JF7_Video3_Samples_ET.mat, Despicable, 120, 8867596012, 9038144315, 170548303
/Volumes/methlab_data/HBN/EEG-ET/NDARFJ803JF7/NDARFJ803JF7_Video4_Samples_ET.mat, Present, 120, 9749331363, 9952399043, 203067680
/Volumes/methlab_data/HBN/EEG-ET/NDARFJ988HKR/NDARFJ988HKR_Video-DM_Samples_ET.mat, Despicable, 60, 5505878339, 5676416973, 170538634
/Volumes/methlab_data/HBN/EEG-ET/NDARFJ988HKR/NDARFJ988HKR_Video-TP_Samples_ET.mat, Present, 60, 6017243880, 6220522611, 203278731
/Volumes/methlab_data/HBN/EEG-ET/NDARFJ988HKR/NDARFJ988HKR_Video-WK_Samples_ET.mat, Diary, 60, 3841623739, 3959016723, 117392984
/Volumes/methlab_data/HBN/EEG-ET/NDARFK027LB0/NDARFK027LB0_Video1_Samples_ET.mat, Diary, 60, 3845955670, 3963354501, 117398831
/Volumes/methlab_data/HBN/EEG-ET/NDARFK027LB0/NDARFK027LB0_Video3_Samples_ET.mat, Despicable, 60, 3337212930, 3507758219, 170545289
/Volumes/methlab_data/HBN/EEG-ET/NDARFK027LB0/NDARFK027LB0_Video4_Samples_ET.mat, Present, 60, 4275730765, 4478791985, 203061220
/Volumes/methlab_data/HBN/EEG-ET/NDARFK477WX9/NDARFK477WX9_Video1_Samples_ET.mat, Diary, 60, 5929543916, 6046935743, 117391827
/Volumes/methlab_data/HBN/EEG-ET/NDARFK477WX9/NDARFK477WX9_Video3_Samples_ET.mat, Despicable, 60, 5444161439, 5614703821, 170542382
/Volumes/methlab_data/HBN/EEG-ET/NDARFK610GY5/NDARFK610GY5_Video1_Samples_ET.mat, Diary, 60, 4271766535, 4389164178, 117397643
/Volumes/methlab_data/HBN/EEG-ET/NDARFK610GY5/NDARFK610GY5_Video3_Samples_ET.mat, Despicable, 60, 3839022565, 4009564856, 170542291
/Volumes/methlab_data/HBN/EEG-ET/NDARFK819TD5/NDARFK819TD5_Video-DM_Samples_ET.mat, Despicable, 60, 3023043273, 3193584791, 170541518
/Volumes/methlab_data/HBN/EEG-ET/NDARFK819TD5/NDARFK819TD5_Video-FF_Samples_ET.mat, Fractals, 60, 2536762667, 2699742847, 162980180
/Volumes/methlab_data/HBN/EEG-ET/NDARFK819TD5/NDARFK819TD5_Video-TP_Samples_ET.mat, Present, 60, 3725609730, 3928680286, 203070556
/Volumes/methlab_data/HBN/EEG-ET/NDARFK819TD5/NDARFK819TD5_Video-WK_Samples_ET.mat, Diary, 60, 1942163475, 2059560450, 117396975
/Volumes/methlab_data/HBN/EEG-ET/NDARFL579BAP/NDARFL579BAP_Video-DM_Samples_ET.mat, Despicable, 120, 2083080713, 2253626489, 170545776
/Volumes/methlab_data/HBN/EEG-ET/NDARFL579BAP/NDARFL579BAP_Video-FF_Samples_ET.mat, Fractals, 120, 2353558317, 2516547340, 162989023
/Volumes/methlab_data/HBN/EEG-ET/NDARFL579BAP/NDARFL579BAP_Video-TP_Samples_ET.mat, Present, 120, 2854142064, 3057205617, 203063553
/Volumes/methlab_data/HBN/EEG-ET/NDARFL579BAP/NDARFL579BAP_Video-WK_Samples_ET.mat, Diary, 120, 2611786304, 2729183641, 117397337
/Volumes/methlab_data/HBN/EEG-ET/NDARFL793LDE/NDARFL793LDE_Video1_Samples_ET.mat, Diary, 60, 3597020158, 3714415181, 117395023
/Volumes/methlab_data/HBN/EEG-ET/NDARFL793LDE/NDARFL793LDE_Video2_Samples_ET.mat, Fractals, 60, 5135787098, 5298771321, 162984223
/Volumes/methlab_data/HBN/EEG-ET/NDARFL793LDE/NDARFL793LDE_Video3_Samples_ET.mat, Despicable, 60, 4697081916, 4867627510, 170545594
/Volumes/methlab_data/HBN/EEG-ET/NDARFL793LDE/NDARFL793LDE_Video4_Samples_ET.mat, Present, 60, 5663229975, 5866303570, 203073595
/Volumes/methlab_data/HBN/EEG-ET/NDARFM080VAF/NDARFM080VAF_Video1_Samples_ET.mat, Diary, 60, 3028837574, 3146227705, 117390131
/Volumes/methlab_data/HBN/EEG-ET/NDARFM080VAF/NDARFM080VAF_Video3_Samples_ET.mat, Despicable, 60, 4520130376, 4690672190, 170541814
/Volumes/methlab_data/HBN/EEG-ET/NDARFM211KDJ/NDARFM211KDJ_Video1_Samples_ET.mat, Fractals, 120, 4394706848, 4557695928, 162989080
/Volumes/methlab_data/HBN/EEG-ET/NDARFM211KDJ/NDARFM211KDJ_Video2_Samples_ET.mat, Despicable, 120, 5362089240, 5532633391, 170544151
/Volumes/methlab_data/HBN/EEG-ET/NDARFM211KDJ/NDARFM211KDJ_Video3_Samples_ET.mat, Diary, 120, 6129649494, 6247040414, 117390920
/Volumes/methlab_data/HBN/EEG-ET/NDARFM229HHA/NDARFM229HHA_Video1_Samples_ET.mat, Diary, 120, 3495262822, 3612650446, 117387624
/Volumes/methlab_data/HBN/EEG-ET/NDARFM229HHA/NDARFM229HHA_Video2_Samples_ET.mat, Despicable, 120, 4983303987, 5153850815, 170546828
/Volumes/methlab_data/HBN/EEG-ET/NDARFM619GTV/NDARFM619GTV_Video1_Samples_ET.mat, Diary, 120, 2792633617, 2910029939, 117396322
/Volumes/methlab_data/HBN/EEG-ET/NDARFM619GTV/NDARFM619GTV_Video2_Samples_ET.mat, Fractals, 120, 3596602780, 3759588380, 162985600
/Volumes/methlab_data/HBN/EEG-ET/NDARFM619GTV/NDARFM619GTV_Video3_Samples_ET.mat, Despicable, 120, 4131163545, 4301710763, 170547218
/Volumes/methlab_data/HBN/EEG-ET/NDARFM619GTV/NDARFM619GTV_Video4_Samples_ET.mat, Present, 120, 4796531113, 4999598034, 203066921
/Volumes/methlab_data/HBN/EEG-ET/NDARFM645RH5/NDARFM645RH5_Video-DM_Samples_ET.mat, Despicable, 60, 3060967422, 3231508990, 170541568
/Volumes/methlab_data/HBN/EEG-ET/NDARFM800UL1/NDARFM800UL1_Video-DM_Samples_ET.mat, Despicable, 60, 7168898372, 7339436779, 170538407
/Volumes/methlab_data/HBN/EEG-ET/NDARFM800UL1/NDARFM800UL1_Video-FF_Samples_ET.mat, Fractals, 60, 6338404108, 6501393178, 162989070
/Volumes/methlab_data/HBN/EEG-ET/NDARFM800UL1/NDARFM800UL1_Video-TP_Samples_ET.mat, Present, 60, 8125698806, 8328769205, 203070399
/Volumes/methlab_data/HBN/EEG-ET/NDARFM800UL1/NDARFM800UL1_Video-WK_Samples_ET.mat, Diary, 60, 7656594650, 7773990543, 117395893
/Volumes/methlab_data/HBN/EEG-ET/NDARFM870UHU/NDARFM870UHU_Video-DM_Samples_ET.mat, Despicable, 30, 2655573391, 2826109838, 170536447
/Volumes/methlab_data/HBN/EEG-ET/NDARFM870UHU/NDARFM870UHU_Video-WK_Samples_ET.mat, Diary, 30, 3248337022, 3365736962, 117399940
/Volumes/methlab_data/HBN/EEG-ET/NDARFN452VPC/NDARFN452VPC_Video1_Samples_ET.mat, Diary, 60, 2530163651, 2647554540, 117390889
/Volumes/methlab_data/HBN/EEG-ET/NDARFN452VPC/NDARFN452VPC_Video3_Samples_ET.mat, Despicable, 60, 3315600126, 3486145523, 170545397
/Volumes/methlab_data/HBN/EEG-ET/NDARFN553LUV/NDARFN553LUV_Video1_Samples_ET.mat, Diary, 60, 3954771592, 4072168944, 117397352
/Volumes/methlab_data/HBN/EEG-ET/NDARFN553LUV/NDARFN553LUV_Video3_Samples_ET.mat, Despicable, 60, 5134050495, 5304593664, 170543169
/Volumes/methlab_data/HBN/EEG-ET/NDARFN553LUV/NDARFN553LUV_Video4_Samples_ET.mat, Present, 60, 5699351680, 5902414816, 203063136
/Volumes/methlab_data/HBN/EEG-ET/NDARFN636ZYB/NDARFN636ZYB_Video-DM_Samples_ET.mat, Despicable, 30, 3328199056, 3498736588, 170537532
/Volumes/methlab_data/HBN/EEG-ET/NDARFN636ZYB/NDARFN636ZYB_Video-TP_Samples_ET.mat, Present, 30, 4362167714, 4565450404, 203282690
/Volumes/methlab_data/HBN/EEG-ET/NDARFN636ZYB/NDARFN636ZYB_Video-WK_Samples_ET.mat, Diary, 30, 2716176580, 2833564550, 117387970
/Volumes/methlab_data/HBN/EEG-ET/NDARFN854EJB/NDARFN854EJB_Video-DM_Samples_ET.mat, Despicable, 60, 4740938030, 4911476476, 170538446
/Volumes/methlab_data/HBN/EEG-ET/NDARFN854EJB/NDARFN854EJB_Video-TP_Samples_ET.mat, Present, 60, 5622737807, 5826016411, 203278604
/Volumes/methlab_data/HBN/EEG-ET/NDARFN854EJB/NDARFN854EJB_Video-WK_Samples_ET.mat, Diary, 60, 5172103527, 5289490453, 117386926
/Volumes/methlab_data/HBN/EEG-ET/NDARFP148YDU/NDARFP148YDU_Video-DM_Samples_ET.mat, Despicable, 120, 4863624731, 5034168122, 170543391
/Volumes/methlab_data/HBN/EEG-ET/NDARFP148YDU/NDARFP148YDU_Video-FF_Samples_ET.mat, Fractals, 120, 4588992630, 4751980005, 162987375
/Volumes/methlab_data/HBN/EEG-ET/NDARFP148YDU/NDARFP148YDU_Video-TP_Samples_ET.mat, Present, 120, 5469478301, 5672545025, 203066724
/Volumes/methlab_data/HBN/EEG-ET/NDARFP148YDU/NDARFP148YDU_Video-WK_Samples_ET.mat, Diary, 120, 3746851781, 3864237969, 117386188
/Volumes/methlab_data/HBN/EEG-ET/NDARFP243NWY/NDARFP243NWY_Video-DM_Samples_ET.mat, Despicable, 60, 4503140081, 4673691521, 170551440
/Volumes/methlab_data/HBN/EEG-ET/NDARFP243NWY/NDARFP243NWY_Video-FF_Samples_ET.mat, Fractals, 60, 5017381130, 5180371192, 162990062
/Volumes/methlab_data/HBN/EEG-ET/NDARFP243NWY/NDARFP243NWY_Video-TP_Samples_ET.mat, Present, 60, 5591520414, 5794590798, 203070384
/Volumes/methlab_data/HBN/EEG-ET/NDARFP243NWY/NDARFP243NWY_Video-WK_Samples_ET.mat, Diary, 60, 3264123437, 3381518315, 117394878
/Volumes/methlab_data/HBN/EEG-ET/NDARFP503KJF/NDARFP503KJF_Video-DM_Samples_ET.mat, Despicable, 60, 3147657080, 3318210583, 170553503
/Volumes/methlab_data/HBN/EEG-ET/NDARFP503KJF/NDARFP503KJF_Video-FF_Samples_ET.mat, Fractals, 60, 2712216527, 2875205675, 162989148
/Volumes/methlab_data/HBN/EEG-ET/NDARFP503KJF/NDARFP503KJF_Video-TP_Samples_ET.mat, Present, 60, 3641321734, 3844392204, 203070470
/Volumes/methlab_data/HBN/EEG-ET/NDARFP503KJF/NDARFP503KJF_Video-WK_Samples_ET.mat, Diary, 60, 2310783008, 2428173953, 117390945
/Volumes/methlab_data/HBN/EEG-ET/NDARFP512MEK/NDARFP512MEK_Video1_Samples_ET.mat, Diary, 60, 1804522021, 1921916120, 117394099
/Volumes/methlab_data/HBN/EEG-ET/NDARFP512MEK/NDARFP512MEK_Video2_Samples_ET.mat, Fractals, 60, 2538437377, 2701430718, 162993341
/Volumes/methlab_data/HBN/EEG-ET/NDARFP512MEK/NDARFP512MEK_Video3_Samples_ET.mat, Despicable, 60, 2959803563, 3130345271, 170541708
/Volumes/methlab_data/HBN/EEG-ET/NDARFP512MEK/NDARFP512MEK_Video4_Samples_ET.mat, Present, 60, 3460717998, 3663849758, 203131760
/Volumes/methlab_data/HBN/EEG-ET/NDARFP813TL5/NDARFP813TL5_Video-DM_Samples_ET.mat, Despicable, 60, 6193217994, 6363753594, 170535600
/Volumes/methlab_data/HBN/EEG-ET/NDARFP813TL5/NDARFP813TL5_Video-TP_Samples_ET.mat, Present, 60, 6831732415, 7035012165, 203279750
/Volumes/methlab_data/HBN/EEG-ET/NDARFP813TL5/NDARFP813TL5_Video-WK_Samples_ET.mat, Diary, 60, 4534184070, 4651582081, 117398011
/Volumes/methlab_data/HBN/EEG-ET/NDARFP841PDJ/NDARFP841PDJ_Video-DM_Samples_ET.mat, Despicable, 30, 3944546211, 4115079835, 170533624
/Volumes/methlab_data/HBN/EEG-ET/NDARFP841PDJ/NDARFP841PDJ_Video-TP_Samples_ET.mat, Present, 30, 4832165988, 5035442777, 203276789
/Volumes/methlab_data/HBN/EEG-ET/NDARFP841PDJ/NDARFP841PDJ_Video-WK_Samples_ET.mat, Diary, 30, 4393138467, 4510525521, 117387054
/Volumes/methlab_data/HBN/EEG-ET/NDARFP909LY1/NDARFP909LY1_Video1_Samples_ET.mat, Fractals, 120, 4379199673, 4542195349, 162995676
/Volumes/methlab_data/HBN/EEG-ET/NDARFP909LY1/NDARFP909LY1_Video2_Samples_ET.mat, Despicable, 120, 5983439079, 6153985885, 170546806
/Volumes/methlab_data/HBN/EEG-ET/NDARFP909LY1/NDARFP909LY1_Video3_Samples_ET.mat, Diary, 120, 6647364682, 6764764985, 117400303
/Volumes/methlab_data/HBN/EEG-ET/NDARFP909LY1/NDARFP909LY1_Video4_Samples_ET.mat, Present, 120, 7296891613, 7499958927, 203067314
/Volumes/methlab_data/HBN/EEG-ET/NDARFR095UJK/NDARFR095UJK_Video1_Samples_ET.mat, Diary, 60, 7300258251, 7417648484, 117390233
/Volumes/methlab_data/HBN/EEG-ET/NDARFR095UJK/NDARFR095UJK_Video2_Samples_ET.mat, Fractals, 60, 5712039708, 5875024221, 162984513
/Volumes/methlab_data/HBN/EEG-ET/NDARFR095UJK/NDARFR095UJK_Video3_Samples_ET.mat, Despicable, 60, 6546684211, 6717233098, 170548887
/Volumes/methlab_data/HBN/EEG-ET/NDARFR095UJK/NDARFR095UJK_Video4_Samples_ET.mat, Present, 60, 7748452895, 7951516834, 203063939
/Volumes/methlab_data/HBN/EEG-ET/NDARFR103CUN/NDARFR103CUN_Video-DM_Samples_ET.mat, Despicable, 60, 5475733955, 5646276879, 170542924
/Volumes/methlab_data/HBN/EEG-ET/NDARFR103CUN/NDARFR103CUN_Video-FF_Samples_ET.mat, Fractals, 60, 5767675951, 5930660542, 162984591
/Volumes/methlab_data/HBN/EEG-ET/NDARFR103CUN/NDARFR103CUN_Video-TP_Samples_ET.mat, Present, 60, 6149362593, 6352424600, 203062007
/Volumes/methlab_data/HBN/EEG-ET/NDARFR103CUN/NDARFR103CUN_Video-WK_Samples_ET.mat, Diary, 60, 5988490518, 6105881820, 117391302
/Volumes/methlab_data/HBN/EEG-ET/NDARFR108JNB/NDARFR108JNB_Video1_Samples_ET.mat, Diary, 120, 4093954352, 4211342766, 117388414
/Volumes/methlab_data/HBN/EEG-ET/NDARFR108JNB/NDARFR108JNB_Video2_Samples_ET.mat, Despicable, 120, 5957544094, 6128086447, 170542353
/Volumes/methlab_data/HBN/EEG-ET/NDARFR108JNB/NDARFR108JNB_Video3_Samples_ET.mat, Fractals, 120, 6474695988, 6637679674, 162983686
/Volumes/methlab_data/HBN/EEG-ET/NDARFR108JNB/NDARFR108JNB_Video4_Samples_ET.mat, Present, 120, 7149666256, 7352742771, 203076515
/Volumes/methlab_data/HBN/EEG-ET/NDARFR426KVH/NDARFR426KVH_Video-DM_Samples_ET.mat, Despicable, 60, 3693252507, 3863791863, 170539356
/Volumes/methlab_data/HBN/EEG-ET/NDARFR426KVH/NDARFR426KVH_Video-FF_Samples_ET.mat, Fractals, 60, 2837788923, 3000776960, 162988037
/Volumes/methlab_data/HBN/EEG-ET/NDARFR426KVH/NDARFR426KVH_Video-TP_Samples_ET.mat, Present, 60, 4177844432, 4380915737, 203071305
/Volumes/methlab_data/HBN/EEG-ET/NDARFR426KVH/NDARFR426KVH_Video-WK_Samples_ET.mat, Diary, 60, 3274140805, 3391530661, 117389856
/Volumes/methlab_data/HBN/EEG-ET/NDARFR445XKP/NDARFR445XKP_Video-DM_Samples_ET.mat, Despicable, 30, 4435638633, 4606176941, 170538308
/Volumes/methlab_data/HBN/EEG-ET/NDARFR445XKP/NDARFR445XKP_Video-TP_Samples_ET.mat, Present, 30, 5003171870, 5206447260, 203275390
/Volumes/methlab_data/HBN/EEG-ET/NDARFR445XKP/NDARFR445XKP_Video-WK_Samples_ET.mat, Diary, 30, 3152315610, 3269702413, 117386803
/Volumes/methlab_data/HBN/EEG-ET/NDARFR601RDQ/NDARFR601RDQ_Video-DM_Samples_ET.mat, Despicable, 60, 2582789940, 2753328433, 170538493
/Volumes/methlab_data/HBN/EEG-ET/NDARFR601RDQ/NDARFR601RDQ_Video-TP_Samples_ET.mat, Present, 60, 3067917578, 3271194178, 203276600
/Volumes/methlab_data/HBN/EEG-ET/NDARFR601RDQ/NDARFR601RDQ_Video-WK_Samples_ET.mat, Diary, 60, 1368725461, 1486114389, 117388928
/Volumes/methlab_data/HBN/EEG-ET/NDARFR696PLG/NDARFR696PLG_Video-DM_Samples_ET.mat, Despicable, 120, 4601200419, 4771748100, 170547681
/Volumes/methlab_data/HBN/EEG-ET/NDARFR696PLG/NDARFR696PLG_Video-FF_Samples_ET.mat, Fractals, 120, 3973205182, 4136192186, 162987004
/Volumes/methlab_data/HBN/EEG-ET/NDARFR696PLG/NDARFR696PLG_Video-TP_Samples_ET.mat, Present, 120, 5773143355, 5976209782, 203066427
/Volumes/methlab_data/HBN/EEG-ET/NDARFR696PLG/NDARFR696PLG_Video-WK_Samples_ET.mat, Diary, 120, 5113828136, 5231225308, 117397172
/Volumes/methlab_data/HBN/EEG-ET/NDARFR820KFF/NDARFR820KFF_Video1_Samples_ET.mat, Diary, 60, 3875248220, 3992642383, 117394163
/Volumes/methlab_data/HBN/EEG-ET/NDARFR820KFF/NDARFR820KFF_Video3_Samples_ET.mat, Despicable, 60, 4916105501, 5086649308, 170543807
/Volumes/methlab_data/HBN/EEG-ET/NDARFR820KFF/NDARFR820KFF_Video4_Samples_ET.mat, Present, 60, 5402306877, 5605369734, 203062857
/Volumes/methlab_data/HBN/EEG-ET/NDARFR849NTP/NDARFR849NTP_Video1_Samples_ET.mat, Diary, 60, 20832578588, 20949972892, 117394304
/Volumes/methlab_data/HBN/EEG-ET/NDARFR849NTP/NDARFR849NTP_Video3_Samples_ET.mat, Despicable, 60, 20395061239, 20565607223, 170545984
/Volumes/methlab_data/HBN/EEG-ET/NDARFR849NTP/NDARFR849NTP_Video4_Samples_ET.mat, Present, 60, 21252636529, 21455706596, 203070067
/Volumes/methlab_data/HBN/EEG-ET/NDARFR873KZX/NDARFR873KZX_Video-DM_Samples_ET.mat, Despicable, 60, 11232260583, 11402797000, 170536417
/Volumes/methlab_data/HBN/EEG-ET/NDARFR873KZX/NDARFR873KZX_Video-TP_Samples_ET.mat, Present, 60, 11852390357, 12055668880, 203278523
/Volumes/methlab_data/HBN/EEG-ET/NDARFR873KZX/NDARFR873KZX_Video-WK_Samples_ET.mat, Diary, 60, 11666902409, 11784292339, 117389930
/Volumes/methlab_data/HBN/EEG-ET/NDARFT176NJP/NDARFT176NJP_Video-DM_Samples_ET.mat, Despicable, 60, 4095685635, 4266234057, 170548422
/Volumes/methlab_data/HBN/EEG-ET/NDARFT176NJP/NDARFT176NJP_Video-FF_Samples_ET.mat, Fractals, 60, 3540323583, 3703313653, 162990070
/Volumes/methlab_data/HBN/EEG-ET/NDARFT176NJP/NDARFT176NJP_Video-TP_Samples_ET.mat, Present, 60, 4611178522, 4814246891, 203068369
/Volumes/methlab_data/HBN/EEG-ET/NDARFT176NJP/NDARFT176NJP_Video-WK_Samples_ET.mat, Diary, 60, 2981847325, 3099237229, 117389904
/Volumes/methlab_data/HBN/EEG-ET/NDARFT305CG1/NDARFT305CG1_Video1_Samples_ET.mat, Diary, 120, 2818853166, 2936249712, 117396546
/Volumes/methlab_data/HBN/EEG-ET/NDARFT305CG1/NDARFT305CG1_Video2_Samples_ET.mat, Despicable, 120, 3930964664, 4101511846, 170547182
/Volumes/methlab_data/HBN/EEG-ET/NDARFT305CG1/NDARFT305CG1_Video3_Samples_ET.mat, Fractals, 120, 4461761283, 4624748968, 162987685
/Volumes/methlab_data/HBN/EEG-ET/NDARFT305CG1/NDARFT305CG1_Video4_Samples_ET.mat, Present, 120, 5089777358, 5292844872, 203067514
/Volumes/methlab_data/HBN/EEG-ET/NDARFT581ZW5/NDARFT581ZW5_Video1_Samples_ET.mat, Diary, 60, 3097094509, 3214486679, 117392170
/Volumes/methlab_data/HBN/EEG-ET/NDARFT581ZW5/NDARFT581ZW5_Video3_Samples_ET.mat, Despicable, 60, 2527049727, 2697594540, 170544813
/Volumes/methlab_data/HBN/EEG-ET/NDARFT591CKG/NDARFT591CKG_Video-DM_Samples_ET.mat, Despicable, 30, 9810681734, 9981220079, 170538345
/Volumes/methlab_data/HBN/EEG-ET/NDARFT591CKG/NDARFT591CKG_Video-TP_Samples_ET.mat, Present, 30, 10284427001, 10487704445, 203277444
/Volumes/methlab_data/HBN/EEG-ET/NDARFT591CKG/NDARFT591CKG_Video-WK_Samples_ET.mat, Diary, 30, 8862552779, 8979941603, 117388824
/Volumes/methlab_data/HBN/EEG-ET/NDARFT615JZ6/NDARFT615JZ6_Video-DM_Samples_ET.mat, Despicable, 120, 6047304190, 6217851533, 170547343
/Volumes/methlab_data/HBN/EEG-ET/NDARFT615JZ6/NDARFT615JZ6_Video-FF_Samples_ET.mat, Fractals, 120, 4835627382, 4998612265, 162984883
/Volumes/methlab_data/HBN/EEG-ET/NDARFT615JZ6/NDARFT615JZ6_Video-TP_Samples_ET.mat, Present, 120, 6742369000, 6945436831, 203067831
/Volumes/methlab_data/HBN/EEG-ET/NDARFT615JZ6/NDARFT615JZ6_Video-WK_Samples_ET.mat, Diary, 120, 5631536544, 5748934617, 117398073
/Volumes/methlab_data/HBN/EEG-ET/NDARFT698LLU/NDARFT698LLU_Video-DM_Samples_ET.mat, Despicable, 30, 5945319886, 6115856480, 170536594
/Volumes/methlab_data/HBN/EEG-ET/NDARFT698LLU/NDARFT698LLU_Video-TP_Samples_ET.mat, Present, 30, 6452974830, 6656239522, 203264692
/Volumes/methlab_data/HBN/EEG-ET/NDARFT698LLU/NDARFT698LLU_Video-WK_Samples_ET.mat, Diary, 30, 4863800250, 4981191259, 117391009
/Volumes/methlab_data/HBN/EEG-ET/NDARFT787HJW/NDARFT787HJW_Video-DM_Samples_ET.mat, Despicable, 120, 5683996514, 5854543170, 170546656
/Volumes/methlab_data/HBN/EEG-ET/NDARFT787HJW/NDARFT787HJW_Video-FF_Samples_ET.mat, Fractals, 120, 5155846885, 5318833507, 162986622
/Volumes/methlab_data/HBN/EEG-ET/NDARFT787HJW/NDARFT787HJW_Video-TP_Samples_ET.mat, Present, 120, 6417132192, 6620208573, 203076381
/Volumes/methlab_data/HBN/EEG-ET/NDARFT787HJW/NDARFT787HJW_Video-WK_Samples_ET.mat, Diary, 120, 4485123993, 4602521025, 117397032
/Volumes/methlab_data/HBN/EEG-ET/NDARFT834NT1/NDARFT834NT1_Video3_Samples_ET.mat, Despicable, 60, 1503955042, 1674499467, 170544425
/Volumes/methlab_data/HBN/EEG-ET/NDARFT964EU8/NDARFT964EU8_Video1_Samples_ET.mat, Diary, 60, 3281878489, 3399269548, 117391059
/Volumes/methlab_data/HBN/EEG-ET/NDARFT964EU8/NDARFT964EU8_Video2_Samples_ET.mat, Fractals, 60, 4035493538, 4198482833, 162989295
/Volumes/methlab_data/HBN/EEG-ET/NDARFT964EU8/NDARFT964EU8_Video3_Samples_ET.mat, Despicable, 60, 4471507872, 4642055534, 170547662
/Volumes/methlab_data/HBN/EEG-ET/NDARFT964EU8/NDARFT964EU8_Video4_Samples_ET.mat, Present, 60, 4977871017, 5180941667, 203070650
/Volumes/methlab_data/HBN/EEG-ET/NDARFU218HYM/NDARFU218HYM_Video-DM_Samples_ET.mat, Despicable, 30, 3278876615, 3449425980, 170549365
/Volumes/methlab_data/HBN/EEG-ET/NDARFU218HYM/NDARFU218HYM_Video-TP_Samples_ET.mat, Present, 30, 3816572996, 4019848439, 203275443
/Volumes/methlab_data/HBN/EEG-ET/NDARFU218HYM/NDARFU218HYM_Video-WK_Samples_ET.mat, Diary, 30, 2173131439, 2290519297, 117387858
/Volumes/methlab_data/HBN/EEG-ET/NDARFU395UBW/NDARFU395UBW_Video1_Samples_ET.mat, Diary, 120, 4821113830, 4938510981, 117397151
/Volumes/methlab_data/HBN/EEG-ET/NDARFU395UBW/NDARFU395UBW_Video2_Samples_ET.mat, Fractals, 120, 5766437356, 5929424448, 162987092
/Volumes/methlab_data/HBN/EEG-ET/NDARFU395UBW/NDARFU395UBW_Video3_Samples_ET.mat, Despicable, 120, 6334304138, 6504851903, 170547765
/Volumes/methlab_data/HBN/EEG-ET/NDARFU395UBW/NDARFU395UBW_Video4_Samples_ET.mat, Present, 120, 7192529420, 7395596586, 203067166
/Volumes/methlab_data/HBN/EEG-ET/NDARFU407YL4/NDARFU407YL4_Video-DM_Samples_ET.mat, Despicable, 120, 5529330334, 5699872069, 170541735
/Volumes/methlab_data/HBN/EEG-ET/NDARFU407YL4/NDARFU407YL4_Video-FF_Samples_ET.mat, Fractals, 120, 4536613380, 4699600495, 162987115
/Volumes/methlab_data/HBN/EEG-ET/NDARFU407YL4/NDARFU407YL4_Video-TP_Samples_ET.mat, Present, 120, 6494292506, 6697359996, 203067490
/Volumes/methlab_data/HBN/EEG-ET/NDARFU407YL4/NDARFU407YL4_Video-WK_Samples_ET.mat, Diary, 120, 3669791321, 3787177782, 117386461
/Volumes/methlab_data/HBN/EEG-ET/NDARFU444HEF/NDARFU444HEF_Video1_Samples_ET.mat, Diary, 60, 7480879238, 7598266033, 117386795
/Volumes/methlab_data/HBN/EEG-ET/NDARFU444HEF/NDARFU444HEF_Video2_Samples_ET.mat, Fractals, 60, 5736517081, 5899508044, 162990963
/Volumes/methlab_data/HBN/EEG-ET/NDARFU444HEF/NDARFU444HEF_Video3_Samples_ET.mat, Despicable, 60, 6736527307, 6907079605, 170552298
/Volumes/methlab_data/HBN/EEG-ET/NDARFU444HEF/NDARFU444HEF_Video4_Samples_ET.mat, Present, 60, 7904596044, 8107667277, 203071233
/Volumes/methlab_data/HBN/EEG-ET/NDARFV058BWM/NDARFV058BWM_Video-DM_Samples_ET.mat, Despicable, 60, 8397142420, 8567685058, 170542638
/Volumes/methlab_data/HBN/EEG-ET/NDARFV058BWM/NDARFV058BWM_Video-FF_Samples_ET.mat, Fractals, 60, 7913170112, 8076158411, 162988299
/Volumes/methlab_data/HBN/EEG-ET/NDARFV058BWM/NDARFV058BWM_Video-TP_Samples_ET.mat, Present, 60, 8921141016, 9124206666, 203065650
/Volumes/methlab_data/HBN/EEG-ET/NDARFV058BWM/NDARFV058BWM_Video-WK_Samples_ET.mat, Diary, 60, 7208357628, 7325749673, 117392045
/Volumes/methlab_data/HBN/EEG-ET/NDARFV061AR5/NDARFV061AR5_Video1_Samples_ET.mat, Diary, 60, 4410265818, 4527660869, 117395051
/Volumes/methlab_data/HBN/EEG-ET/NDARFV061AR5/NDARFV061AR5_Video2_Samples_ET.mat, Fractals, 60, 3276822163, 3439808461, 162986298
/Volumes/methlab_data/HBN/EEG-ET/NDARFV061AR5/NDARFV061AR5_Video3_Samples_ET.mat, Despicable, 60, 3969082768, 4139625438, 170542670
/Volumes/methlab_data/HBN/EEG-ET/NDARFV061AR5/NDARFV061AR5_Video4_Samples_ET.mat, Present, 60, 4841245623, 5044303282, 203057659
/Volumes/methlab_data/HBN/EEG-ET/NDARFV557XAA/NDARFV557XAA_Video1_Samples_ET.mat, Diary, 60, 3069630731, 3187022084, 117391353
/Volumes/methlab_data/HBN/EEG-ET/NDARFV557XAA/NDARFV557XAA_Video3_Samples_ET.mat, Despicable, 60, 2582909310, 2753458747, 170549437
/Volumes/methlab_data/HBN/EEG-ET/NDARFV686LHH/NDARFV686LHH_Video-DM_Samples_ET.mat, Despicable, 60, 5837214720, 6007761493, 170546773
/Volumes/methlab_data/HBN/EEG-ET/NDARFV686LHH/NDARFV686LHH_Video-TP_Samples_ET.mat, Present, 60, 6302880404, 6506157354, 203276950
/Volumes/methlab_data/HBN/EEG-ET/NDARFV686LHH/NDARFV686LHH_Video-WK_Samples_ET.mat, Diary, 60, 4293156565, 4410545699, 117389134
/Volumes/methlab_data/HBN/EEG-ET/NDARFV725DEQ/NDARFV725DEQ_Video-DM_Samples_ET.mat, Despicable, 60, 2943885735, 3114423140, 170537405
/Volumes/methlab_data/HBN/EEG-ET/NDARFV725DEQ/NDARFV725DEQ_Video-TP_Samples_ET.mat, Present, 60, 3395442604, 3598721033, 203278429
/Volumes/methlab_data/HBN/EEG-ET/NDARFV725DEQ/NDARFV725DEQ_Video-WK_Samples_ET.mat, Diary, 60, 3213311934, 3330700827, 117388893
/Volumes/methlab_data/HBN/EEG-ET/NDARFV725LGA/NDARFV725LGA_Video-DM_Samples_ET.mat, Despicable, 60, 5499349168, 5669894518, 170545350
/Volumes/methlab_data/HBN/EEG-ET/NDARFV725LGA/NDARFV725LGA_Video-FF_Samples_ET.mat, Fractals, 60, 4457321941, 4620309964, 162988023
/Volumes/methlab_data/HBN/EEG-ET/NDARFV725LGA/NDARFV725LGA_Video-TP_Samples_ET.mat, Present, 60, 6081130648, 6284200953, 203070305
/Volumes/methlab_data/HBN/EEG-ET/NDARFV725LGA/NDARFV725LGA_Video-WK_Samples_ET.mat, Diary, 60, 5084455423, 5201849286, 117393863
/Volumes/methlab_data/HBN/EEG-ET/NDARFV780ABD/NDARFV780ABD_Video1_Samples_ET.mat, Diary, 120, 2221258677, 2338655363, 117396686
/Volumes/methlab_data/HBN/EEG-ET/NDARFV780ABD/NDARFV780ABD_Video2_Samples_ET.mat, Fractals, 120, 3152872537, 3315860378, 162987841
/Volumes/methlab_data/HBN/EEG-ET/NDARFV780ABD/NDARFV780ABD_Video3_Samples_ET.mat, Despicable, 120, 3701538728, 3872083486, 170544758
/Volumes/methlab_data/HBN/EEG-ET/NDARFV780ABD/NDARFV780ABD_Video4_Samples_ET.mat, Present, 120, 4286526637, 4489593111, 203066474
/Volumes/methlab_data/HBN/EEG-ET/NDARFW038ZNE/NDARFW038ZNE_Video-DM_Samples_ET.mat, Despicable, 60, 6138242179, 6308794048, 170551869
/Volumes/methlab_data/HBN/EEG-ET/NDARFW038ZNE/NDARFW038ZNE_Video-FF_Samples_ET.mat, Fractals, 60, 5679308104, 5842302572, 162994468
/Volumes/methlab_data/HBN/EEG-ET/NDARFW038ZNE/NDARFW038ZNE_Video-TP_Samples_ET.mat, Present, 60, 6650846416, 6853908130, 203061714
/Volumes/methlab_data/HBN/EEG-ET/NDARFW038ZNE/NDARFW038ZNE_Video-WK_Samples_ET.mat, Diary, 60, 5059891353, 5177615743, 117724390
/Volumes/methlab_data/HBN/EEG-ET/NDARFW100ZXX/NDARFW100ZXX_Video-DM_Samples_ET.mat, Despicable, 60, 3294359280, 3464908582, 170549302
/Volumes/methlab_data/HBN/EEG-ET/NDARFW100ZXX/NDARFW100ZXX_Video-TP_Samples_ET.mat, Present, 60, 3796026064, 3999306454, 203280390
/Volumes/methlab_data/HBN/EEG-ET/NDARFW100ZXX/NDARFW100ZXX_Video-WK_Samples_ET.mat, Diary, 60, 2879155474, 2996544290, 117388816
/Volumes/methlab_data/HBN/EEG-ET/NDARFW253GZM/NDARFW253GZM_Video-DM_Samples_ET.mat, Despicable, 120, 2921167651, 3091713167, 170545516
/Volumes/methlab_data/HBN/EEG-ET/NDARFW253GZM/NDARFW253GZM_Video-FF_Samples_ET.mat, Fractals, 120, 2511788267, 2674775641, 162987374
/Volumes/methlab_data/HBN/EEG-ET/NDARFW253GZM/NDARFW253GZM_Video-TP_Samples_ET.mat, Present, 120, 3599702201, 3802769250, 203067049
/Volumes/methlab_data/HBN/EEG-ET/NDARFW253GZM/NDARFW253GZM_Video-WK_Samples_ET.mat, Diary, 120, 2018531693, 2135920142, 117388449
/Volumes/methlab_data/HBN/EEG-ET/NDARFW292PBD/NDARFW292PBD_Video1_Samples_ET.mat, Diary, 60, 3079619698, 3197009804, 117390106
/Volumes/methlab_data/HBN/EEG-ET/NDARFW292PBD/NDARFW292PBD_Video3_Samples_ET.mat, Despicable, 60, 2867806723, 3038359518, 170552795
/Volumes/methlab_data/HBN/EEG-ET/NDARFW444PN1/NDARFW444PN1_Video1_Samples_ET.mat, Diary, 60, 2001383093, 2118779206, 117396113
/Volumes/methlab_data/HBN/EEG-ET/NDARFW444PN1/NDARFW444PN1_Video3_Samples_ET.mat, Despicable, 60, 3465957468, 3627988211, 162030743
/Volumes/methlab_data/HBN/EEG-ET/NDARFW506ZZ0/NDARFW506ZZ0_Video-DM_Samples_ET.mat, Despicable, 60, 5409941536, 5580489239, 170547703
/Volumes/methlab_data/HBN/EEG-ET/NDARFW506ZZ0/NDARFW506ZZ0_Video-TP_Samples_ET.mat, Present, 60, 5888409108, 6091684968, 203275860
/Volumes/methlab_data/HBN/EEG-ET/NDARFW506ZZ0/NDARFW506ZZ0_Video-WK_Samples_ET.mat, Diary, 60, 4136974743, 4254375853, 117401110
/Volumes/methlab_data/HBN/EEG-ET/NDARFW578RU9/NDARFW578RU9_Video1_Samples_ET.mat, Diary, 60, 3427424653, 3544821582, 117396929
/Volumes/methlab_data/HBN/EEG-ET/NDARFW578RU9/NDARFW578RU9_Video3_Samples_ET.mat, Despicable, 60, 2999620502, 3170162983, 170542481
/Volumes/methlab_data/HBN/EEG-ET/NDARFW578RU9/NDARFW578RU9_Video4_Samples_ET.mat, Present, 60, 3848782241, 4051844676, 203062435
/Volumes/methlab_data/HBN/EEG-ET/NDARFW669WJ9/NDARFW669WJ9_Video-DM_Samples_ET.mat, Despicable, 60, 4478142999, 4648680357, 170537358
/Volumes/methlab_data/HBN/EEG-ET/NDARFW669WJ9/NDARFW669WJ9_Video-TP_Samples_ET.mat, Present, 60, 5091536827, 5294815233, 203278406
/Volumes/methlab_data/HBN/EEG-ET/NDARFW669WJ9/NDARFW669WJ9_Video-WK_Samples_ET.mat, Diary, 60, 3040119367, 3157510228, 117390861
/Volumes/methlab_data/HBN/EEG-ET/NDARFW972KFQ/NDARFW972KFQ_Video1_Samples_ET.mat, Diary, 60, 1393411590, 1510805489, 117393899
/Volumes/methlab_data/HBN/EEG-ET/NDARFW972KFQ/NDARFW972KFQ_Video3_Samples_ET.mat, Despicable, 60, 970835277, 1141381674, 170546397
/Volumes/methlab_data/HBN/EEG-ET/NDARFX455JFY/NDARFX455JFY_Video1_Samples_ET.mat, Diary, 60, 3006271959, 3123669063, 117397104
/Volumes/methlab_data/HBN/EEG-ET/NDARFX455JFY/NDARFX455JFY_Video2_Samples_ET.mat, Fractals, 60, 3774478849, 3937470233, 162991384
/Volumes/methlab_data/HBN/EEG-ET/NDARFX455JFY/NDARFX455JFY_Video3_Samples_ET.mat, Despicable, 60, 4191313945, 4361859687, 170545742
/Volumes/methlab_data/HBN/EEG-ET/NDARFX455JFY/NDARFX455JFY_Video4_Samples_ET.mat, Present, 60, 4673391240, 4876453009, 203061769
/Volumes/methlab_data/HBN/EEG-ET/NDARFX508WPN/NDARFX508WPN_Video-DM_Samples_ET.mat, Despicable, 60, 5595531237, 5766082076, 170550839
/Volumes/methlab_data/HBN/EEG-ET/NDARFX508WPN/NDARFX508WPN_Video-FF_Samples_ET.mat, Fractals, 60, 5154100145, 5317087393, 162987248
/Volumes/methlab_data/HBN/EEG-ET/NDARFX508WPN/NDARFX508WPN_Video-TP_Samples_ET.mat, Present, 60, 6094546049, 6297613637, 203067588
/Volumes/methlab_data/HBN/EEG-ET/NDARFX508WPN/NDARFX508WPN_Video-WK_Samples_ET.mat, Diary, 60, 4736034568, 4853425597, 117391029
/Volumes/methlab_data/HBN/EEG-ET/NDARFX710UZA/NDARFX710UZA_Video1_Samples_ET.mat, Diary, 60, 4434447648, 4551847543, 117399895
/Volumes/methlab_data/HBN/EEG-ET/NDARFX710UZA/NDARFX710UZA_Video2_Samples_ET.mat, Fractals, 60, 3402022881, 3565011896, 162989015
/Volumes/methlab_data/HBN/EEG-ET/NDARFX710UZA/NDARFX710UZA_Video3_Samples_ET.mat, Despicable, 60, 3989938859, 4160488257, 170549398
/Volumes/methlab_data/HBN/EEG-ET/NDARFX710UZA/NDARFX710UZA_Video4_Samples_ET.mat, Present, 60, 4872483858, 5075546239, 203062381
/Volumes/methlab_data/HBN/EEG-ET/NDARFX721WR8/NDARFX721WR8_Video3_Samples_ET.mat, Despicable, 60, 2167892778, 2336112747, 168219969
/Volumes/methlab_data/HBN/EEG-ET/NDARFY009MNL/NDARFY009MNL_Video1_Samples_ET.mat, Diary, 60, 4927523568, 5044915405, 117391837
/Volumes/methlab_data/HBN/EEG-ET/NDARFY009MNL/NDARFY009MNL_Video3_Samples_ET.mat, Despicable, 60, 5300140492, 5470682896, 170542404
/Volumes/methlab_data/HBN/EEG-ET/NDARFY075REK/NDARFY075REK_Video1_Samples_ET.mat, Diary, 120, 7243639425, 7361037037, 117397612
/Volumes/methlab_data/HBN/EEG-ET/NDARFY075REK/NDARFY075REK_Video2_Samples_ET.mat, Fractals, 120, 8187913714, 8350900382, 162986668
/Volumes/methlab_data/HBN/EEG-ET/NDARFY075REK/NDARFY075REK_Video3_Samples_ET.mat, Despicable, 120, 8724160376, 8894707900, 170547524
/Volumes/methlab_data/HBN/EEG-ET/NDARFY525TL2/NDARFY525TL2_Video-DM_Samples_ET.mat, Despicable, 60, 2359837856, 2530393404, 170555548
/Volumes/methlab_data/HBN/EEG-ET/NDARFY525TL2/NDARFY525TL2_Video-FF_Samples_ET.mat, Fractals, 60, 62114141, 225100260, 162986119
/Volumes/methlab_data/HBN/EEG-ET/NDARFY525TL2/NDARFY525TL2_Video-TP_Samples_ET.mat, Present, 60, 475944560, 679007852, 203063292
/Volumes/methlab_data/HBN/EEG-ET/NDARFY525TL2/NDARFY525TL2_Video-WK_Samples_ET.mat, Diary, 60, 274576178, 391962158, 117385980
/Volumes/methlab_data/HBN/EEG-ET/NDARFY612EMR/NDARFY612EMR_Video1_Samples_ET.mat, Diary, 60, 2938363764, 3055755872, 117392108
/Volumes/methlab_data/HBN/EEG-ET/NDARFY612EMR/NDARFY612EMR_Video3_Samples_ET.mat, Despicable, 60, 2439709960, 2610251613, 170541653
/Volumes/methlab_data/HBN/EEG-ET/NDARFZ296UNG/NDARFZ296UNG_Video1_Samples_ET.mat, Diary, 60, 2832616867, 2950009971, 117393104
/Volumes/methlab_data/HBN/EEG-ET/NDARFZ296UNG/NDARFZ296UNG_Video3_Samples_ET.mat, Despicable, 60, 2357293504, 2527835213, 170541709
/Volumes/methlab_data/HBN/EEG-ET/NDARFZ698MJL/NDARFZ698MJL_Video-DM_Samples_ET.mat, Despicable, 60, 4066891630, 4237432016, 170540386
/Volumes/methlab_data/HBN/EEG-ET/NDARFZ698MJL/NDARFZ698MJL_Video-TP_Samples_ET.mat, Present, 60, 4548279954, 4751558524, 203278570
/Volumes/methlab_data/HBN/EEG-ET/NDARFZ698MJL/NDARFZ698MJL_Video-WK_Samples_ET.mat, Diary, 60, 3079648625, 3197192217, 117543592
/Volumes/methlab_data/HBN/EEG-ET/NDARGA048BD8/NDARGA048BD8_Video-DM_Samples_ET.mat, Despicable, 60, 7038270539, 7208811067, 170540528
/Volumes/methlab_data/HBN/EEG-ET/NDARGA048BD8/NDARGA048BD8_Video-FF_Samples_ET.mat, Fractals, 60, 6590649244, 6753643425, 162994181
/Volumes/methlab_data/HBN/EEG-ET/NDARGA048BD8/NDARGA048BD8_Video-TP_Samples_ET.mat, Present, 60, 7533361381, 7736423901, 203062520
/Volumes/methlab_data/HBN/EEG-ET/NDARGA048BD8/NDARGA048BD8_Video-WK_Samples_ET.mat, Diary, 60, 5688194505, 5805584488, 117389983
/Volumes/methlab_data/HBN/EEG-ET/NDARGA056TMW/NDARGA056TMW_Video1_Samples_ET.mat, Diary, 60, 3462536835, 3579937092, 117400257
/Volumes/methlab_data/HBN/EEG-ET/NDARGA056TMW/NDARGA056TMW_Video3_Samples_ET.mat, Despicable, 60, 3033652575, 3204202583, 170550008
/Volumes/methlab_data/HBN/EEG-ET/NDARGA346NA7/NDARGA346NA7_Video1_Samples_ET.mat, Diary, 60, 1677149112, 1794547300, 117398188
/Volumes/methlab_data/HBN/EEG-ET/NDARGA346NA7/NDARGA346NA7_Video3_Samples_ET.mat, Despicable, 60, 2472464484, 2643008300, 170543816
/Volumes/methlab_data/HBN/EEG-ET/NDARGA499CKF/NDARGA499CKF_Video1_Samples_ET.mat, Fractals, 120, 4316510248, 4479494385, 162984137
/Volumes/methlab_data/HBN/EEG-ET/NDARGA499CKF/NDARGA499CKF_Video2_Samples_ET.mat, Diary, 120, 5156602905, 5274000043, 117397138
/Volumes/methlab_data/HBN/EEG-ET/NDARGA499CKF/NDARGA499CKF_Video3_Samples_ET.mat, Despicable, 120, 5606959060, 5777506675, 170547615
/Volumes/methlab_data/HBN/EEG-ET/NDARGA499CKF/NDARGA499CKF_Video4_Samples_ET.mat, Present, 120, 6177226203, 6380292551, 203066348
/Volumes/methlab_data/HBN/EEG-ET/NDARGA507DCC/NDARGA507DCC_Video1_Samples_ET.mat, Fractals, 120, 2446819649, 2609803608, 162983959
/Volumes/methlab_data/HBN/EEG-ET/NDARGA507DCC/NDARGA507DCC_Video2_Samples_ET.mat, Despicable, 120, 3126151563, 3296698026, 170546463
/Volumes/methlab_data/HBN/EEG-ET/NDARGA507DCC/NDARGA507DCC_Video3_Samples_ET.mat, Diary, 120, 3622527622, 3739946173, 117418551
/Volumes/methlab_data/HBN/EEG-ET/NDARGA507DCC/NDARGA507DCC_Video4_Samples_ET.mat, Present, 120, 4203495809, 4406562989, 203067180
/Volumes/methlab_data/HBN/EEG-ET/NDARGA921UHR/NDARGA921UHR_Video-DM_Samples_ET.mat, Despicable, 60, 3646319541, 3816857351, 170537810
/Volumes/methlab_data/HBN/EEG-ET/NDARGA921UHR/NDARGA921UHR_Video-TP_Samples_ET.mat, Present, 60, 4595685024, 4798956038, 203271014
/Volumes/methlab_data/HBN/EEG-ET/NDARGA921UHR/NDARGA921UHR_Video-WK_Samples_ET.mat, Diary, 60, 4117897568, 4235285745, 117388177
/Volumes/methlab_data/HBN/EEG-ET/NDARGB000CW8/NDARGB000CW8_Video1_Samples_ET.mat, Diary, 120, 17397331757, 17514728447, 117396690
/Volumes/methlab_data/HBN/EEG-ET/NDARGB000CW8/NDARGB000CW8_Video2_Samples_ET.mat, Fractals, 120, 18148944709, 18311932457, 162987748
/Volumes/methlab_data/HBN/EEG-ET/NDARGB000CW8/NDARGB000CW8_Video3_Samples_ET.mat, Despicable, 120, 18670783120, 18841330198, 170547078
/Volumes/methlab_data/HBN/EEG-ET/NDARGB000CW8/NDARGB000CW8_Video4_Samples_ET.mat, Present, 120, 19291648616, 19494716189, 203067573
/Volumes/methlab_data/HBN/EEG-ET/NDARGB015CT3/NDARGB015CT3_Video-DM_Samples_ET.mat, Despicable, 60, 3824048964, 3994585314, 170536350
/Volumes/methlab_data/HBN/EEG-ET/NDARGB015CT3/NDARGB015CT3_Video-TP_Samples_ET.mat, Present, 60, 4344724342, 4547990786, 203266444
/Volumes/methlab_data/HBN/EEG-ET/NDARGB015CT3/NDARGB015CT3_Video-WK_Samples_ET.mat, Diary, 60, 2756704845, 2874087862, 117383017
/Volumes/methlab_data/HBN/EEG-ET/NDARGB040MGR/NDARGB040MGR_Video1_Samples_ET.mat, Diary, 60, 2138590911, 2255987014, 117396103
/Volumes/methlab_data/HBN/EEG-ET/NDARGB040MGR/NDARGB040MGR_Video3_Samples_ET.mat, Despicable, 60, 3300673239, 3471215006, 170541767
/Volumes/methlab_data/HBN/EEG-ET/NDARGB060TAM/NDARGB060TAM_Video-DM_Samples_ET.mat, Despicable, 60, 5059610515, 5230150152, 170539637
/Volumes/methlab_data/HBN/EEG-ET/NDARGB060TAM/NDARGB060TAM_Video-TP_Samples_ET.mat, Present, 60, 5652884980, 5856164709, 203279729
/Volumes/methlab_data/HBN/EEG-ET/NDARGB060TAM/NDARGB060TAM_Video-WK_Samples_ET.mat, Diary, 60, 4461456635, 4578848646, 117392011
/Volumes/methlab_data/HBN/EEG-ET/NDARGB102NWJ/NDARGB102NWJ_Video1_Samples_ET.mat, Diary, 120, 2847836860, 2965223435, 117386575
/Volumes/methlab_data/HBN/EEG-ET/NDARGB102NWJ/NDARGB102NWJ_Video2_Samples_ET.mat, Fractals, 120, 4382969760, 4545957454, 162987694
/Volumes/methlab_data/HBN/EEG-ET/NDARGB102NWJ/NDARGB102NWJ_Video3_Samples_ET.mat, Despicable, 120, 4777608037, 4948155135, 170547098
/Volumes/methlab_data/HBN/EEG-ET/NDARGB102NWJ/NDARGB102NWJ_Video4_Samples_ET.mat, Present, 120, 5495672798, 5698740042, 203067244
/Volumes/methlab_data/HBN/EEG-ET/NDARGB324PM1/NDARGB324PM1_Video1_Samples_ET.mat, Diary, 60, 1102995802, 1220387374, 117391572
/Volumes/methlab_data/HBN/EEG-ET/NDARGB324PM1/NDARGB324PM1_Video3_Samples_ET.mat, Despicable, 60, 835013088, 1005553467, 170540379
/Volumes/methlab_data/HBN/EEG-ET/NDARGB441VVD/NDARGB441VVD_Video1_Samples_ET.mat, Diary, 120, 4110328948, 4227726339, 117397391
/Volumes/methlab_data/HBN/EEG-ET/NDARGB441VVD/NDARGB441VVD_Video2_Samples_ET.mat, Despicable, 120, 6002426229, 6172973272, 170547043
/Volumes/methlab_data/HBN/EEG-ET/NDARGB441VVD/NDARGB441VVD_Video3_Samples_ET.mat, Fractals, 120, 6453771716, 6616759271, 162987555
/Volumes/methlab_data/HBN/EEG-ET/NDARGB441VVD/NDARGB441VVD_Video4_Samples_ET.mat, Present, 120, 7096369750, 7299435517, 203065767
/Volumes/methlab_data/HBN/EEG-ET/NDARGB528CP8/NDARGB528CP8_Video1_Samples_ET.mat, Despicable, 120, 2507963559, 2678510341, 170546782
/Volumes/methlab_data/HBN/EEG-ET/NDARGB528CP8/NDARGB528CP8_Video2_Samples_ET.mat, Diary, 120, 2795890772, 2913288524, 117397752
/Volumes/methlab_data/HBN/EEG-ET/NDARGB528CP8/NDARGB528CP8_Video3_Samples_ET.mat, Fractals, 120, 2994119728, 3157107749, 162988021
/Volumes/methlab_data/HBN/EEG-ET/NDARGB528CP8/NDARGB528CP8_Video4_Samples_ET.mat, Present, 120, 3207029151, 3410096219, 203067068
/Volumes/methlab_data/HBN/EEG-ET/NDARGB866MPN/NDARGB866MPN_Video-DM_Samples_ET.mat, Despicable, 120, 7584229438, 7754773015, 170543577
/Volumes/methlab_data/HBN/EEG-ET/NDARGB866MPN/NDARGB866MPN_Video-FF_Samples_ET.mat, Fractals, 120, 6096517116, 6259502695, 162985579
/Volumes/methlab_data/HBN/EEG-ET/NDARGB866MPN/NDARGB866MPN_Video-WK_Samples_ET.mat, Diary, 120, 7135648431, 7253046010, 117397579
/Volumes/methlab_data/HBN/EEG-ET/NDARGB998HX3/NDARGB998HX3_Video-DM_Samples_ET.mat, Despicable, 120, 4805064695, 4975606465, 170541770
/Volumes/methlab_data/HBN/EEG-ET/NDARGB998HX3/NDARGB998HX3_Video-FF_Samples_ET.mat, Fractals, 120, 5339011117, 5502007083, 162995966
/Volumes/methlab_data/HBN/EEG-ET/NDARGB998HX3/NDARGB998HX3_Video-TP_Samples_ET.mat, Present, 120, 5807965138, 6011029371, 203064233
/Volumes/methlab_data/HBN/EEG-ET/NDARGB998HX3/NDARGB998HX3_Video-WK_Samples_ET.mat, Diary, 120, 5636458016, 5753856108, 117398092
/Volumes/methlab_data/HBN/EEG-ET/NDARGC099LDZ/NDARGC099LDZ_Video-DM_Samples_ET.mat, Despicable, 120, 2486974026, 2657530316, 170556290
/Volumes/methlab_data/HBN/EEG-ET/NDARGC099LDZ/NDARGC099LDZ_Video-FF_Samples_ET.mat, Fractals, 120, 3013559829, 3176548254, 162988425
/Volumes/methlab_data/HBN/EEG-ET/NDARGC099LDZ/NDARGC099LDZ_Video-TP_Samples_ET.mat, Present, 120, 3218750414, 3421812529, 203062115
/Volumes/methlab_data/HBN/EEG-ET/NDARGC099LDZ/NDARGC099LDZ_Video-WK_Samples_ET.mat, Diary, 120, 2819260978, 2936658426, 117397448
/Volumes/methlab_data/HBN/EEG-ET/NDARGC124PAW/NDARGC124PAW_Video-DM_Samples_ET.mat, Despicable, 60, 1196807738, 1367355199, 170547461
/Volumes/methlab_data/HBN/EEG-ET/NDARGC124PAW/NDARGC124PAW_Video-TP_Samples_ET.mat, Present, 60, 1771714093, 1974995878, 203281785
/Volumes/methlab_data/HBN/EEG-ET/NDARGC124PAW/NDARGC124PAW_Video-WK_Samples_ET.mat, Diary, 60, 1407495750, 1524884359, 117388609
/Volumes/methlab_data/HBN/EEG-ET/NDARGC157LYY/NDARGC157LYY_Video-DM_Samples_ET.mat, Despicable, 30, 9454981872, 9625519133, 170537261
/Volumes/methlab_data/HBN/EEG-ET/NDARGC157LYY/NDARGC157LYY_Video-TP_Samples_ET.mat, Present, 30, 10575346685, 10778612984, 203266299
/Volumes/methlab_data/HBN/EEG-ET/NDARGC157LYY/NDARGC157LYY_Video-WK_Samples_ET.mat, Diary, 30, 9985675005, 10103073762, 117398757
/Volumes/methlab_data/HBN/EEG-ET/NDARGC170UK2/NDARGC170UK2_Video-DM_Samples_ET.mat, Despicable, 60, 4555166806, 4725709420, 170542614
/Volumes/methlab_data/HBN/EEG-ET/NDARGC170UK2/NDARGC170UK2_Video-FF_Samples_ET.mat, Fractals, 60, 4110561487, 4273543729, 162982242
/Volumes/methlab_data/HBN/EEG-ET/NDARGC170UK2/NDARGC170UK2_Video-TP_Samples_ET.mat, Present, 60, 5072649672, 5275708261, 203058589
/Volumes/methlab_data/HBN/EEG-ET/NDARGC170UK2/NDARGC170UK2_Video-WK_Samples_ET.mat, Diary, 60, 3444884845, 3562280902, 117396057
/Volumes/methlab_data/HBN/EEG-ET/NDARGC255BUN/NDARGC255BUN_Video-DM_Samples_ET.mat, Despicable, 60, 6547396748, 6717941268, 170544520
/Volumes/methlab_data/HBN/EEG-ET/NDARGC255BUN/NDARGC255BUN_Video-FF_Samples_ET.mat, Fractals, 60, 6126593402, 6289573560, 162980158
/Volumes/methlab_data/HBN/EEG-ET/NDARGC255BUN/NDARGC255BUN_Video-TP_Samples_ET.mat, Present, 60, 7020302917, 7223370431, 203067514
/Volumes/methlab_data/HBN/EEG-ET/NDARGC255BUN/NDARGC255BUN_Video-WK_Samples_ET.mat, Diary, 60, 5214284735, 5331678668, 117393933
/Volumes/methlab_data/HBN/EEG-ET/NDARGC407NV7/NDARGC407NV7_Video-TP_Samples_ET.mat, Present, 30, 5032442977, 5235719639, 203276662
/Volumes/methlab_data/HBN/EEG-ET/NDARGC407NV7/NDARGC407NV7_Video-WK_Samples_ET.mat, Diary, 30, 3485882137, 3603317122, 117434985
/Volumes/methlab_data/HBN/EEG-ET/NDARGC471KD1/NDARGC471KD1_Video1_Samples_ET.mat, Diary, 120, 2553145365, 2670541149, 117395784
/Volumes/methlab_data/HBN/EEG-ET/NDARGC471KD1/NDARGC471KD1_Video2_Samples_ET.mat, Fractals, 120, 3528697092, 3691684480, 162987388
/Volumes/methlab_data/HBN/EEG-ET/NDARGC471KD1/NDARGC471KD1_Video3_Samples_ET.mat, Despicable, 120, 4001274299, 4171821536, 170547237
/Volumes/methlab_data/HBN/EEG-ET/NDARGC471KD1/NDARGC471KD1_Video4_Samples_ET.mat, Present, 120, 4697965779, 4901031890, 203066111
/Volumes/methlab_data/HBN/EEG-ET/NDARGC521HNP/NDARGC521HNP_Video1_Samples_ET.mat, Diary, 60, 4156304891, 4273689632, 117384741
/Volumes/methlab_data/HBN/EEG-ET/NDARGC521HNP/NDARGC521HNP_Video3_Samples_ET.mat, Despicable, 60, 3937489855, 4108034545, 170544690
/Volumes/methlab_data/HBN/EEG-ET/NDARGC559LN8/NDARGC559LN8_Video-DM_Samples_ET.mat, Despicable, 60, 5031192120, 5201735780, 170543660
/Volumes/methlab_data/HBN/EEG-ET/NDARGC559LN8/NDARGC559LN8_Video-FF_Samples_ET.mat, Fractals, 60, 4298882920, 4461869079, 162986159
/Volumes/methlab_data/HBN/EEG-ET/NDARGC559LN8/NDARGC559LN8_Video-TP_Samples_ET.mat, Present, 60, 5954855520, 6157926069, 203070549
/Volumes/methlab_data/HBN/EEG-ET/NDARGC559LN8/NDARGC559LN8_Video-WK_Samples_ET.mat, Diary, 60, 5502829797, 5620223367, 117393570
/Volumes/methlab_data/HBN/EEG-ET/NDARGD229DCJ/NDARGD229DCJ_Video-DM_Samples_ET.mat, Despicable, 60, 3745309721, 3915847355, 170537634
/Volumes/methlab_data/HBN/EEG-ET/NDARGD229DCJ/NDARGD229DCJ_Video-TP_Samples_ET.mat, Present, 60, 4276636503, 4479911294, 203274791
/Volumes/methlab_data/HBN/EEG-ET/NDARGD229DCJ/NDARGD229DCJ_Video-WK_Samples_ET.mat, Diary, 60, 2356215246, 2473597301, 117382055
/Volumes/methlab_data/HBN/EEG-ET/NDARGD414HBX/NDARGD414HBX_Video-DM_Samples_ET.mat, Despicable, 120, 7427173118, 7597720367, 170547249
/Volumes/methlab_data/HBN/EEG-ET/NDARGD414HBX/NDARGD414HBX_Video-FF_Samples_ET.mat, Fractals, 120, 6685548620, 6848535720, 162987100
/Volumes/methlab_data/HBN/EEG-ET/NDARGD414HBX/NDARGD414HBX_Video-TP_Samples_ET.mat, Present, 120, 8660526449, 8863593196, 203066747
/Volumes/methlab_data/HBN/EEG-ET/NDARGD414HBX/NDARGD414HBX_Video-WK_Samples_ET.mat, Diary, 120, 7918510874, 8035907398, 117396524
/Volumes/methlab_data/HBN/EEG-ET/NDARGD425PTN/NDARGD425PTN_Video-DM_Samples_ET.mat, Despicable, 120, 3798231254, 3968778705, 170547451
/Volumes/methlab_data/HBN/EEG-ET/NDARGD425PTN/NDARGD425PTN_Video-FF_Samples_ET.mat, Fractals, 120, 2946807433, 3109793470, 162986037
/Volumes/methlab_data/HBN/EEG-ET/NDARGD425PTN/NDARGD425PTN_Video-WK_Samples_ET.mat, Diary, 120, 4367263626, 4484653484, 117389858
/Volumes/methlab_data/HBN/EEG-ET/NDARGD507TDZ/NDARGD507TDZ_Video1_Samples_ET.mat, Diary, 60, 874445764, 991833873, 117388109
/Volumes/methlab_data/HBN/EEG-ET/NDARGD507TDZ/NDARGD507TDZ_Video3_Samples_ET.mat, Despicable, 60, 656712700, 827264405, 170551705
/Volumes/methlab_data/HBN/EEG-ET/NDARGE366WNC/NDARGE366WNC_Video1_Samples_ET.mat, Diary, 60, 1823189999, 1940584032, 117394033
/Volumes/methlab_data/HBN/EEG-ET/NDARGE366WNC/NDARGE366WNC_Video3_Samples_ET.mat, Despicable, 60, 3276230679, 3446773300, 170542621
/Volumes/methlab_data/HBN/EEG-ET/NDARGE536BGD/NDARGE536BGD_Video1_Samples_ET.mat, Diary, 60, 3950796989, 4068187043, 117390054
/Volumes/methlab_data/HBN/EEG-ET/NDARGE536BGD/NDARGE536BGD_Video3_Samples_ET.mat, Despicable, 60, 3471294853, 3641832488, 170537635
/Volumes/methlab_data/HBN/EEG-ET/NDARGE643MYU/NDARGE643MYU_Video-DM_Samples_ET.mat, Despicable, 30, 4216622107, 4387154791, 170532684
/Volumes/methlab_data/HBN/EEG-ET/NDARGE643MYU/NDARGE643MYU_Video-TP_Samples_ET.mat, Present, 30, 4692423793, 4895691650, 203267857
/Volumes/methlab_data/HBN/EEG-ET/NDARGE643MYU/NDARGE643MYU_Video-WK_Samples_ET.mat, Diary, 30, 3243167260, 3360555342, 117388082
/Volumes/methlab_data/HBN/EEG-ET/NDARGE946RCB/NDARGE946RCB_Video1_Samples_ET.mat, Diary, 60, 4722590347, 4839983205, 117392858
/Volumes/methlab_data/HBN/EEG-ET/NDARGE946RCB/NDARGE946RCB_Video3_Samples_ET.mat, Despicable, 60, 4074964404, 4245506746, 170542342
/Volumes/methlab_data/HBN/EEG-ET/NDARGE994BMX/NDARGE994BMX_Video1_Samples_ET.mat, Diary, 60, 3090432659, 3207828860, 117396201
/Volumes/methlab_data/HBN/EEG-ET/NDARGE994BMX/NDARGE994BMX_Video2_Samples_ET.mat, Fractals, 60, 3720513986, 3883506970, 162992984
/Volumes/methlab_data/HBN/EEG-ET/NDARGE994BMX/NDARGE994BMX_Video3_Samples_ET.mat, Despicable, 60, 4203027757, 4373570611, 170542854
/Volumes/methlab_data/HBN/EEG-ET/NDARGE994BMX/NDARGE994BMX_Video4_Samples_ET.mat, Present, 60, 4695381518, 4898441395, 203059877
/Volumes/methlab_data/HBN/EEG-ET/NDARGF367KVL/NDARGF367KVL_Video1_Samples_ET.mat, Diary, 60, 2585999526, 2703393719, 117394193
/Volumes/methlab_data/HBN/EEG-ET/NDARGF367KVL/NDARGF367KVL_Video3_Samples_ET.mat, Despicable, 60, 2157983361, 2328529183, 170545822
/Volumes/methlab_data/HBN/EEG-ET/NDARGF445UFB/NDARGF445UFB_Video1_Samples_ET.mat, Diary, 120, 3360445218, 3477834923, 117389705
/Volumes/methlab_data/HBN/EEG-ET/NDARGF445UFB/NDARGF445UFB_Video2_Samples_ET.mat, Fractals, 120, 4621535953, 4784523460, 162987507
/Volumes/methlab_data/HBN/EEG-ET/NDARGF445UFB/NDARGF445UFB_Video3_Samples_ET.mat, Despicable, 120, 5152688597, 5323236251, 170547654
/Volumes/methlab_data/HBN/EEG-ET/NDARGF445UFB/NDARGF445UFB_Video4_Samples_ET.mat, Present, 120, 5807774207, 6010836280, 203062073
/Volumes/methlab_data/HBN/EEG-ET/NDARGF543PM2/NDARGF543PM2_Video1_Samples_ET.mat, Diary, 120, 4571232062, 4688629631, 117397569
/Volumes/methlab_data/HBN/EEG-ET/NDARGF543PM2/NDARGF543PM2_Video2_Samples_ET.mat, Fractals, 120, 5201388353, 5364375058, 162986705
/Volumes/methlab_data/HBN/EEG-ET/NDARGF543PM2/NDARGF543PM2_Video3_Samples_ET.mat, Despicable, 120, 5691925744, 5862470272, 170544528
/Volumes/methlab_data/HBN/EEG-ET/NDARGF543PM2/NDARGF543PM2_Video4_Samples_ET.mat, Present, 120, 6371033064, 6574098753, 203065689
/Volumes/methlab_data/HBN/EEG-ET/NDARGG058DYF/NDARGG058DYF_Video-DM_Samples_ET.mat, Despicable, 60, 4545256494, 4715793056, 170536562
/Volumes/methlab_data/HBN/EEG-ET/NDARGG058DYF/NDARGG058DYF_Video-TP_Samples_ET.mat, Present, 60, 5089412037, 5292688682, 203276645
/Volumes/methlab_data/HBN/EEG-ET/NDARGG058DYF/NDARGG058DYF_Video-WK_Samples_ET.mat, Diary, 60, 4096500382, 4213891369, 117390987
/Volumes/methlab_data/HBN/EEG-ET/NDARGG423UMK/NDARGG423UMK_Video-DM_Samples_ET.mat, Despicable, 60, 5643915114, 5814455631, 170540517
/Volumes/methlab_data/HBN/EEG-ET/NDARGG423UMK/NDARGG423UMK_Video-TP_Samples_ET.mat, Present, 60, 6155281469, 6358556177, 203274708
/Volumes/methlab_data/HBN/EEG-ET/NDARGG539YGN/NDARGG539YGN_Video1_Samples_ET.mat, Diary, 60, 15377603357, 15494998363, 117395006
/Volumes/methlab_data/HBN/EEG-ET/NDARGG539YGN/NDARGG539YGN_Video4_Samples_ET.mat, Present, 60, 15808495855, 16011552350, 203056495
/Volumes/methlab_data/HBN/EEG-ET/NDARGH074MU6/NDARGH074MU6_Video1_Samples_ET.mat, Diary, 60, 3221555595, 3338951602, 117396007
/Volumes/methlab_data/HBN/EEG-ET/NDARGH074MU6/NDARGH074MU6_Video3_Samples_ET.mat, Despicable, 60, 4253112894, 4423656525, 170543631
/Volumes/methlab_data/HBN/EEG-ET/NDARGH074MU6/NDARGH074MU6_Video4_Samples_ET.mat, Present, 60, 4743467583, 4946534168, 203066585
/Volumes/methlab_data/HBN/EEG-ET/NDARGH492CF1/NDARGH492CF1_Video1_Samples_ET.mat, Diary, 60, 3603163798, 3720557864, 117394066
/Volumes/methlab_data/HBN/EEG-ET/NDARGH492CF1/NDARGH492CF1_Video3_Samples_ET.mat, Despicable, 60, 3385492856, 3556037496, 170544640
/Volumes/methlab_data/HBN/EEG-ET/NDARGH775KF5/NDARGH775KF5_Video1_Samples_ET.mat, Diary, 60, 2555163266, 2672544303, 117381037
/Volumes/methlab_data/HBN/EEG-ET/NDARGH775KF5/NDARGH775KF5_Video3_Samples_ET.mat, Despicable, 60, 1911126642, 2081678626, 170551984
/Volumes/methlab_data/HBN/EEG-ET/NDARGH790CEF/NDARGH790CEF_Video3_Samples_ET.mat, Despicable, 60, 2721633175, 2892191595, 170558420
/Volumes/methlab_data/HBN/EEG-ET/NDARGJ392ACY/NDARGJ392ACY_Video-DM_Samples_ET.mat, Despicable, 30, 2141402719, 2311940310, 170537591
/Volumes/methlab_data/HBN/EEG-ET/NDARGJ392ACY/NDARGJ392ACY_Video-TP_Samples_ET.mat, Present, 30, 3998656795, 4201923531, 203266736
/Volumes/methlab_data/HBN/EEG-ET/NDARGJ392ACY/NDARGJ392ACY_Video-WK_Samples_ET.mat, Diary, 30, 2964974984, 3082363996, 117389012
/Volumes/methlab_data/HBN/EEG-ET/NDARGJ395FKP/NDARGJ395FKP_Video1_Samples_ET.mat, Diary, 60, 3406075936, 3523465501, 117389565
/Volumes/methlab_data/HBN/EEG-ET/NDARGJ395FKP/NDARGJ395FKP_Video3_Samples_ET.mat, Despicable, 60, 4760286786, 4930828157, 170541371
/Volumes/methlab_data/HBN/EEG-ET/NDARGJ627BL2/NDARGJ627BL2_Video1_Samples_ET.mat, Despicable, 120, 3097963641, 3178422267, 3348969140
2.510055e+08, 1.705469e+08, /Volumes/methlab_data/HBN/EEG-ET/NDARGJ627BL2/NDARGJ627BL2_Video2_Samples_ET.mat, Fractals, 120, 3514859560, 3677846974, 162987414
/Volumes/methlab_data/HBN/EEG-ET/NDARGJ627BL2/NDARGJ627BL2_Video3_Samples_ET.mat, Diary, 120, 3760477492, 3877874916, 117397424
/Volumes/methlab_data/HBN/EEG-ET/NDARGJ627BL2/NDARGJ627BL2_Video4_Samples_ET.mat, Present, 120, 3926446131, 4129522957, 203076826
/Volumes/methlab_data/HBN/EEG-ET/NDARGJ653MG2/NDARGJ653MG2_Video-DM_Samples_ET.mat, Despicable, 30, 3821649631, 3992189041, 170539410
/Volumes/methlab_data/HBN/EEG-ET/NDARGJ653MG2/NDARGJ653MG2_Video-TP_Samples_ET.mat, Present, 30, 4311917716, 4515180238, 203262522
/Volumes/methlab_data/HBN/EEG-ET/NDARGJ653MG2/NDARGJ653MG2_Video-WK_Samples_ET.mat, Diary, 30, 2563821695, 2681210574, 117388879
/Volumes/methlab_data/HBN/EEG-ET/NDARGJ761GA8/NDARGJ761GA8_Video3_Samples_ET.mat, Despicable, 60, 3191685907, 3362230535, 170544628
/Volumes/methlab_data/HBN/EEG-ET/NDARGJ878ZP4/NDARGJ878ZP4_Video1_Samples_ET.mat, Diary, 60, 5071983406, 5189382354, 117398948
/Volumes/methlab_data/HBN/EEG-ET/NDARGJ878ZP4/NDARGJ878ZP4_Video3_Samples_ET.mat, Despicable, 60, 4636308698, 4806859163, 170550465
/Volumes/methlab_data/HBN/EEG-ET/NDARGK254RYE/NDARGK254RYE_Video-DM_Samples_ET.mat, Despicable, 60, 8838772181, 9009313694, 170541513
/Volumes/methlab_data/HBN/EEG-ET/NDARGK254RYE/NDARGK254RYE_Video-FF_Samples_ET.mat, Fractals, 60, 8224371992, 8387353314, 162981322
/Volumes/methlab_data/HBN/EEG-ET/NDARGK254RYE/NDARGK254RYE_Video-TP_Samples_ET.mat, Present, 60, 9707844284, 9910915819, 203071535
/Volumes/methlab_data/HBN/EEG-ET/NDARGK254RYE/NDARGK254RYE_Video-WK_Samples_ET.mat, Diary, 60, 9288996318, 9406392295, 117395977
/Volumes/methlab_data/HBN/EEG-ET/NDARGK442YHH/NDARGK442YHH_Video-DM_Samples_ET.mat, Despicable, 60, 5887868248, 6058411828, 170543580
/Volumes/methlab_data/HBN/EEG-ET/NDARGK442YHH/NDARGK442YHH_Video-FF_Samples_ET.mat, Fractals, 60, 5112242967, 5275228153, 162985186
/Volumes/methlab_data/HBN/EEG-ET/NDARGK442YHH/NDARGK442YHH_Video-TP_Samples_ET.mat, Present, 60, 6807160190, 7010231787, 203071597
/Volumes/methlab_data/HBN/EEG-ET/NDARGK442YHH/NDARGK442YHH_Video-WK_Samples_ET.mat, Diary, 60, 6349882906, 6467282930, 117400024
/Volumes/methlab_data/HBN/EEG-ET/NDARGK608LJ8/NDARGK608LJ8_Video1_Samples_ET.mat, Diary, 60, 5474699741, 5592090595, 117390854
/Volumes/methlab_data/HBN/EEG-ET/NDARGK608LJ8/NDARGK608LJ8_Video3_Samples_ET.mat, Despicable, 60, 5024337978, 5194887327, 170549349
/Volumes/methlab_data/HBN/EEG-ET/NDARGK608LJ8/NDARGK608LJ8_Video4_Samples_ET.mat, Present, 60, 5980893909, 6183964209, 203070300
/Volumes/methlab_data/HBN/EEG-ET/NDARGK736HF4/NDARGK736HF4_Video1_Samples_ET.mat, Diary, 60, 5591380474, 5708771335, 117390861
/Volumes/methlab_data/HBN/EEG-ET/NDARGK736HF4/NDARGK736HF4_Video3_Samples_ET.mat, Despicable, 60, 4940661353, 5111203708, 170542355
/Volumes/methlab_data/HBN/EEG-ET/NDARGK786DWR/NDARGK786DWR_Video1_Samples_ET.mat, Diary, 120, 4011517925, 4128904698, 117386773
/Volumes/methlab_data/HBN/EEG-ET/NDARGK786DWR/NDARGK786DWR_Video2_Samples_ET.mat, Fractals, 120, 4841629534, 5004617530, 162987996
/Volumes/methlab_data/HBN/EEG-ET/NDARGK786DWR/NDARGK786DWR_Video3_Samples_ET.mat, Despicable, 120, 5397118104, 5567664807, 170546703
/Volumes/methlab_data/HBN/EEG-ET/NDARGK786DWR/NDARGK786DWR_Video4_Samples_ET.mat, Present, 120, 6003853788, 6206920798, 203067010
/Volumes/methlab_data/HBN/EEG-ET/NDARGK943RL3/NDARGK943RL3_Video1_Samples_ET.mat, Diary, 60, 3490638669, 3608034812, 117396143
/Volumes/methlab_data/HBN/EEG-ET/NDARGK943RL3/NDARGK943RL3_Video2_Samples_ET.mat, Fractals, 60, 2314497992, 2477482431, 162984439
/Volumes/methlab_data/HBN/EEG-ET/NDARGK943RL3/NDARGK943RL3_Video3_Samples_ET.mat, Despicable, 60, 3008438283, 3178978051, 170539768
/Volumes/methlab_data/HBN/EEG-ET/NDARGK943RL3/NDARGK943RL3_Video4_Samples_ET.mat, Present, 60, 3951878233, 4154938028, 203059795
/Volumes/methlab_data/HBN/EEG-ET/NDARGL085RTW/NDARGL085RTW_Video1_Samples_ET.mat, Fractals, 120, 3928189910, 4091176288, 162986378
/Volumes/methlab_data/HBN/EEG-ET/NDARGL085RTW/NDARGL085RTW_Video2_Samples_ET.mat, Diary, 120, 5588794667, 5706187643, 117392976
/Volumes/methlab_data/HBN/EEG-ET/NDARGL085RTW/NDARGL085RTW_Video3_Samples_ET.mat, Despicable, 120, 6167558152, 6338101950, 170543798
/Volumes/methlab_data/HBN/EEG-ET/NDARGL085RTW/NDARGL085RTW_Video4_Samples_ET.mat, Present, 120, 6784492011, 6987567919, 203075908
/Volumes/methlab_data/HBN/EEG-ET/NDARGL105JJ7/NDARGL105JJ7_Video1_Samples_ET.mat, Diary, 60, 1876349744, 1993740925, 117391181
/Volumes/methlab_data/HBN/EEG-ET/NDARGL105JJ7/NDARGL105JJ7_Video2_Samples_ET.mat, Fractals, 60, 2553204210, 2716186680, 162982470
/Volumes/methlab_data/HBN/EEG-ET/NDARGL105JJ7/NDARGL105JJ7_Video3_Samples_ET.mat, Despicable, 60, 3033769607, 3204312420, 170542813
/Volumes/methlab_data/HBN/EEG-ET/NDARGL105JJ7/NDARGL105JJ7_Video4_Samples_ET.mat, Present, 60, 3538171904, 3741235750, 203063846
/Volumes/methlab_data/HBN/EEG-ET/NDARGL107GFK/NDARGL107GFK_Video1_Samples_ET.mat, Diary, 120, 4124757893, 4242154838, 117396945
/Volumes/methlab_data/HBN/EEG-ET/NDARGL107GFK/NDARGL107GFK_Video2_Samples_ET.mat, Fractals, 120, 5650733020, 5813717610, 162984590
/Volumes/methlab_data/HBN/EEG-ET/NDARGL107GFK/NDARGL107GFK_Video3_Samples_ET.mat, Despicable, 120, 6180893601, 6351441185, 170547584
/Volumes/methlab_data/HBN/EEG-ET/NDARGL289TB8/NDARGL289TB8_Video-DM_Samples_ET.mat, Despicable, 60, 5008164951, 5178705562, 170540611
/Volumes/methlab_data/HBN/EEG-ET/NDARGL289TB8/NDARGL289TB8_Video-TP_Samples_ET.mat, Present, 60, 5606787307, 5810055089, 203267782
/Volumes/methlab_data/HBN/EEG-ET/NDARGL289TB8/NDARGL289TB8_Video-WK_Samples_ET.mat, Diary, 60, 3850063824, 3967467893, 117404069
/Volumes/methlab_data/HBN/EEG-ET/NDARGL359WZA/NDARGL359WZA_Video1_Samples_ET.mat, Despicable, 120, 1560923197, 1806361714, 1976918238
4.159950e+08, 1.705565e+08, /Volumes/methlab_data/HBN/EEG-ET/NDARGL359WZA/NDARGL359WZA_Video2_Samples_ET.mat, Fractals, 120, 2106248458, 2269245872, 162997414
/Volumes/methlab_data/HBN/EEG-ET/NDARGL359WZA/NDARGL359WZA_Video3_Samples_ET.mat, Diary, 120, 2341777464, 2459174566, 117397102
/Volumes/methlab_data/HBN/EEG-ET/NDARGL359WZA/NDARGL359WZA_Video4_Samples_ET.mat, Present, 120, 2631366099, 2834433079, 203066980
/Volumes/methlab_data/HBN/EEG-ET/NDARGL800LDW/NDARGL800LDW_Video1_Samples_ET.mat, Diary, 60, 3395102025, 3512497021, 117394996
/Volumes/methlab_data/HBN/EEG-ET/NDARGL800LDW/NDARGL800LDW_Video3_Samples_ET.mat, Despicable, 60, 4299515149, 4470058671, 170543522
/Volumes/methlab_data/HBN/EEG-ET/NDARGL834CMQ/NDARGL834CMQ_Video1_Samples_ET.mat, Diary, 60, 2924221536, 3041616468, 117394932
/Volumes/methlab_data/HBN/EEG-ET/NDARGL834CMQ/NDARGL834CMQ_Video3_Samples_ET.mat, Despicable, 60, 3714563770, 3885106220, 170542450
/Volumes/methlab_data/HBN/EEG-ET/NDARGL936KTV/NDARGL936KTV_Video1_Samples_ET.mat, Diary, 60, 2625821977, 2743214100, 117392123
/Volumes/methlab_data/HBN/EEG-ET/NDARGL936KTV/NDARGL936KTV_Video2_Samples_ET.mat, Fractals, 60, 2019940005, 2182927427, 162987422
/Volumes/methlab_data/HBN/EEG-ET/NDARGL936KTV/NDARGL936KTV_Video3_Samples_ET.mat, Despicable, 60, 3040359455, 3210897206, 170537751
/Volumes/methlab_data/HBN/EEG-ET/NDARGL936KTV/NDARGL936KTV_Video4_Samples_ET.mat, Present, 60, 3519280523, 3722341298, 203060775
/Volumes/methlab_data/HBN/EEG-ET/NDARGL963HU4/NDARGL963HU4_Video1_Samples_ET.mat, Diary, 60, 3086629299, 3204026234, 117396935
/Volumes/methlab_data/HBN/EEG-ET/NDARGL963HU4/NDARGL963HU4_Video3_Samples_ET.mat, Despicable, 60, 2141822009, 2312366476, 170544467
/Volumes/methlab_data/HBN/EEG-ET/NDARGM240YJM/NDARGM240YJM_Video-DM_Samples_ET.mat, Despicable, 60, 4459989848, 4630524431, 170534583
/Volumes/methlab_data/HBN/EEG-ET/NDARGM240YJM/NDARGM240YJM_Video-TP_Samples_ET.mat, Present, 60, 4960832942, 5164110690, 203277748
/Volumes/methlab_data/HBN/EEG-ET/NDARGM240YJM/NDARGM240YJM_Video-WK_Samples_ET.mat, Diary, 60, 3343652606, 3461039622, 117387016
/Volumes/methlab_data/HBN/EEG-ET/NDARGM258RZU/NDARGM258RZU_Video-DM_Samples_ET.mat, Despicable, 60, 4386496746, 4557034164, 170537418
/Volumes/methlab_data/HBN/EEG-ET/NDARGM258RZU/NDARGM258RZU_Video-TP_Samples_ET.mat, Present, 60, 5300516969, 5503792510, 203275541
/Volumes/methlab_data/HBN/EEG-ET/NDARGM258RZU/NDARGM258RZU_Video-WK_Samples_ET.mat, Diary, 60, 4834211793, 4951597689, 117385896
/Volumes/methlab_data/HBN/EEG-ET/NDARGM269AVQ/NDARGM269AVQ_Video-WK_Samples_ET.mat, Diary, 60, 2340820301, 2458213400, 117393099
/Volumes/methlab_data/HBN/EEG-ET/NDARGM421YWQ/NDARGM421YWQ_Video-DM_Samples_ET.mat, Despicable, 60, 5112400283, 5282937807, 170537524
/Volumes/methlab_data/HBN/EEG-ET/NDARGM421YWQ/NDARGM421YWQ_Video-TP_Samples_ET.mat, Present, 60, 5588306594, 5791577383, 203270789
/Volumes/methlab_data/HBN/EEG-ET/NDARGM421YWQ/NDARGM421YWQ_Video-WK_Samples_ET.mat, Diary, 60, 3837230606, 3954623184, 117392578
/Volumes/methlab_data/HBN/EEG-ET/NDARGM439FZD/NDARGM439FZD_Video-DM_Samples_ET.mat, Despicable, 60, 4764992044, 4935530563, 170538519
/Volumes/methlab_data/HBN/EEG-ET/NDARGM439FZD/NDARGM439FZD_Video-FF_Samples_ET.mat, Fractals, 60, 4288534343, 4451518541, 162984198
/Volumes/methlab_data/HBN/EEG-ET/NDARGM439FZD/NDARGM439FZD_Video-TP_Samples_ET.mat, Present, 60, 5240673183, 5443735709, 203062526
/Volumes/methlab_data/HBN/EEG-ET/NDARGM439FZD/NDARGM439FZD_Video-WK_Samples_ET.mat, Diary, 60, 3641588199, 3758981172, 117392973
/Volumes/methlab_data/HBN/EEG-ET/NDARGM498YFL/NDARGM498YFL_Video1_Samples_ET.mat, Diary, 60, 3169035121, 3286427150, 117392029
/Volumes/methlab_data/HBN/EEG-ET/NDARGM498YFL/NDARGM498YFL_Video3_Samples_ET.mat, Despicable, 60, 2720426938, 2890971564, 170544626
/Volumes/methlab_data/HBN/EEG-ET/NDARGM540EV8/NDARGM540EV8_Video1_Samples_ET.mat, Diary, 60, 1304771090, 1422166965, 117395875
/Volumes/methlab_data/HBN/EEG-ET/NDARGM540EV8/NDARGM540EV8_Video3_Samples_ET.mat, Despicable, 60, 1084450551, 1254994032, 170543481
/Volumes/methlab_data/HBN/EEG-ET/NDARGM616DJC/NDARGM616DJC_Video-DM_Samples_ET.mat, Despicable, 60, 4469095734, 4639640399, 170544665
/Volumes/methlab_data/HBN/EEG-ET/NDARGM616DJC/NDARGM616DJC_Video-FF_Samples_ET.mat, Fractals, 60, 3971744754, 4134731071, 162986317
/Volumes/methlab_data/HBN/EEG-ET/NDARGM616DJC/NDARGM616DJC_Video-TP_Samples_ET.mat, Present, 60, 4998035980, 5201100697, 203064717
/Volumes/methlab_data/HBN/EEG-ET/NDARGM616DJC/NDARGM616DJC_Video-WK_Samples_ET.mat, Diary, 60, 3385944222, 3503338313, 117394091
/Volumes/methlab_data/HBN/EEG-ET/NDARGN148MK2/NDARGN148MK2_Video1_Samples_ET.mat, Diary, 60, 2881720080, 2999113077, 117392997
/Volumes/methlab_data/HBN/EEG-ET/NDARGN148MK2/NDARGN148MK2_Video3_Samples_ET.mat, Despicable, 60, 2435413690, 2605957253, 170543563
/Volumes/methlab_data/HBN/EEG-ET/NDARGN210CK7/NDARGN210CK7_Video-DM_Samples_ET.mat, Despicable, 60, 3399311718, 3569848070, 170536352
/Volumes/methlab_data/HBN/EEG-ET/NDARGN210CK7/NDARGN210CK7_Video-TP_Samples_ET.mat, Present, 60, 3609307909, 3812588343, 203280434
/Volumes/methlab_data/HBN/EEG-ET/NDARGN721GKT/NDARGN721GKT_Video-DM_Samples_ET.mat, Despicable, 120, 3453051953, 3623599269, 170547316
/Volumes/methlab_data/HBN/EEG-ET/NDARGN721GKT/NDARGN721GKT_Video-FF_Samples_ET.mat, Fractals, 120, 2727748050, 2890734149, 162986099
/Volumes/methlab_data/HBN/EEG-ET/NDARGN721GKT/NDARGN721GKT_Video-TP_Samples_ET.mat, Present, 120, 4469665651, 4672733366, 203067715
/Volumes/methlab_data/HBN/EEG-ET/NDARGN721GKT/NDARGN721GKT_Video-WK_Samples_ET.mat, Diary, 120, 3889780161, 4007176912, 117396751
/Volumes/methlab_data/HBN/EEG-ET/NDARGN782BZN/NDARGN782BZN_Video-DM_Samples_ET.mat, Despicable, 60, 3439505895, 3610043560, 170537665
/Volumes/methlab_data/HBN/EEG-ET/NDARGN782BZN/NDARGN782BZN_Video-TP_Samples_ET.mat, Present, 60, 4843080639, 5046350399, 203269760
/Volumes/methlab_data/HBN/EEG-ET/NDARGN782BZN/NDARGN782BZN_Video-WK_Samples_ET.mat, Diary, 60, 3930349051, 4047739123, 117390072
/Volumes/methlab_data/HBN/EEG-ET/NDARGP132PYA/NDARGP132PYA_Video-DM_Samples_ET.mat, Despicable, 120, 4276857507, 4447402589, 170545082
/Volumes/methlab_data/HBN/EEG-ET/NDARGP132PYA/NDARGP132PYA_Video-FF_Samples_ET.mat, Fractals, 120, 7325979719, 7488965665, 162985946
/Volumes/methlab_data/HBN/EEG-ET/NDARGP132PYA/NDARGP132PYA_Video-TP_Samples_ET.mat, Present, 120, 7937586513, 8140653557, 203067044
/Volumes/methlab_data/HBN/EEG-ET/NDARGP132PYA/NDARGP132PYA_Video-WK_Samples_ET.mat, Diary, 120, 6944964953, 7062354903, 117389950
/Volumes/methlab_data/HBN/EEG-ET/NDARGP191YHN/NDARGP191YHN_Video1_Samples_ET.mat, Diary, 60, 4938595695, 5055991389, 117395694
/Volumes/methlab_data/HBN/EEG-ET/NDARGP191YHN/NDARGP191YHN_Video2_Samples_ET.mat, Fractals, 60, 3744027735, 3907012008, 162984273
/Volumes/methlab_data/HBN/EEG-ET/NDARGP191YHN/NDARGP191YHN_Video3_Samples_ET.mat, Despicable, 60, 4503660484, 4674199106, 170538622
/Volumes/methlab_data/HBN/EEG-ET/NDARGP191YHN/NDARGP191YHN_Video4_Samples_ET.mat, Present, 60, 5368804452, 5571876305, 203071853
/Volumes/methlab_data/HBN/EEG-ET/NDARGP984YLN/NDARGP984YLN_Video-DM_Samples_ET.mat, Despicable, 120, 1945704456, 2116251787, 170547331
/Volumes/methlab_data/HBN/EEG-ET/NDARGP984YLN/NDARGP984YLN_Video-FF_Samples_ET.mat, Fractals, 120, 1729361356, 1892346290, 162984934
/Volumes/methlab_data/HBN/EEG-ET/NDARGP984YLN/NDARGP984YLN_Video-TP_Samples_ET.mat, Present, 120, 2165373323, 2368450282, 203076959
/Volumes/methlab_data/HBN/EEG-ET/NDARGP984YLN/NDARGP984YLN_Video-WK_Samples_ET.mat, Diary, 120, 1569386439, 1686773581, 117387142
/Volumes/methlab_data/HBN/EEG-ET/NDARGR106TJB/NDARGR106TJB_Video1_Samples_ET.mat, Diary, 120, 4089177533, 4206574414, 117396881
/Volumes/methlab_data/HBN/EEG-ET/NDARGR106TJB/NDARGR106TJB_Video2_Samples_ET.mat, Fractals, 120, 5457506600, 5620503675, 162997075
/Volumes/methlab_data/HBN/EEG-ET/NDARGR106TJB/NDARGR106TJB_Video3_Samples_ET.mat, Despicable, 120, 6188983744, 6359539136, 170555392
/Volumes/methlab_data/HBN/EEG-ET/NDARGR106TJB/NDARGR106TJB_Video4_Samples_ET.mat, Present, 120, 6734199034, 6937265654, 203066620
/Volumes/methlab_data/HBN/EEG-ET/NDARGR354WBH/NDARGR354WBH_Video1_Samples_ET.mat, Diary, 60, 1605961883, 1723356710, 117394827
/Volumes/methlab_data/HBN/EEG-ET/NDARGR354WBH/NDARGR354WBH_Video2_Samples_ET.mat, Fractals, 60, 2716860308, 2879854289, 162993981
/Volumes/methlab_data/HBN/EEG-ET/NDARGR354WBH/NDARGR354WBH_Video3_Samples_ET.mat, Despicable, 60, 2267529435, 2438068715, 170539280
/Volumes/methlab_data/HBN/EEG-ET/NDARGR354WBH/NDARGR354WBH_Video4_Samples_ET.mat, Present, 60, 3155896933, 3358966179, 203069246
/Volumes/methlab_data/HBN/EEG-ET/NDARGR358FGC/NDARGR358FGC_Video1_Samples_ET.mat, Diary, 120, 4615348086, 4732738262, 117390176
/Volumes/methlab_data/HBN/EEG-ET/NDARGR358FGC/NDARGR358FGC_Video2_Samples_ET.mat, Despicable, 120, 5724803095, 5895344552, 170541457
/Volumes/methlab_data/HBN/EEG-ET/NDARGR358FGC/NDARGR358FGC_Video3_Samples_ET.mat, Fractals, 120, 6315877713, 6478864350, 162986637
/Volumes/methlab_data/HBN/EEG-ET/NDARGR358FGC/NDARGR358FGC_Video4_Samples_ET.mat, Present, 120, 6997783704, 7200851221, 203067517
/Volumes/methlab_data/HBN/EEG-ET/NDARGR661YZG/NDARGR661YZG_Video1_Samples_ET.mat, Diary, 60, 2002414713, 2119803614, 117388901
/Volumes/methlab_data/HBN/EEG-ET/NDARGR661YZG/NDARGR661YZG_Video3_Samples_ET.mat, Despicable, 60, 1284518943, 1455068343, 170549400
/Volumes/methlab_data/HBN/EEG-ET/NDARGR893PUA/NDARGR893PUA_Video1_Samples_ET.mat, Diary, 60, 3668619870, 3786015731, 117395861
/Volumes/methlab_data/HBN/EEG-ET/NDARGR893PUA/NDARGR893PUA_Video2_Samples_ET.mat, Fractals, 60, 4316476994, 4479458998, 162982004
/Volumes/methlab_data/HBN/EEG-ET/NDARGR893PUA/NDARGR893PUA_Video3_Samples_ET.mat, Despicable, 60, 4746481406, 4917025751, 170544345
/Volumes/methlab_data/HBN/EEG-ET/NDARGR893PUA/NDARGR893PUA_Video4_Samples_ET.mat, Present, 60, 5217272578, 5420422916, 203150338
/Volumes/methlab_data/HBN/EEG-ET/NDARGT022BEW/NDARGT022BEW_Video1_Samples_ET.mat, Diary, 60, 764857948, 882253045, 117395097
/Volumes/methlab_data/HBN/EEG-ET/NDARGT267UZR/NDARGT267UZR_Video1_Samples_ET.mat, Diary, 60, 1990767182, 2108161184, 117394002
/Volumes/methlab_data/HBN/EEG-ET/NDARGT267UZR/NDARGT267UZR_Video3_Samples_ET.mat, Despicable, 60, 3125941720, 3296492326, 170550606
/Volumes/methlab_data/HBN/EEG-ET/NDARGT551AFK/NDARGT551AFK_Video1_Samples_ET.mat, Diary, 120, 3245621251, 3363009314, 117388063
/Volumes/methlab_data/HBN/EEG-ET/NDARGT551AFK/NDARGT551AFK_Video2_Samples_ET.mat, Fractals, 120, 3900986892, 4063974181, 162987289
/Volumes/methlab_data/HBN/EEG-ET/NDARGT551AFK/NDARGT551AFK_Video3_Samples_ET.mat, Despicable, 120, 4441514320, 4612061092, 170546772
/Volumes/methlab_data/HBN/EEG-ET/NDARGT551AFK/NDARGT551AFK_Video4_Samples_ET.mat, Present, 120, 5130109516, 5333177137, 203067621
/Volumes/methlab_data/HBN/EEG-ET/NDARGT634DUJ/NDARGT634DUJ_Video-DM_Samples_ET.mat, Despicable, 60, 3337217404, 3507759912, 170542508
/Volumes/methlab_data/HBN/EEG-ET/NDARGT634DUJ/NDARGT634DUJ_Video-FF_Samples_ET.mat, Fractals, 60, 2451745681, 2614731869, 162986188
/Volumes/methlab_data/HBN/EEG-ET/NDARGT634DUJ/NDARGT634DUJ_Video-TP_Samples_ET.mat, Present, 60, 4221593331, 4424662885, 203069554
/Volumes/methlab_data/HBN/EEG-ET/NDARGT634DUJ/NDARGT634DUJ_Video-WK_Samples_ET.mat, Diary, 60, 3789238835, 3906631809, 117392974
/Volumes/methlab_data/HBN/EEG-ET/NDARGT682ZWN/NDARGT682ZWN_Video1_Samples_ET.mat, Diary, 60, 10434858925, 10552247726, 117388801
/Volumes/methlab_data/HBN/EEG-ET/NDARGT682ZWN/NDARGT682ZWN_Video3_Samples_ET.mat, Despicable, 60, 10799011639, 10969559889, 170548250
/Volumes/methlab_data/HBN/EEG-ET/NDARGU067HT7/NDARGU067HT7_Video-DM_Samples_ET.mat, Despicable, 60, 4990231553, 5160768088, 170536535
/Volumes/methlab_data/HBN/EEG-ET/NDARGU067HT7/NDARGU067HT7_Video-TP_Samples_ET.mat, Present, 60, 5788621735, 5991901411, 203279676
/Volumes/methlab_data/HBN/EEG-ET/NDARGU067HT7/NDARGU067HT7_Video-WK_Samples_ET.mat, Diary, 60, 5419054582, 5536443552, 117388970
/Volumes/methlab_data/HBN/EEG-ET/NDARGU126KC2/NDARGU126KC2_Video-DM_Samples_ET.mat, Despicable, 30, 5004420193, 5174956548, 170536355
/Volumes/methlab_data/HBN/EEG-ET/NDARGU126KC2/NDARGU126KC2_Video-TP_Samples_ET.mat, Present, 30, 5904790477, 6108057927, 203267450
/Volumes/methlab_data/HBN/EEG-ET/NDARGU126KC2/NDARGU126KC2_Video-WK_Samples_ET.mat, Diary, 30, 5492836811, 5610223658, 117386847
/Volumes/methlab_data/HBN/EEG-ET/NDARGU182ELW/NDARGU182ELW_Video-DM_Samples_ET.mat, Despicable, 120, 5469707906, 5640250734, 170542828
/Volumes/methlab_data/HBN/EEG-ET/NDARGU182ELW/NDARGU182ELW_Video-FF_Samples_ET.mat, Fractals, 120, 4742940346, 4905926606, 162986260
/Volumes/methlab_data/HBN/EEG-ET/NDARGU182ELW/NDARGU182ELW_Video-TP_Samples_ET.mat, Present, 120, 6578507354, 6781575043, 203067689
/Volumes/methlab_data/HBN/EEG-ET/NDARGU182ELW/NDARGU182ELW_Video-WK_Samples_ET.mat, Diary, 120, 5898442517, 6015839577, 117397060
/Volumes/methlab_data/HBN/EEG-ET/NDARGU271CPG/NDARGU271CPG_Video-DM_Samples_ET.mat, Despicable, 120, 4808287189, 4978834757, 170547568
/Volumes/methlab_data/HBN/EEG-ET/NDARGU271CPG/NDARGU271CPG_Video-FF_Samples_ET.mat, Fractals, 120, 4233070616, 4396058023, 162987407
/Volumes/methlab_data/HBN/EEG-ET/NDARGU271CPG/NDARGU271CPG_Video-TP_Samples_ET.mat, Present, 120, 5493463822, 5696531062, 203067240
/Volumes/methlab_data/HBN/EEG-ET/NDARGU271CPG/NDARGU271CPG_Video-WK_Samples_ET.mat, Diary, 120, 3396066657, 3513463312, 117396655
/Volumes/methlab_data/HBN/EEG-ET/NDARGU395RFP/NDARGU395RFP_Video1_Samples_ET.mat, Diary, 60, 3451817569, 3569209621, 117392052
/Volumes/methlab_data/HBN/EEG-ET/NDARGU395RFP/NDARGU395RFP_Video2_Samples_ET.mat, Fractals, 60, 4143791965, 4306785276, 162993311
/Volumes/methlab_data/HBN/EEG-ET/NDARGU395RFP/NDARGU395RFP_Video3_Samples_ET.mat, Despicable, 60, 4563540855, 4734081494, 170540639
/Volumes/methlab_data/HBN/EEG-ET/NDARGU395RFP/NDARGU395RFP_Video4_Samples_ET.mat, Present, 60, 5056995868, 5260053486, 203057618
/Volumes/methlab_data/HBN/EEG-ET/NDARGU485JJA/NDARGU485JJA_Video1_Samples_ET.mat, Diary, 60, 6266638149, 6384032896, 117394747
/Volumes/methlab_data/HBN/EEG-ET/NDARGU485JJA/NDARGU485JJA_Video3_Samples_ET.mat, Despicable, 60, 6654068146, 6824608305, 170540159
/Volumes/methlab_data/HBN/EEG-ET/NDARGU667MCK/NDARGU667MCK_Video1_Samples_ET.mat, Diary, 60, 3164732207, 3282128211, 117396004
/Volumes/methlab_data/HBN/EEG-ET/NDARGU667MCK/NDARGU667MCK_Video3_Samples_ET.mat, Despicable, 60, 2941302230, 3111846812, 170544582
/Volumes/methlab_data/HBN/EEG-ET/NDARGU729WUR/NDARGU729WUR_Video1_Samples_ET.mat, Diary, 60, 3923393197, 4040787229, 117394032
/Volumes/methlab_data/HBN/EEG-ET/NDARGU729WUR/NDARGU729WUR_Video3_Samples_ET.mat, Despicable, 60, 4333629337, 4504170972, 170541635
/Volumes/methlab_data/HBN/EEG-ET/NDARGU829GZ4/NDARGU829GZ4_Video-DM_Samples_ET.mat, Despicable, 60, 4590832788, 4761383353, 170550565
/Volumes/methlab_data/HBN/EEG-ET/NDARGU829GZ4/NDARGU829GZ4_Video-TP_Samples_ET.mat, Present, 60, 5598083601, 5801354230, 203270629
/Volumes/methlab_data/HBN/EEG-ET/NDARGU829GZ4/NDARGU829GZ4_Video-WK_Samples_ET.mat, Diary, 60, 2941700432, 3059097422, 117396990
/Volumes/methlab_data/HBN/EEG-ET/NDARGV263ZRY/NDARGV263ZRY_Video-DM_Samples_ET.mat, Despicable, 60, 4216749192, 4387285482, 170536290
/Volumes/methlab_data/HBN/EEG-ET/NDARGV263ZRY/NDARGV263ZRY_Video-TP_Samples_ET.mat, Present, 60, 5124918645, 5328184018, 203265373
/Volumes/methlab_data/HBN/EEG-ET/NDARGV263ZRY/NDARGV263ZRY_Video-WK_Samples_ET.mat, Diary, 60, 4690512297, 4807903113, 117390816
/Volumes/methlab_data/HBN/EEG-ET/NDARGV436PFT/NDARGV436PFT_Video1_Samples_ET.mat, Diary, 60, 3574798143, 3692186311, 117388168
/Volumes/methlab_data/HBN/EEG-ET/NDARGV436PFT/NDARGV436PFT_Video2_Samples_ET.mat, Fractals, 60, 4072464509, 4235458936, 162994427
/Volumes/methlab_data/HBN/EEG-ET/NDARGV436PFT/NDARGV436PFT_Video3_Samples_ET.mat, Despicable, 60, 4495412959, 4665965715, 170552756
/Volumes/methlab_data/HBN/EEG-ET/NDARGV436PFT/NDARGV436PFT_Video4_Samples_ET.mat, Present, 60, 4993226425, 5196300183, 203073758
/Volumes/methlab_data/HBN/EEG-ET/NDARGV455JV1/NDARGV455JV1_Video-DM_Samples_ET.mat, Despicable, 30, 3320593157, 3491130917, 170537760
/Volumes/methlab_data/HBN/EEG-ET/NDARGV455JV1/NDARGV455JV1_Video-TP_Samples_ET.mat, Present, 30, 4218075562, 4421344490, 203268928
/Volumes/methlab_data/HBN/EEG-ET/NDARGV455JV1/NDARGV455JV1_Video-WK_Samples_ET.mat, Diary, 30, 3788558478, 3905947609, 117389131
/Volumes/methlab_data/HBN/EEG-ET/NDARGV948BFZ/NDARGV948BFZ_Video1_Samples_ET.mat, Diary, 60, 4942545396, 5059941414, 117396018
/Volumes/methlab_data/HBN/EEG-ET/NDARGV948BFZ/NDARGV948BFZ_Video2_Samples_ET.mat, Fractals, 60, 3599242713, 3762224914, 162982201
/Volumes/methlab_data/HBN/EEG-ET/NDARGV948BFZ/NDARGV948BFZ_Video3_Samples_ET.mat, Despicable, 60, 4455573129, 4626115691, 170542562
/Volumes/methlab_data/HBN/EEG-ET/NDARGV948BFZ/NDARGV948BFZ_Video4_Samples_ET.mat, Present, 60, 5367351736, 5570423341, 203071605
/Volumes/methlab_data/HBN/EEG-ET/NDARGV956EGX/NDARGV956EGX_Video1_Samples_ET.mat, Diary, 60, 3288749138, 3406135233, 117386095
/Volumes/methlab_data/HBN/EEG-ET/NDARGV956EGX/NDARGV956EGX_Video3_Samples_ET.mat, Despicable, 60, 2856174038, 3026722737, 170548699
/Volumes/methlab_data/HBN/EEG-ET/NDARGW180RV4/NDARGW180RV4_Video-DM_Samples_ET.mat, Despicable, 30, 3885886968, 4056424221, 170537253
/Volumes/methlab_data/HBN/EEG-ET/NDARGW180RV4/NDARGW180RV4_Video-TP_Samples_ET.mat, Present, 30, 4740007092, 4943272392, 203265300
/Volumes/methlab_data/HBN/EEG-ET/NDARGW180RV4/NDARGW180RV4_Video-WK_Samples_ET.mat, Diary, 30, 4318082671, 4435470430, 117387759
/Volumes/methlab_data/HBN/EEG-ET/NDARGW249GEJ/NDARGW249GEJ_Video-DM_Samples_ET.mat, Despicable, 120, 4145468857, 4316015501, 170546644
/Volumes/methlab_data/HBN/EEG-ET/NDARGW249GEJ/NDARGW249GEJ_Video-FF_Samples_ET.mat, Fractals, 120, 3948558808, 4111546191, 162987383
/Volumes/methlab_data/HBN/EEG-ET/NDARGW249GEJ/NDARGW249GEJ_Video-TP_Samples_ET.mat, Present, 120, 4769733494, 4972800945, 203067451
/Volumes/methlab_data/HBN/EEG-ET/NDARGW249GEJ/NDARGW249GEJ_Video-WK_Samples_ET.mat, Diary, 120, 3465472504, 3582860190, 117387686
/Volumes/methlab_data/HBN/EEG-ET/NDARGW362UJZ/NDARGW362UJZ_Video1_Samples_ET.mat, Diary, 60, 4228845563, 4346239519, 117393956
/Volumes/methlab_data/HBN/EEG-ET/NDARGW362UJZ/NDARGW362UJZ_Video3_Samples_ET.mat, Despicable, 60, 3979933756, 4150476223, 170542467
/Volumes/methlab_data/HBN/EEG-ET/NDARGW404GJL/NDARGW404GJL_Video1_Samples_ET.mat, Diary, 60, 11605027546, 11722421581, 117394035
/Volumes/methlab_data/HBN/EEG-ET/NDARGW404GJL/NDARGW404GJL_Video3_Samples_ET.mat, Despicable, 60, 11206659785, 11377206435, 170546650
/Volumes/methlab_data/HBN/EEG-ET/NDARGW450YUX/NDARGW450YUX_Video-DM_Samples_ET.mat, Despicable, 60, 4553261653, 4723809285, 170547632
/Volumes/methlab_data/HBN/EEG-ET/NDARGW450YUX/NDARGW450YUX_Video-TP_Samples_ET.mat, Present, 60, 5087674623, 5290953409, 203278786
/Volumes/methlab_data/HBN/EEG-ET/NDARGW450YUX/NDARGW450YUX_Video-WK_Samples_ET.mat, Diary, 60, 3720920965, 3838307007, 117386042
/Volumes/methlab_data/HBN/EEG-ET/NDARGX001CB1/NDARGX001CB1_Video1_Samples_ET.mat, Fractals, 120, 3468688229, 3631675031, 162986802
/Volumes/methlab_data/HBN/EEG-ET/NDARGX001CB1/NDARGX001CB1_Video2_Samples_ET.mat, Diary, 120, 4756970156, 4874366270, 117396114
/Volumes/methlab_data/HBN/EEG-ET/NDARGX001CB1/NDARGX001CB1_Video3_Samples_ET.mat, Despicable, 120, 5235876221, 5406422562, 170546341
/Volumes/methlab_data/HBN/EEG-ET/NDARGX001CB1/NDARGX001CB1_Video4_Samples_ET.mat, Present, 120, 5960180944, 6163248647, 203067703
/Volumes/methlab_data/HBN/EEG-ET/NDARGX161LRM/NDARGX161LRM_Video-DM_Samples_ET.mat, Despicable, 60, 651099437, 821638345, 170538908
/Volumes/methlab_data/HBN/EEG-ET/NDARGX161LRM/NDARGX161LRM_Video-TP_Samples_ET.mat, Present, 60, 2225043425, 2428312296, 203268871
/Volumes/methlab_data/HBN/EEG-ET/NDARGX161LRM/NDARGX161LRM_Video-WK_Samples_ET.mat, Diary, 60, 1435979079, 1553368169, 117389090
/Volumes/methlab_data/HBN/EEG-ET/NDARGX173AC3/NDARGX173AC3_Video1_Samples_ET.mat, Diary, 120, 3116531187, 3233919508, 117388321
/Volumes/methlab_data/HBN/EEG-ET/NDARGX173AC3/NDARGX173AC3_Video2_Samples_ET.mat, Fractals, 120, 4875901600, 5038889211, 162987611
/Volumes/methlab_data/HBN/EEG-ET/NDARGX173AC3/NDARGX173AC3_Video3_Samples_ET.mat, Despicable, 120, 5345944322, 5516488652, 170544330
/Volumes/methlab_data/HBN/EEG-ET/NDARGX173AC3/NDARGX173AC3_Video4_Samples_ET.mat, Present, 120, 5985925977, 6188992062, 203066085
/Volumes/methlab_data/HBN/EEG-ET/NDARGX443CEU/NDARGX443CEU_Video1_Samples_ET.mat, Diary, 60, 3688019403, 3805416350, 117396947
/Volumes/methlab_data/HBN/EEG-ET/NDARGX443CEU/NDARGX443CEU_Video3_Samples_ET.mat, Despicable, 60, 3264913381, 3435464917, 170551536
/Volumes/methlab_data/HBN/EEG-ET/NDARGX443CEU/NDARGX443CEU_Video4_Samples_ET.mat, Present, 60, 4122309250, 4325370777, 203061527
/Volumes/methlab_data/HBN/EEG-ET/NDARGX583YNZ/NDARGX583YNZ_Video1_Samples_ET.mat, Diary, 120, 2191392444, 2308789538, 117397094
/Volumes/methlab_data/HBN/EEG-ET/NDARGX583YNZ/NDARGX583YNZ_Video2_Samples_ET.mat, Fractals, 120, 2879487732, 3042474555, 162986823
/Volumes/methlab_data/HBN/EEG-ET/NDARGX583YNZ/NDARGX583YNZ_Video3_Samples_ET.mat, Despicable, 120, 3351884480, 3522431916, 170547436
/Volumes/methlab_data/HBN/EEG-ET/NDARGX760NYV/NDARGX760NYV_Video1_Samples_ET.mat, Diary, 60, 4342088470, 4459480530, 117392060
/Volumes/methlab_data/HBN/EEG-ET/NDARGX760NYV/NDARGX760NYV_Video2_Samples_ET.mat, Fractals, 60, 5615366039, 5778356331, 162990292
/Volumes/methlab_data/HBN/EEG-ET/NDARGX760NYV/NDARGX760NYV_Video3_Samples_ET.mat, Despicable, 60, 5175526939, 5346070595, 170543656
/Volumes/methlab_data/HBN/EEG-ET/NDARGX760NYV/NDARGX760NYV_Video4_Samples_ET.mat, Present, 60, 6082057110, 6285129767, 203072657
/Volumes/methlab_data/HBN/EEG-ET/NDARGY054ENV/NDARGY054ENV_Video1_Samples_ET.mat, Diary, 60, 3498987832, 3616385855, 117398023
/Volumes/methlab_data/HBN/EEG-ET/NDARGY054ENV/NDARGY054ENV_Video3_Samples_ET.mat, Despicable, 60, 4806929550, 4977470120, 170540570
/Volumes/methlab_data/HBN/EEG-ET/NDARGY148EVU/NDARGY148EVU_Video1_Samples_ET.mat, Diary, 60, 1840543677, 1957940758, 117397081
/Volumes/methlab_data/HBN/EEG-ET/NDARGY148EVU/NDARGY148EVU_Video3_Samples_ET.mat, Despicable, 60, 3027878847, 3198433780, 170554933
/Volumes/methlab_data/HBN/EEG-ET/NDARGY542TJ5/NDARGY542TJ5_Video1_Samples_ET.mat, Diary, 60, 2285848568, 2403250722, 117402154
/Volumes/methlab_data/HBN/EEG-ET/NDARGY542TJ5/NDARGY542TJ5_Video2_Samples_ET.mat, Fractals, 60, 2442852727, 2605841149, 162988422
/Volumes/methlab_data/HBN/EEG-ET/NDARGY542TJ5/NDARGY542TJ5_Video3_Samples_ET.mat, Despicable, 60, 2077128806, 2247677618, 170548812
/Volumes/methlab_data/HBN/EEG-ET/NDARGY542TJ5/NDARGY542TJ5_Video4_Samples_ET.mat, Present, 60, 2645295051, 2848362850, 203067799
/Volumes/methlab_data/HBN/EEG-ET/NDARGY559UL3/NDARGY559UL3_Video-DM_Samples_ET.mat, Despicable, 60, 4909785267, 5080330750, 170545483
/Volumes/methlab_data/HBN/EEG-ET/NDARGY559UL3/NDARGY559UL3_Video-FF_Samples_ET.mat, Fractals, 60, 5357130227, 5520124369, 162994142
/Volumes/methlab_data/HBN/EEG-ET/NDARGY559UL3/NDARGY559UL3_Video-TP_Samples_ET.mat, Present, 60, 5843614848, 6046674282, 203059434
/Volumes/methlab_data/HBN/EEG-ET/NDARGY559UL3/NDARGY559UL3_Video-WK_Samples_ET.mat, Diary, 60, 4316648337, 4434041279, 117392942
/Volumes/methlab_data/HBN/EEG-ET/NDARGY580WWL/NDARGY580WWL_Video1_Samples_ET.mat, Diary, 60, 50683008218, 50800405204, 117396986
/Volumes/methlab_data/HBN/EEG-ET/NDARGY580WWL/NDARGY580WWL_Video3_Samples_ET.mat, Despicable, 60, 50158425530, 50328968069, 170542539
/Volumes/methlab_data/HBN/EEG-ET/NDARGY580WWL/NDARGY580WWL_Video4_Samples_ET.mat, Present, 60, 51089753652, 51292914221, 203160569
/Volumes/methlab_data/HBN/EEG-ET/NDARGY639ANB/NDARGY639ANB_Video-DM_Samples_ET.mat, Despicable, 30, 5205878232, 5376416476, 170538244
/Volumes/methlab_data/HBN/EEG-ET/NDARGY639ANB/NDARGY639ANB_Video-TP_Samples_ET.mat, Present, 30, 5748571806, 5951848126, 203276320
/Volumes/methlab_data/HBN/EEG-ET/NDARGY639ANB/NDARGY639ANB_Video-WK_Samples_ET.mat, Diary, 30, 4112981792, 4230369562, 117387770
/Volumes/methlab_data/HBN/EEG-ET/NDARGY959RN8/NDARGY959RN8_Video-DM_Samples_ET.mat, Despicable, 120, 5694440413, 5864986375, 170545962
/Volumes/methlab_data/HBN/EEG-ET/NDARGY959RN8/NDARGY959RN8_Video-FF_Samples_ET.mat, Fractals, 120, 4312380510, 4701596790, 4864583414
5.522029e+08, 1.629866e+08, /Volumes/methlab_data/HBN/EEG-ET/NDARGY959RN8/NDARGY959RN8_Video-TP_Samples_ET.mat, Present, 120, 6891661581, 7094728427, 203066846
/Volumes/methlab_data/HBN/EEG-ET/NDARGY959RN8/NDARGY959RN8_Video-WK_Samples_ET.mat, Diary, 120, 6095157327, 6212554164, 117396837
/Volumes/methlab_data/HBN/EEG-ET/NDARGZ038DRL/NDARGZ038DRL_Video1_Samples_ET.mat, Despicable, 120, 4561116888, 4731663636, 170546748
/Volumes/methlab_data/HBN/EEG-ET/NDARGZ038DRL/NDARGZ038DRL_Video2_Samples_ET.mat, Diary, 120, 6596602147, 6714000528, 117398381
/Volumes/methlab_data/HBN/EEG-ET/NDARGZ038DRL/NDARGZ038DRL_Video3_Samples_ET.mat, Fractals, 120, 6734141171, 6897138831, 162997660
/Volumes/methlab_data/HBN/EEG-ET/NDARGZ038DRL/NDARGZ038DRL_Video4_Samples_ET.mat, Present, 120, 7403138095, 7606214576, 203076481
/Volumes/methlab_data/HBN/EEG-ET/NDARGZ059UVR/NDARGZ059UVR_Video1_Samples_ET.mat, Diary, 60, 6769618914, 6887015406, 117396492
/Volumes/methlab_data/HBN/EEG-ET/NDARGZ059UVR/NDARGZ059UVR_Video3_Samples_ET.mat, Despicable, 60, 6347529647, 6518072971, 170543324
/Volumes/methlab_data/HBN/EEG-ET/NDARGZ059UVR/NDARGZ059UVR_Video4_Samples_ET.mat, Present, 60, 7183647426, 7386709919, 203062493
/Volumes/methlab_data/HBN/EEG-ET/NDARGZ116HTR/NDARGZ116HTR_Video-WK_Samples_ET.mat, Diary, 60, 4993763351, 5111153286, 117389935
/Volumes/methlab_data/HBN/EEG-ET/NDARGZ207NNA/NDARGZ207NNA_Video1_Samples_ET.mat, Diary, 60, 5332667335, 5450068228, 117400893
/Volumes/methlab_data/HBN/EEG-ET/NDARGZ207NNA/NDARGZ207NNA_Video2_Samples_ET.mat, Fractals, 60, 4139174799, 4302162896, 162988097
/Volumes/methlab_data/HBN/EEG-ET/NDARGZ207NNA/NDARGZ207NNA_Video3_Samples_ET.mat, Despicable, 60, 4897537362, 5068084578, 170547216
/Volumes/methlab_data/HBN/EEG-ET/NDARGZ207NNA/NDARGZ207NNA_Video4_Samples_ET.mat, Present, 60, 5770805648, 5973869006, 203063358
/Volumes/methlab_data/HBN/EEG-ET/NDARGZ282DLD/NDARGZ282DLD_Video1_Samples_ET.mat, Fractals, 120, 4507494213, 4670482093, 162987880
/Volumes/methlab_data/HBN/EEG-ET/NDARGZ282DLD/NDARGZ282DLD_Video2_Samples_ET.mat, Despicable, 120, 5513787737, 5684329845, 170542108
/Volumes/methlab_data/HBN/EEG-ET/NDARGZ282DLD/NDARGZ282DLD_Video3_Samples_ET.mat, Diary, 120, 6074568482, 6191962068, 117393586
/Volumes/methlab_data/HBN/EEG-ET/NDARGZ282DLD/NDARGZ282DLD_Video4_Samples_ET.mat, Present, 120, 6767000735, 6970069312, 203068577
/Volumes/methlab_data/HBN/EEG-ET/NDARGZ361JJ9/NDARGZ361JJ9_Video1_Samples_ET.mat, Diary, 120, 2539292656, 2656681117, 117388461
/Volumes/methlab_data/HBN/EEG-ET/NDARGZ361JJ9/NDARGZ361JJ9_Video2_Samples_ET.mat, Fractals, 120, 3165583443, 3328580053, 162996610
/Volumes/methlab_data/HBN/EEG-ET/NDARGZ361JJ9/NDARGZ361JJ9_Video3_Samples_ET.mat, Despicable, 120, 3636661293, 3807208373, 170547080
/Volumes/methlab_data/HBN/EEG-ET/NDARGZ361JJ9/NDARGZ361JJ9_Video4_Samples_ET.mat, Present, 120, 4205176291, 4408238609, 203062318
/Volumes/methlab_data/HBN/EEG-ET/NDARHA387FPM/NDARHA387FPM_Video1_Samples_ET.mat, Diary, 60, 3249266442, 3366661428, 117394986
/Volumes/methlab_data/HBN/EEG-ET/NDARHA387FPM/NDARHA387FPM_Video3_Samples_ET.mat, Despicable, 60, 2773883525, 2944431055, 170547530
/Volumes/methlab_data/HBN/EEG-ET/NDARHA780UYE/NDARHA780UYE_Video-WK_Samples_ET.mat, Diary, 60, 4474669631, 4592063534, 117393903
/Volumes/methlab_data/HBN/EEG-ET/NDARHB000YF8/NDARHB000YF8_Video1_Samples_ET.mat, Diary, 120, 4203529356, 4320925495, 117396139
/Volumes/methlab_data/HBN/EEG-ET/NDARHB000YF8/NDARHB000YF8_Video2_Samples_ET.mat, Fractals, 120, 5702547432, 5865534884, 162987452
/Volumes/methlab_data/HBN/EEG-ET/NDARHB000YF8/NDARHB000YF8_Video3_Samples_ET.mat, Despicable, 120, 6237145897, 6407691996, 170546099
/Volumes/methlab_data/HBN/EEG-ET/NDARHB261JMG/NDARHB261JMG_Video-DM_Samples_ET.mat, Despicable, 30, 4763647368, 4934184773, 170537405
/Volumes/methlab_data/HBN/EEG-ET/NDARHB261JMG/NDARHB261JMG_Video-TP_Samples_ET.mat, Present, 30, 5283122085, 5486399602, 203277517
/Volumes/methlab_data/HBN/EEG-ET/NDARHB261JMG/NDARHB261JMG_Video-WK_Samples_ET.mat, Diary, 30, 3673587854, 3790975740, 117387886
/Volumes/methlab_data/HBN/EEG-ET/NDARHB764VZ2/NDARHB764VZ2_Video1_Samples_ET.mat, Diary, 60, 4937198246, 5054589990, 117391744
/Volumes/methlab_data/HBN/EEG-ET/NDARHB764VZ2/NDARHB764VZ2_Video3_Samples_ET.mat, Despicable, 60, 4401913108, 4572464245, 170551137
/Volumes/methlab_data/HBN/EEG-ET/NDARHB772TE5/NDARHB772TE5_Video1_Samples_ET.mat, Diary, 120, 3033699719, 3151097233, 117397514
/Volumes/methlab_data/HBN/EEG-ET/NDARHB772TE5/NDARHB772TE5_Video2_Samples_ET.mat, Despicable, 120, 5320674561, 5491221672, 170547111
/Volumes/methlab_data/HBN/EEG-ET/NDARHB772TE5/NDARHB772TE5_Video3_Samples_ET.mat, Fractals, 120, 5884891023, 6047877954, 162986931
/Volumes/methlab_data/HBN/EEG-ET/NDARHB993EV0/NDARHB993EV0_Video1_Samples_ET.mat, Diary, 60, 3454770750, 3572166715, 117395965
/Volumes/methlab_data/HBN/EEG-ET/NDARHB993EV0/NDARHB993EV0_Video3_Samples_ET.mat, Despicable, 60, 3010815019, 3181358566, 170543547
/Volumes/methlab_data/HBN/EEG-ET/NDARHC287ZF4/NDARHC287ZF4_Video1_Samples_ET.mat, Fractals, 120, 4029702949, 4192688986, 162986037
/Volumes/methlab_data/HBN/EEG-ET/NDARHC287ZF4/NDARHC287ZF4_Video2_Samples_ET.mat, Despicable, 120, 4221400459, 4391948098, 170547639
/Volumes/methlab_data/HBN/EEG-ET/NDARHC287ZF4/NDARHC287ZF4_Video3_Samples_ET.mat, Diary, 120, 4791677624, 4909065294, 117387670
/Volumes/methlab_data/HBN/EEG-ET/NDARHC426PAW/NDARHC426PAW_Video-DM_Samples_ET.mat, Despicable, 30, 2931047717, 3101585238, 170537521
/Volumes/methlab_data/HBN/EEG-ET/NDARHC426PAW/NDARHC426PAW_Video-TP_Samples_ET.mat, Present, 30, 3922749501, 4126027156, 203277655
/Volumes/methlab_data/HBN/EEG-ET/NDARHC426PAW/NDARHC426PAW_Video-WK_Samples_ET.mat, Diary, 30, 2573962368, 2691350341, 117387973
/Volumes/methlab_data/HBN/EEG-ET/NDARHC453LC1/NDARHC453LC1_Video1_Samples_ET.mat, Diary, 60, 3344168266, 3461563099, 117394833
/Volumes/methlab_data/HBN/EEG-ET/NDARHC453LC1/NDARHC453LC1_Video2_Samples_ET.mat, Fractals, 60, 2284836816, 2447830818, 162994002
/Volumes/methlab_data/HBN/EEG-ET/NDARHC453LC1/NDARHC453LC1_Video3_Samples_ET.mat, Despicable, 60, 2901055598, 3071597960, 170542362
/Volumes/methlab_data/HBN/EEG-ET/NDARHC453LC1/NDARHC453LC1_Video4_Samples_ET.mat, Present, 60, 3778415721, 3981483944, 203068223
/Volumes/methlab_data/HBN/EEG-ET/NDARHC462NGR/NDARHC462NGR_Video1_Samples_ET.mat, Diary, 120, 3383656414, 3501043319, 117386905
/Volumes/methlab_data/HBN/EEG-ET/NDARHC462NGR/NDARHC462NGR_Video2_Samples_ET.mat, Fractals, 120, 3544605687, 3707592847, 162987160
/Volumes/methlab_data/HBN/EEG-ET/NDARHC462NGR/NDARHC462NGR_Video3_Samples_ET.mat, Despicable, 120, 3752884657, 3923432414, 170547757
/Volumes/methlab_data/HBN/EEG-ET/NDARHC462NGR/NDARHC462NGR_Video4_Samples_ET.mat, Present, 120, 3976483511, 4179550196, 203066685
/Volumes/methlab_data/HBN/EEG-ET/NDARHC661KGK/NDARHC661KGK_Video-DM_Samples_ET.mat, Despicable, 120, 4283719594, 4454267185, 170547591
/Volumes/methlab_data/HBN/EEG-ET/NDARHC661KGK/NDARHC661KGK_Video-FF_Samples_ET.mat, Fractals, 120, 4769957553, 4932944285, 162986732
/Volumes/methlab_data/HBN/EEG-ET/NDARHC661KGK/NDARHC661KGK_Video-TP_Samples_ET.mat, Present, 120, 5452413668, 5655490315, 203076647
/Volumes/methlab_data/HBN/EEG-ET/NDARHC661KGK/NDARHC661KGK_Video-WK_Samples_ET.mat, Diary, 120, 3072939213, 3190328526, 117389313
/Volumes/methlab_data/HBN/EEG-ET/NDARHC735FJF/NDARHC735FJF_Video-DM_Samples_ET.mat, Despicable, 120, 6045042777, 6215590157, 170547380
/Volumes/methlab_data/HBN/EEG-ET/NDARHC735FJF/NDARHC735FJF_Video-FF_Samples_ET.mat, Fractals, 120, 5471293155, 5634280408, 162987253
/Volumes/methlab_data/HBN/EEG-ET/NDARHC735FJF/NDARHC735FJF_Video-TP_Samples_ET.mat, Present, 120, 7094926824, 7297994599, 203067775
/Volumes/methlab_data/HBN/EEG-ET/NDARHC735FJF/NDARHC735FJF_Video-WK_Samples_ET.mat, Diary, 120, 6492496261, 6609890319, 117394058
/Volumes/methlab_data/HBN/EEG-ET/NDARHC737MHK/NDARHC737MHK_Video1_Samples_ET.mat, Diary, 120, 3938879357, 4056276653, 117397296
/Volumes/methlab_data/HBN/EEG-ET/NDARHC737MHK/NDARHC737MHK_Video2_Samples_ET.mat, Fractals, 120, 5025050673, 5188038869, 162988196
/Volumes/methlab_data/HBN/EEG-ET/NDARHC737MHK/NDARHC737MHK_Video3_Samples_ET.mat, Despicable, 120, 5471168951, 5641716175, 170547224
/Volumes/methlab_data/HBN/EEG-ET/NDARHC814ZZL/NDARHC814ZZL_Video-DM_Samples_ET.mat, Despicable, 120, 3077812960, 3248352176, 170539216
/Volumes/methlab_data/HBN/EEG-ET/NDARHC814ZZL/NDARHC814ZZL_Video-FF_Samples_ET.mat, Fractals, 120, 2624473837, 2787461256, 162987419
/Volumes/methlab_data/HBN/EEG-ET/NDARHC814ZZL/NDARHC814ZZL_Video-TP_Samples_ET.mat, Present, 120, 3716142957, 3919208021, 203065064
/Volumes/methlab_data/HBN/EEG-ET/NDARHC814ZZL/NDARHC814ZZL_Video-WK_Samples_ET.mat, Diary, 120, 1968219114, 2085616579, 117397465
/Volumes/methlab_data/HBN/EEG-ET/NDARHC825ZFZ/NDARHC825ZFZ_Video1_Samples_ET.mat, Diary, 60, 4786358980, 4903754091, 117395111
/Volumes/methlab_data/HBN/EEG-ET/NDARHC825ZFZ/NDARHC825ZFZ_Video3_Samples_ET.mat, Despicable, 60, 4964540073, 5135080784, 170540711
/Volumes/methlab_data/HBN/EEG-ET/NDARHC825ZFZ/NDARHC825ZFZ_Video4_Samples_ET.mat, Present, 60, 5443266822, 5646327543, 203060721
/Volumes/methlab_data/HBN/EEG-ET/NDARHD017XEU/NDARHD017XEU_Video-DM_Samples_ET.mat, Despicable, 60, 5902339249, 6072879663, 170540414
/Volumes/methlab_data/HBN/EEG-ET/NDARHD017XEU/NDARHD017XEU_Video-FF_Samples_ET.mat, Fractals, 60, 5433315165, 5596306248, 162991083
/Volumes/methlab_data/HBN/EEG-ET/NDARHD017XEU/NDARHD017XEU_Video-TP_Samples_ET.mat, Present, 60, 6479736865, 6682807252, 203070387
/Volumes/methlab_data/HBN/EEG-ET/NDARHD017XEU/NDARHD017XEU_Video-WK_Samples_ET.mat, Diary, 60, 4825307952, 4942699849, 117391897
/Volumes/methlab_data/HBN/EEG-ET/NDARHD059PEQ/NDARHD059PEQ_Video1_Samples_ET.mat, Diary, 60, 832567688, 949958360, 117390672
/Volumes/methlab_data/HBN/EEG-ET/NDARHD059PEQ/NDARHD059PEQ_Video3_Samples_ET.mat, Despicable, 60, 615923570, 786467911, 170544341
/Volumes/methlab_data/HBN/EEG-ET/NDARHD276TYX/NDARHD276TYX_Video-DM_Samples_ET.mat, Despicable, 60, 5814623599, 5985162127, 170538528
/Volumes/methlab_data/HBN/EEG-ET/NDARHD276TYX/NDARHD276TYX_Video-TP_Samples_ET.mat, Present, 60, 6298657638, 6501937293, 203279655
/Volumes/methlab_data/HBN/EEG-ET/NDARHD276TYX/NDARHD276TYX_Video-WK_Samples_ET.mat, Diary, 60, 4659233145, 4776622105, 117388960
/Volumes/methlab_data/HBN/EEG-ET/NDARHD507TEF/NDARHD507TEF_Video1_Samples_ET.mat, Diary, 120, 2962709083, 3080105653, 117396570
/Volumes/methlab_data/HBN/EEG-ET/NDARHD507TEF/NDARHD507TEF_Video2_Samples_ET.mat, Despicable, 120, 4346560107, 4517107006, 170546899
/Volumes/methlab_data/HBN/EEG-ET/NDARHD507TEF/NDARHD507TEF_Video3_Samples_ET.mat, Fractals, 120, 4966859302, 5129843327, 162984025
/Volumes/methlab_data/HBN/EEG-ET/NDARHD507TEF/NDARHD507TEF_Video4_Samples_ET.mat, Present, 120, 5631071795, 5834138940, 203067145
/Volumes/methlab_data/HBN/EEG-ET/NDARHD546PDX/NDARHD546PDX_Video-DM_Samples_ET.mat, Despicable, 60, 76703700417, 76874236826, 170536409
/Volumes/methlab_data/HBN/EEG-ET/NDARHD546PDX/NDARHD546PDX_Video-TP_Samples_ET.mat, Present, 60, 77600731660, 77803998168, 203266508
/Volumes/methlab_data/HBN/EEG-ET/NDARHD546PDX/NDARHD546PDX_Video-WK_Samples_ET.mat, Diary, 60, 77124104189, 77241492100, 117387911
/Volumes/methlab_data/HBN/EEG-ET/NDARHD931FNA/NDARHD931FNA_Video1_Samples_ET.mat, Diary, 60, 5822547887, 5939939889, 117392002
/Volumes/methlab_data/HBN/EEG-ET/NDARHD931FNA/NDARHD931FNA_Video2_Samples_ET.mat, Fractals, 60, 4478346018, 4641334210, 162988192
/Volumes/methlab_data/HBN/EEG-ET/NDARHD931FNA/NDARHD931FNA_Video3_Samples_ET.mat, Despicable, 60, 5348591965, 5519133496, 170541531
/Volumes/methlab_data/HBN/EEG-ET/NDARHD931FNA/NDARHD931FNA_Video4_Samples_ET.mat, Present, 60, 6261911347, 6464973919, 203062572
/Volumes/methlab_data/HBN/EEG-ET/NDARHD952XHH/NDARHD952XHH_Video-DM_Samples_ET.mat, Despicable, 60, 3404473798, 3575010201, 170536403
/Volumes/methlab_data/HBN/EEG-ET/NDARHD952XHH/NDARHD952XHH_Video-TP_Samples_ET.mat, Present, 60, 4362247750, 4565518517, 203270767
/Volumes/methlab_data/HBN/EEG-ET/NDARHD952XHH/NDARHD952XHH_Video-WK_Samples_ET.mat, Diary, 60, 3750280975, 3867669620, 117388645
/Volumes/methlab_data/HBN/EEG-ET/NDARHE199NGL/NDARHE199NGL_Video1_Samples_ET.mat, Diary, 60, 9068076355, 9185471203, 117394848
/Volumes/methlab_data/HBN/EEG-ET/NDARHE199NGL/NDARHE199NGL_Video3_Samples_ET.mat, Despicable, 60, 8498308370, 8668848693, 170540323
/Volumes/methlab_data/HBN/EEG-ET/NDARHE199NGL/NDARHE199NGL_Video4_Samples_ET.mat, Present, 60, 9502513890, 9705574324, 203060434
/Volumes/methlab_data/HBN/EEG-ET/NDARHE236YLB/NDARHE236YLB_Video1_Samples_ET.mat, Diary, 60, 2821241587, 2938638580, 117396993
/Volumes/methlab_data/HBN/EEG-ET/NDARHE236YLB/NDARHE236YLB_Video3_Samples_ET.mat, Despicable, 60, 2523532214, 2694076757, 170544543
/Volumes/methlab_data/HBN/EEG-ET/NDARHE283KZN/NDARHE283KZN_Video-DM_Samples_ET.mat, Despicable, 60, 4361309079, 4531860452, 170551373
/Volumes/methlab_data/HBN/EEG-ET/NDARHE283KZN/NDARHE283KZN_Video-FF_Samples_ET.mat, Fractals, 60, 3865428156, 4028409211, 162981055
/Volumes/methlab_data/HBN/EEG-ET/NDARHE283KZN/NDARHE283KZN_Video-TP_Samples_ET.mat, Present, 60, 4839895737, 5042963029, 203067292
/Volumes/methlab_data/HBN/EEG-ET/NDARHE283KZN/NDARHE283KZN_Video-WK_Samples_ET.mat, Diary, 60, 3147113332, 3264507174, 117393842
/Volumes/methlab_data/HBN/EEG-ET/NDARHE772FWW/NDARHE772FWW_Video-DM_Samples_ET.mat, Despicable, 60, 5121881306, 5292425838, 170544532
/Volumes/methlab_data/HBN/EEG-ET/NDARHE772FWW/NDARHE772FWW_Video-FF_Samples_ET.mat, Fractals, 60, 5713810573, 5876794766, 162984193
/Volumes/methlab_data/HBN/EEG-ET/NDARHE772FWW/NDARHE772FWW_Video-TP_Samples_ET.mat, Present, 60, 6583641258, 6786703767, 203062509
/Volumes/methlab_data/HBN/EEG-ET/NDARHE772FWW/NDARHE772FWW_Video-WK_Samples_ET.mat, Diary, 60, 6149804667, 6267199651, 117394984
/Volumes/methlab_data/HBN/EEG-ET/NDARHE896MYM/NDARHE896MYM_Video-DM_Samples_ET.mat, Despicable, 30, 4027633982, 4198181639, 170547657
/Volumes/methlab_data/HBN/EEG-ET/NDARHE896MYM/NDARHE896MYM_Video-TP_Samples_ET.mat, Present, 30, 4508629173, 4711895942, 203266769
/Volumes/methlab_data/HBN/EEG-ET/NDARHE896MYM/NDARHE896MYM_Video-WK_Samples_ET.mat, Diary, 30, 2775314258, 2892704293, 117390035
/Volumes/methlab_data/HBN/EEG-ET/NDARHE899FJV/NDARHE899FJV_Video1_Samples_ET.mat, Diary, 120, 2864623879, 2982011094, 117387215
/Volumes/methlab_data/HBN/EEG-ET/NDARHE899FJV/NDARHE899FJV_Video2_Samples_ET.mat, Despicable, 120, 3411386172, 3581932389, 170546217
/Volumes/methlab_data/HBN/EEG-ET/NDARHE899FJV/NDARHE899FJV_Video3_Samples_ET.mat, Fractals, 120, 3887852551, 4050839726, 162987175
/Volumes/methlab_data/HBN/EEG-ET/NDARHE899FJV/NDARHE899FJV_Video4_Samples_ET.mat, Present, 120, 4549209733, 4752276009, 203066276
/Volumes/methlab_data/HBN/EEG-ET/NDARHF081GX4/NDARHF081GX4_Video-DM_Samples_ET.mat, Despicable, 30, 4491378232, 4661917050, 170538818
/Volumes/methlab_data/HBN/EEG-ET/NDARHF081GX4/NDARHF081GX4_Video-TP_Samples_ET.mat, Present, 30, 5474058292, 5677337305, 203279013
/Volumes/methlab_data/HBN/EEG-ET/NDARHF081GX4/NDARHF081GX4_Video-WK_Samples_ET.mat, Diary, 30, 4993961226, 5111357405, 117396179
/Volumes/methlab_data/HBN/EEG-ET/NDARHF150FDY/NDARHF150FDY_Video1_Samples_ET.mat, Diary, 120, 3336942551, 3454339824, 117397273
/Volumes/methlab_data/HBN/EEG-ET/NDARHF150FDY/NDARHF150FDY_Video2_Samples_ET.mat, Fractals, 120, 5816096121, 5979084235, 162988114
/Volumes/methlab_data/HBN/EEG-ET/NDARHF150FDY/NDARHF150FDY_Video3_Samples_ET.mat, Despicable, 120, 6259724046, 6430271735, 170547689
/Volumes/methlab_data/HBN/EEG-ET/NDARHF150FDY/NDARHF150FDY_Video4_Samples_ET.mat, Present, 120, 6906410424, 7109478128, 203067704
/Volumes/methlab_data/HBN/EEG-ET/NDARHF269ATU/NDARHF269ATU_Video1_Samples_ET.mat, Diary, 60, 1629008594, 1746398582, 117389988
/Volumes/methlab_data/HBN/EEG-ET/NDARHF269ATU/NDARHF269ATU_Video3_Samples_ET.mat, Despicable, 60, 2458685898, 2629227417, 170541519
/Volumes/methlab_data/HBN/EEG-ET/NDARHF351AA6/NDARHF351AA6_Video1_Samples_ET.mat, Diary, 60, 8345308884, 8462702917, 117394033
/Volumes/methlab_data/HBN/EEG-ET/NDARHF351AA6/NDARHF351AA6_Video3_Samples_ET.mat, Despicable, 60, 8536587211, 8707123779, 170536568
/Volumes/methlab_data/HBN/EEG-ET/NDARHF545HFW/NDARHF545HFW_Video1_Samples_ET.mat, Diary, 60, 2393899654, 2511295618, 117395964
/Volumes/methlab_data/HBN/EEG-ET/NDARHF545HFW/NDARHF545HFW_Video2_Samples_ET.mat, Fractals, 60, 3656045538, 3819030742, 162985204
/Volumes/methlab_data/HBN/EEG-ET/NDARHF545HFW/NDARHF545HFW_Video3_Samples_ET.mat, Despicable, 60, 3037587504, 3208142054, 170554550
/Volumes/methlab_data/HBN/EEG-ET/NDARHF545HFW/NDARHF545HFW_Video4_Samples_ET.mat, Present, 60, 4203184170, 4406248676, 203064506
/Volumes/methlab_data/HBN/EEG-ET/NDARHF904CWB/NDARHF904CWB_Video1_Samples_ET.mat, Diary, 60, 2333709556, 2451102376, 117392820
/Volumes/methlab_data/HBN/EEG-ET/NDARHF904CWB/NDARHF904CWB_Video3_Samples_ET.mat, Despicable, 60, 914898635, 1085437920, 170539285
/Volumes/methlab_data/HBN/EEG-ET/NDARHG065YHQ/NDARHG065YHQ_Video1_Samples_ET.mat, Diary, 60, 3744802667, 3862197743, 117395076
/Volumes/methlab_data/HBN/EEG-ET/NDARHG065YHQ/NDARHG065YHQ_Video2_Samples_ET.mat, Fractals, 60, 4653411612, 4816403988, 162992376
/Volumes/methlab_data/HBN/EEG-ET/NDARHG065YHQ/NDARHG065YHQ_Video3_Samples_ET.mat, Despicable, 60, 5116947620, 5287490344, 170542724
/Volumes/methlab_data/HBN/EEG-ET/NDARHG065YHQ/NDARHG065YHQ_Video4_Samples_ET.mat, Present, 60, 5596770186, 5799833886, 203063700
/Volumes/methlab_data/HBN/EEG-ET/NDARHG125NEN/NDARHG125NEN_Video-DM_Samples_ET.mat, Despicable, 60, 4604365184, 4774902420, 170537236
/Volumes/methlab_data/HBN/EEG-ET/NDARHG125NEN/NDARHG125NEN_Video-TP_Samples_ET.mat, Present, 60, 5061638609, 5264905030, 203266421
/Volumes/methlab_data/HBN/EEG-ET/NDARHG125NEN/NDARHG125NEN_Video-WK_Samples_ET.mat, Diary, 60, 3563604153, 3680993967, 117389814
/Volumes/methlab_data/HBN/EEG-ET/NDARHG152GZC/NDARHG152GZC_Video1_Samples_ET.mat, Diary, 60, 16410551335, 16527946661, 117395326
/Volumes/methlab_data/HBN/EEG-ET/NDARHG152GZC/NDARHG152GZC_Video3_Samples_ET.mat, Despicable, 60, 15878006371, 16048549426, 170543055
/Volumes/methlab_data/HBN/EEG-ET/NDARHG152GZC/NDARHG152GZC_Video4_Samples_ET.mat, Present, 60, 16855951409, 17059011537, 203060128
/Volumes/methlab_data/HBN/EEG-ET/NDARHG188YE9/NDARHG188YE9_Video1_Samples_ET.mat, Fractals, 120, 10325667709, 10488663617, 162995908
/Volumes/methlab_data/HBN/EEG-ET/NDARHG188YE9/NDARHG188YE9_Video2_Samples_ET.mat, Diary, 120, 11601809824, 11719206902, 117397078
/Volumes/methlab_data/HBN/EEG-ET/NDARHG188YE9/NDARHG188YE9_Video3_Samples_ET.mat, Despicable, 120, 12124516871, 12295064589, 170547718
/Volumes/methlab_data/HBN/EEG-ET/NDARHG188YE9/NDARHG188YE9_Video4_Samples_ET.mat, Present, 120, 12864468134, 13067534839, 203066705
/Volumes/methlab_data/HBN/EEG-ET/NDARHG260BM9/NDARHG260BM9_Video-DM_Samples_ET.mat, Despicable, 60, 4374012874, 4544550509, 170537635
/Volumes/methlab_data/HBN/EEG-ET/NDARHG260BM9/NDARHG260BM9_Video-FF_Samples_ET.mat, Fractals, 60, 3653636371, 3816628662, 162992291
/Volumes/methlab_data/HBN/EEG-ET/NDARHG260BM9/NDARHG260BM9_Video-TP_Samples_ET.mat, Present, 60, 5274969081, 5478039745, 203070664
/Volumes/methlab_data/HBN/EEG-ET/NDARHG260BM9/NDARHG260BM9_Video-WK_Samples_ET.mat, Diary, 60, 4830375640, 4947765680, 117390040
/Volumes/methlab_data/HBN/EEG-ET/NDARHG294AFG/NDARHG294AFG_Video1_Samples_ET.mat, Diary, 120, 3276907498, 3394304912, 117397414
/Volumes/methlab_data/HBN/EEG-ET/NDARHG294AFG/NDARHG294AFG_Video2_Samples_ET.mat, Fractals, 120, 4380929741, 4543917865, 162988124
/Volumes/methlab_data/HBN/EEG-ET/NDARHG294AFG/NDARHG294AFG_Video3_Samples_ET.mat, Despicable, 120, 4877407616, 5047954980, 170547364
/Volumes/methlab_data/HBN/EEG-ET/NDARHG294AFG/NDARHG294AFG_Video4_Samples_ET.mat, Present, 120, 5524413516, 5727481603, 203068087
/Volumes/methlab_data/HBN/EEG-ET/NDARHG321LLD/NDARHG321LLD_Video1_Samples_ET.mat, Diary, 60, 9908001118, 10025399117, 117397999
/Volumes/methlab_data/HBN/EEG-ET/NDARHG321LLD/NDARHG321LLD_Video3_Samples_ET.mat, Despicable, 60, 9372579778, 9543125302, 170545524
/Volumes/methlab_data/HBN/EEG-ET/NDARHG594GKH/NDARHG594GKH_Video1_Samples_ET.mat, Diary, 60, 3537071831, 3654463885, 117392054
/Volumes/methlab_data/HBN/EEG-ET/NDARHG594GKH/NDARHG594GKH_Video2_Samples_ET.mat, Fractals, 60, 3776422122, 3939415427, 162993305
/Volumes/methlab_data/HBN/EEG-ET/NDARHG594GKH/NDARHG594GKH_Video3_Samples_ET.mat, Despicable, 60, 3252270398, 3422824049, 170553651
/Volumes/methlab_data/HBN/EEG-ET/NDARHG594GKH/NDARHG594GKH_Video4_Samples_ET.mat, Present, 60, 3988434063, 4191496729, 203062666
/Volumes/methlab_data/HBN/EEG-ET/NDARHH127PCL/NDARHH127PCL_Video-DM_Samples_ET.mat, Despicable, 120, 2519573561, 2690121089, 170547528
/Volumes/methlab_data/HBN/EEG-ET/NDARHH127PCL/NDARHH127PCL_Video-FF_Samples_ET.mat, Fractals, 120, 3220052083, 3383036405, 162984322
/Volumes/methlab_data/HBN/EEG-ET/NDARHH127PCL/NDARHH127PCL_Video-TP_Samples_ET.mat, Present, 120, 3914824762, 4117901622, 203076860
/Volumes/methlab_data/HBN/EEG-ET/NDARHH127PCL/NDARHH127PCL_Video-WK_Samples_ET.mat, Diary, 120, 2842431143, 2959828973, 117397830
/Volumes/methlab_data/HBN/EEG-ET/NDARHH654ZF9/NDARHH654ZF9_Video-DM_Samples_ET.mat, Despicable, 120, 4796785341, 4967332785, 170547444
/Volumes/methlab_data/HBN/EEG-ET/NDARHH654ZF9/NDARHH654ZF9_Video-FF_Samples_ET.mat, Fractals, 120, 4184040436, 4347026691, 162986255
/Volumes/methlab_data/HBN/EEG-ET/NDARHH654ZF9/NDARHH654ZF9_Video-TP_Samples_ET.mat, Present, 120, 5504210537, 5707277534, 203066997
/Volumes/methlab_data/HBN/EEG-ET/NDARHH654ZF9/NDARHH654ZF9_Video-WK_Samples_ET.mat, Diary, 120, 3314875850, 3432272832, 117396982
/Volumes/methlab_data/HBN/EEG-ET/NDARHH802DBM/NDARHH802DBM_Video-DM_Samples_ET.mat, Despicable, 60, 5740460433, 5911008929, 170548496
/Volumes/methlab_data/HBN/EEG-ET/NDARHH802DBM/NDARHH802DBM_Video-TP_Samples_ET.mat, Present, 60, 6317616075, 6520891670, 203275595
/Volumes/methlab_data/HBN/EEG-ET/NDARHH802DBM/NDARHH802DBM_Video-WK_Samples_ET.mat, Diary, 60, 6159495389, 6276885337, 117389948
/Volumes/methlab_data/HBN/EEG-ET/NDARHH819LH3/NDARHH819LH3_Video-DM_Samples_ET.mat, Despicable, 120, 5552090526, 5722635641, 170545115
/Volumes/methlab_data/HBN/EEG-ET/NDARHH819LH3/NDARHH819LH3_Video-FF_Samples_ET.mat, Fractals, 120, 4240785155, 4403770904, 162985749
/Volumes/methlab_data/HBN/EEG-ET/NDARHH819LH3/NDARHH819LH3_Video-TP_Samples_ET.mat, Present, 120, 6856197295, 7059264635, 203067340
/Volumes/methlab_data/HBN/EEG-ET/NDARHH819LH3/NDARHH819LH3_Video-WK_Samples_ET.mat, Diary, 120, 6031222036, 6148619991, 117397955
/Volumes/methlab_data/HBN/EEG-ET/NDARHJ126UW2/NDARHJ126UW2_Video1_Samples_ET.mat, Diary, 60, 2531042777, 2648438219, 117395442
/Volumes/methlab_data/HBN/EEG-ET/NDARHJ126UW2/NDARHJ126UW2_Video3_Samples_ET.mat, Despicable, 60, 2324257939, 2494805072, 170547133
/Volumes/methlab_data/HBN/EEG-ET/NDARHJ318KZA/NDARHJ318KZA_Video-DM_Samples_ET.mat, Despicable, 120, 2142809855, 2313356365, 170546510
/Volumes/methlab_data/HBN/EEG-ET/NDARHJ318KZA/NDARHJ318KZA_Video-FF_Samples_ET.mat, Fractals, 120, 2421036678, 2584024617, 162987939
/Volumes/methlab_data/HBN/EEG-ET/NDARHJ318KZA/NDARHJ318KZA_Video-TP_Samples_ET.mat, Present, 120, 2832925117, 3036002119, 203077002
/Volumes/methlab_data/HBN/EEG-ET/NDARHJ318KZA/NDARHJ318KZA_Video-WK_Samples_ET.mat, Diary, 120, 2621245888, 2738643378, 117397490
/Volumes/methlab_data/HBN/EEG-ET/NDARHJ523XGB/NDARHJ523XGB_Video1_Samples_ET.mat, Diary, 60, 2218563431, 2335948357, 117384926
/Volumes/methlab_data/HBN/EEG-ET/NDARHJ523XGB/NDARHJ523XGB_Video3_Samples_ET.mat, Despicable, 60, 3376711422, 3547250889, 170539467
/Volumes/methlab_data/HBN/EEG-ET/NDARHJ830RXD/NDARHJ830RXD_Video-DM_Samples_ET.mat, Despicable, 60, 3368426366, 3538976892, 170550526
/Volumes/methlab_data/HBN/EEG-ET/NDARHJ830RXD/NDARHJ830RXD_Video-FF_Samples_ET.mat, Fractals, 60, 3821512518, 3984503742, 162991224
/Volumes/methlab_data/HBN/EEG-ET/NDARHJ830RXD/NDARHJ830RXD_Video-TP_Samples_ET.mat, Present, 60, 4319603521, 4522675029, 203071508
/Volumes/methlab_data/HBN/EEG-ET/NDARHJ830RXD/NDARHJ830RXD_Video-WK_Samples_ET.mat, Diary, 60, 2619622213, 2737016220, 117394007
/Volumes/methlab_data/HBN/EEG-ET/NDARHJ945PV0/NDARHJ945PV0_Video1_Samples_ET.mat, Diary, 60, 3086828633, 3204219719, 117391086
/Volumes/methlab_data/HBN/EEG-ET/NDARHJ945PV0/NDARHJ945PV0_Video3_Samples_ET.mat, Despicable, 60, 2544215427, 2714765195, 170549768
/Volumes/methlab_data/HBN/EEG-ET/NDARHK506HLW/NDARHK506HLW_Video1_Samples_ET.mat, Diary, 120, 4743456172, 4860853487, 117397315
/Volumes/methlab_data/HBN/EEG-ET/NDARHK506HLW/NDARHK506HLW_Video2_Samples_ET.mat, Despicable, 120, 5716290381, 5886837155, 170546774
/Volumes/methlab_data/HBN/EEG-ET/NDARHK506HLW/NDARHK506HLW_Video3_Samples_ET.mat, Fractals, 120, 6247245911, 6410233578, 162987667
/Volumes/methlab_data/HBN/EEG-ET/NDARHK506HLW/NDARHK506HLW_Video4_Samples_ET.mat, Present, 120, 6911562575, 7114629977, 203067402
/Volumes/methlab_data/HBN/EEG-ET/NDARHK526BY1/NDARHK526BY1_Video1_Samples_ET.mat, Diary, 60, 7037293223, 7154682389, 117389166
/Volumes/methlab_data/HBN/EEG-ET/NDARHK526BY1/NDARHK526BY1_Video3_Samples_ET.mat, Despicable, 60, 6558630176, 6729177986, 170547810
/Volumes/methlab_data/HBN/EEG-ET/NDARHK526BY1/NDARHK526BY1_Video4_Samples_ET.mat, Present, 60, 7544665624, 7747738498, 203072874
/Volumes/methlab_data/HBN/EEG-ET/NDARHL164JHH/NDARHL164JHH_Video1_Samples_ET.mat, Diary, 60, 1288163813, 1405568993, 117405180
/Volumes/methlab_data/HBN/EEG-ET/NDARHL164JHH/NDARHL164JHH_Video3_Samples_ET.mat, Despicable, 60, 872257206, 1042801033, 170543827
/Volumes/methlab_data/HBN/EEG-ET/NDARHL164JHH/NDARHL164JHH_Video4_Samples_ET.mat, Present, 60, 1442418075, 1645483927, 203065852
/Volumes/methlab_data/HBN/EEG-ET/NDARHL684WYU/NDARHL684WYU_Video-DM_Samples_ET.mat, Despicable, 60, 4599026121, 4769567001, 170540880
/Volumes/methlab_data/HBN/EEG-ET/NDARHL684WYU/NDARHL684WYU_Video-FF_Samples_ET.mat, Fractals, 60, 4160468370, 4323449937, 162981567
/Volumes/methlab_data/HBN/EEG-ET/NDARHL684WYU/NDARHL684WYU_Video-TP_Samples_ET.mat, Present, 60, 5080638444, 5283704533, 203066089
/Volumes/methlab_data/HBN/EEG-ET/NDARHL684WYU/NDARHL684WYU_Video-WK_Samples_ET.mat, Diary, 60, 3541161420, 3658553631, 117392211
/Volumes/methlab_data/HBN/EEG-ET/NDARHL822EJK/NDARHL822EJK_Video-DM_Samples_ET.mat, Despicable, 60, 4102837726, 4273377335, 170539609
/Volumes/methlab_data/HBN/EEG-ET/NDARHL822EJK/NDARHL822EJK_Video-FF_Samples_ET.mat, Fractals, 60, 4545739826, 4708724096, 162984270
/Volumes/methlab_data/HBN/EEG-ET/NDARHL822EJK/NDARHL822EJK_Video-TP_Samples_ET.mat, Present, 60, 5014327120, 5217401706, 203074586
/Volumes/methlab_data/HBN/EEG-ET/NDARHL822EJK/NDARHL822EJK_Video-WK_Samples_ET.mat, Diary, 60, 3453812895, 3571209853, 117396958
/Volumes/methlab_data/HBN/EEG-ET/NDARHM282EJ4/NDARHM282EJ4_Video-DM_Samples_ET.mat, Despicable, 30, 163982569, 334520327, 170537758
/Volumes/methlab_data/HBN/EEG-ET/NDARHM282EJ4/NDARHM282EJ4_Video-TP_Samples_ET.mat, Present, 30, 691782236, 895045163, 203262927
/Volumes/methlab_data/HBN/EEG-ET/NDARHM282EJ4/NDARHM282EJ4_Video-WK_Samples_ET.mat, Diary, 30, 3396423463, 3513807603, 117384140
/Volumes/methlab_data/HBN/EEG-ET/NDARHM413HVA/NDARHM413HVA_Video1_Samples_ET.mat, Diary, 120, 2841912408, 2959308813, 117396405
/Volumes/methlab_data/HBN/EEG-ET/NDARHM413HVA/NDARHM413HVA_Video2_Samples_ET.mat, Fractals, 120, 3838812265, 4001796372, 162984107
/Volumes/methlab_data/HBN/EEG-ET/NDARHM413HVA/NDARHM413HVA_Video3_Samples_ET.mat, Despicable, 120, 4349322547, 4519869084, 170546537
/Volumes/methlab_data/HBN/EEG-ET/NDARHM413HVA/NDARHM413HVA_Video4_Samples_ET.mat, Present, 120, 5162916715, 5365984296, 203067581
/Volumes/methlab_data/HBN/EEG-ET/NDARHM611GDR/NDARHM611GDR_Video-DM_Samples_ET.mat, Despicable, 60, 5846968356, 6017509887, 170541531
/Volumes/methlab_data/HBN/EEG-ET/NDARHM611GDR/NDARHM611GDR_Video-FF_Samples_ET.mat, Fractals, 60, 5385334143, 5548315391, 162981248
/Volumes/methlab_data/HBN/EEG-ET/NDARHM611GDR/NDARHM611GDR_Video-TP_Samples_ET.mat, Present, 60, 6354949372, 6558020843, 203071471
/Volumes/methlab_data/HBN/EEG-ET/NDARHM611GDR/NDARHM611GDR_Video-WK_Samples_ET.mat, Diary, 60, 4830864357, 4948255284, 117390927
/Volumes/methlab_data/HBN/EEG-ET/NDARHN078CDT/NDARHN078CDT_Video-DM_Samples_ET.mat, Despicable, 60, 4721392487, 4891933345, 170540858
/Volumes/methlab_data/HBN/EEG-ET/NDARHN078CDT/NDARHN078CDT_Video-FF_Samples_ET.mat, Fractals, 60, 5281184006, 5444166553, 162982547
/Volumes/methlab_data/HBN/EEG-ET/NDARHN078CDT/NDARHN078CDT_Video-TP_Samples_ET.mat, Present, 60, 5893323603, 6096385502, 203061899
/Volumes/methlab_data/HBN/EEG-ET/NDARHN078CDT/NDARHN078CDT_Video-WK_Samples_ET.mat, Diary, 60, 3893498059, 4010893220, 117395161
/Volumes/methlab_data/HBN/EEG-ET/NDARHN131ZP6/NDARHN131ZP6_Video1_Samples_ET.mat, Diary, 120, 3116806237, 3234202338, 117396101
/Volumes/methlab_data/HBN/EEG-ET/NDARHN131ZP6/NDARHN131ZP6_Video2_Samples_ET.mat, Despicable, 120, 4557925246, 4728472363, 170547117
/Volumes/methlab_data/HBN/EEG-ET/NDARHN131ZP6/NDARHN131ZP6_Video3_Samples_ET.mat, Fractals, 120, 5012281011, 5175269580, 162988569
/Volumes/methlab_data/HBN/EEG-ET/NDARHN131ZP6/NDARHN131ZP6_Video4_Samples_ET.mat, Present, 120, 5653018425, 5856084585, 203066160
/Volumes/methlab_data/HBN/EEG-ET/NDARHN158DC6/NDARHN158DC6_Video1_Samples_ET.mat, Diary, 60, 3583474706, 3700873655, 117398949
/Volumes/methlab_data/HBN/EEG-ET/NDARHN158DC6/NDARHN158DC6_Video3_Samples_ET.mat, Despicable, 60, 3368012531, 3538560015, 170547484
/Volumes/methlab_data/HBN/EEG-ET/NDARHN212TT6/NDARHN212TT6_Video1_Samples_ET.mat, Diary, 120, 4948791183, 5066189089, 117397906
/Volumes/methlab_data/HBN/EEG-ET/NDARHN212TT6/NDARHN212TT6_Video2_Samples_ET.mat, Fractals, 120, 5635096646, 5798084858, 162988212
/Volumes/methlab_data/HBN/EEG-ET/NDARHN212TT6/NDARHN212TT6_Video3_Samples_ET.mat, Despicable, 120, 6074024819, 6244572003, 170547184
/Volumes/methlab_data/HBN/EEG-ET/NDARHN212TT6/NDARHN212TT6_Video4_Samples_ET.mat, Present, 120, 6765194128, 6968258393, 203064265
/Volumes/methlab_data/HBN/EEG-ET/NDARHN224TPA/NDARHN224TPA_Video-DM_Samples_ET.mat, Despicable, 60, 4009374505, 4179919840, 170545335
/Volumes/methlab_data/HBN/EEG-ET/NDARHN224TPA/NDARHN224TPA_Video-FF_Samples_ET.mat, Fractals, 60, 4456421938, 4619412169, 162990231
/Volumes/methlab_data/HBN/EEG-ET/NDARHN224TPA/NDARHN224TPA_Video-TP_Samples_ET.mat, Present, 60, 4932713989, 5135781311, 203067322
/Volumes/methlab_data/HBN/EEG-ET/NDARHN224TPA/NDARHN224TPA_Video-WK_Samples_ET.mat, Diary, 60, 3183703939, 3301097783, 117393844
/Volumes/methlab_data/HBN/EEG-ET/NDARHN386FXX/NDARHN386FXX_Video-DM_Samples_ET.mat, Despicable, 30, 5670242362, 5840779846, 170537484
/Volumes/methlab_data/HBN/EEG-ET/NDARHN386FXX/NDARHN386FXX_Video-TP_Samples_ET.mat, Present, 30, 6562312421, 6765580020, 203267599
/Volumes/methlab_data/HBN/EEG-ET/NDARHN386FXX/NDARHN386FXX_Video-WK_Samples_ET.mat, Diary, 30, 6097467108, 6214857043, 117389935
/Volumes/methlab_data/HBN/EEG-ET/NDARHN749RW4/NDARHN749RW4_Video1_Samples_ET.mat, Diary, 60, 6004809372, 6122204255, 117394883
/Volumes/methlab_data/HBN/EEG-ET/NDARHN749RW4/NDARHN749RW4_Video3_Samples_ET.mat, Despicable, 60, 5494338194, 5664881535, 170543341
/Volumes/methlab_data/HBN/EEG-ET/NDARHN749RW4/NDARHN749RW4_Video4_Samples_ET.mat, Present, 60, 6539752961, 6742771073, 203018112
/Volumes/methlab_data/HBN/EEG-ET/NDARHN911CNJ/NDARHN911CNJ_Video-DM_Samples_ET.mat, Despicable, 60, 5577478730, 5748016323, 170537593
/Volumes/methlab_data/HBN/EEG-ET/NDARHN911CNJ/NDARHN911CNJ_Video-TP_Samples_ET.mat, Present, 60, 6453381062, 6656654725, 203273663
/Volumes/methlab_data/HBN/EEG-ET/NDARHN911CNJ/NDARHN911CNJ_Video-WK_Samples_ET.mat, Diary, 60, 6006842291, 6124230309, 117388018
/Volumes/methlab_data/HBN/EEG-ET/NDARHN931CJV/NDARHN931CJV_Video1_Samples_ET.mat, Diary, 120, 6447362500, 6564759038, 117396538
/Volumes/methlab_data/HBN/EEG-ET/NDARHN931CJV/NDARHN931CJV_Video2_Samples_ET.mat, Despicable, 120, 7292947393, 7463493200, 170545807
/Volumes/methlab_data/HBN/EEG-ET/NDARHN931CJV/NDARHN931CJV_Video3_Samples_ET.mat, Fractals, 120, 7761832858, 7924830844, 162997986
/Volumes/methlab_data/HBN/EEG-ET/NDARHN931CJV/NDARHN931CJV_Video4_Samples_ET.mat, Present, 120, 8447299729, 8650366789, 203067060
/Volumes/methlab_data/HBN/EEG-ET/NDARHP039DBU/NDARHP039DBU_Video1_Samples_ET.mat, Diary, 60, 5517687515, 5635081538, 117394023
/Volumes/methlab_data/HBN/EEG-ET/NDARHP039DBU/NDARHP039DBU_Video2_Samples_ET.mat, Fractals, 60, 6007736987, 6170720247, 162983260
/Volumes/methlab_data/HBN/EEG-ET/NDARHP039DBU/NDARHP039DBU_Video3_Samples_ET.mat, Despicable, 60, 6514080033, 6684621573, 170541540
/Volumes/methlab_data/HBN/EEG-ET/NDARHP039DBU/NDARHP039DBU_Video4_Samples_ET.mat, Present, 60, 6986292841, 7189356431, 203063590
/Volumes/methlab_data/HBN/EEG-ET/NDARHP176DPE/NDARHP176DPE_Video1_Samples_ET.mat, Diary, 60, 1881964414, 1999360502, 117396088
/Volumes/methlab_data/HBN/EEG-ET/NDARHP176DPE/NDARHP176DPE_Video3_Samples_ET.mat, Despicable, 60, 3159676556, 3330222265, 170545709
/Volumes/methlab_data/HBN/EEG-ET/NDARHP395DGY/NDARHP395DGY_Video-DM_Samples_ET.mat, Despicable, 60, 6640083698, 6810625310, 170541612
/Volumes/methlab_data/HBN/EEG-ET/NDARHP395DGY/NDARHP395DGY_Video-FF_Samples_ET.mat, Fractals, 60, 7278869451, 7441857755, 162988304
/Volumes/methlab_data/HBN/EEG-ET/NDARHP395DGY/NDARHP395DGY_Video-TP_Samples_ET.mat, Present, 60, 7986720087, 8189794742, 203074655
/Volumes/methlab_data/HBN/EEG-ET/NDARHP395DGY/NDARHP395DGY_Video-WK_Samples_ET.mat, Diary, 60, 7567847859, 7685240923, 117393064
/Volumes/methlab_data/HBN/EEG-ET/NDARHP705RFA/NDARHP705RFA_Video-DM_Samples_ET.mat, Despicable, 120, 3052433377, 3222979200, 170545823
/Volumes/methlab_data/HBN/EEG-ET/NDARHP705RFA/NDARHP705RFA_Video-FF_Samples_ET.mat, Fractals, 120, 2415197544, 2578183178, 162985634
/Volumes/methlab_data/HBN/EEG-ET/NDARHP705RFA/NDARHP705RFA_Video-TP_Samples_ET.mat, Present, 120, 4096286390, 4299352747, 203066357
/Volumes/methlab_data/HBN/EEG-ET/NDARHP705RFA/NDARHP705RFA_Video-WK_Samples_ET.mat, Diary, 120, 3497099533, 3614496450, 117396917
/Volumes/methlab_data/HBN/EEG-ET/NDARHP841RMR/NDARHP841RMR_Video-DM_Samples_ET.mat, Despicable, 60, 3685368542, 3855912164, 170543622
/Volumes/methlab_data/HBN/EEG-ET/NDARHP841RMR/NDARHP841RMR_Video-FF_Samples_ET.mat, Fractals, 60, 3197395157, 3360386489, 162991332
/Volumes/methlab_data/HBN/EEG-ET/NDARHP841RMR/NDARHP841RMR_Video-TP_Samples_ET.mat, Present, 60, 4333185840, 4536248563, 203062723
/Volumes/methlab_data/HBN/EEG-ET/NDARHP841RMR/NDARHP841RMR_Video-WK_Samples_ET.mat, Diary, 60, 2453700892, 2571094988, 117394096
/Volumes/methlab_data/HBN/EEG-ET/NDARHP924ZHW/NDARHP924ZHW_Video1_Samples_ET.mat, Diary, 60, 4775651765, 4893034605, 117382840
/Volumes/methlab_data/HBN/EEG-ET/NDARHP924ZHW/NDARHP924ZHW_Video3_Samples_ET.mat, Despicable, 60, 4498034890, 4668585240, 170550350
/Volumes/methlab_data/HBN/EEG-ET/NDARHR099EWX/NDARHR099EWX_Video1_Samples_ET.mat, Diary, 60, 12478006514, 12595403567, 117397053
/Volumes/methlab_data/HBN/EEG-ET/NDARHR099EWX/NDARHR099EWX_Video2_Samples_ET.mat, Fractals, 60, 11204960127, 11367952422, 162992295
/Volumes/methlab_data/HBN/EEG-ET/NDARHR099EWX/NDARHR099EWX_Video3_Samples_ET.mat, Despicable, 60, 12039910673, 12210455300, 170544627
/Volumes/methlab_data/HBN/EEG-ET/NDARHR099EWX/NDARHR099EWX_Video4_Samples_ET.mat, Present, 60, 12990840225, 13193899856, 203059631
/Volumes/methlab_data/HBN/EEG-ET/NDARHR140GMB/NDARHR140GMB_Video1_Samples_ET.mat, Diary, 60, 3350703918, 3468102722, 117398804
/Volumes/methlab_data/HBN/EEG-ET/NDARHR140GMB/NDARHR140GMB_Video2_Samples_ET.mat, Fractals, 60, 2127287620, 2290276653, 162989033
/Volumes/methlab_data/HBN/EEG-ET/NDARHR140GMB/NDARHR140GMB_Video3_Samples_ET.mat, Despicable, 60, 2847730954, 3018270308, 170539354
/Volumes/methlab_data/HBN/EEG-ET/NDARHR140GMB/NDARHR140GMB_Video4_Samples_ET.mat, Present, 60, 3801284752, 4004357052, 203072300
/Volumes/methlab_data/HBN/EEG-ET/NDARHR372GJ7/NDARHR372GJ7_Video1_Samples_ET.mat, Diary, 60, 4482530117, 4599925097, 117394980
/Volumes/methlab_data/HBN/EEG-ET/NDARHR372GJ7/NDARHR372GJ7_Video3_Samples_ET.mat, Despicable, 60, 5618491841, 5789036371, 170544530
/Volumes/methlab_data/HBN/EEG-ET/NDARHR443EHF/NDARHR443EHF_Video1_Samples_ET.mat, Diary, 60, 3095419029, 3212816034, 117397005
/Volumes/methlab_data/HBN/EEG-ET/NDARHR443EHF/NDARHR443EHF_Video3_Samples_ET.mat, Despicable, 60, 2608664508, 2779218221, 170553713
/Volumes/methlab_data/HBN/EEG-ET/NDARHR484PZP/NDARHR484PZP_Video-DM_Samples_ET.mat, Despicable, 30, 4902515186, 5073051785, 170536599
/Volumes/methlab_data/HBN/EEG-ET/NDARHR484PZP/NDARHR484PZP_Video-TP_Samples_ET.mat, Present, 30, 5835135550, 6038402278, 203266728
/Volumes/methlab_data/HBN/EEG-ET/NDARHR484PZP/NDARHR484PZP_Video-WK_Samples_ET.mat, Diary, 30, 4098638849, 4216026879, 117388030
/Volumes/methlab_data/HBN/EEG-ET/NDARHR690ZAM/NDARHR690ZAM_Video-DM_Samples_ET.mat, Despicable, 30, 8460809356, 8631342977, 170533621
/Volumes/methlab_data/HBN/EEG-ET/NDARHR690ZAM/NDARHR690ZAM_Video-TP_Samples_ET.mat, Present, 30, 8981950939, 9185230739, 203279800
/Volumes/methlab_data/HBN/EEG-ET/NDARHR690ZAM/NDARHR690ZAM_Video-WK_Samples_ET.mat, Diary, 30, 7246648628, 7364034857, 117386229
/Volumes/methlab_data/HBN/EEG-ET/NDARHR753ZKU/NDARHR753ZKU_Video1_Samples_ET.mat, Diary, 60, 4205917365, 4323310336, 117392971
/Volumes/methlab_data/HBN/EEG-ET/NDARHR753ZKU/NDARHR753ZKU_Video3_Samples_ET.mat, Despicable, 60, 3698135561, 3868679084, 170543523
/Volumes/methlab_data/HBN/EEG-ET/NDARHR763RB4/NDARHR763RB4_Video1_Samples_ET.mat, Despicable, 120, 3504362595, 3674907600, 170545005
/Volumes/methlab_data/HBN/EEG-ET/NDARHR763RB4/NDARHR763RB4_Video2_Samples_ET.mat, Diary, 120, 4667753997, 4785161097, 117407100
/Volumes/methlab_data/HBN/EEG-ET/NDARHR763RB4/NDARHR763RB4_Video3_Samples_ET.mat, Fractals, 120, 5123659712, 5286647795, 162988083
/Volumes/methlab_data/HBN/EEG-ET/NDARHR763RB4/NDARHR763RB4_Video4_Samples_ET.mat, Present, 120, 5720598136, 5923664224, 203066088
/Volumes/methlab_data/HBN/EEG-ET/NDARHR901YLY/NDARHR901YLY_Video1_Samples_ET.mat, Diary, 120, 4719559864, 4836955459, 117395595
/Volumes/methlab_data/HBN/EEG-ET/NDARHR901YLY/NDARHR901YLY_Video2_Samples_ET.mat, Fractals, 120, 5872165965, 6035149628, 162983663
/Volumes/methlab_data/HBN/EEG-ET/NDARHR901YLY/NDARHR901YLY_Video3_Samples_ET.mat, Despicable, 120, 6587319366, 6757863619, 170544253
/Volumes/methlab_data/HBN/EEG-ET/NDARHR901YLY/NDARHR901YLY_Video4_Samples_ET.mat, Present, 120, 7357624034, 7560691197, 203067163
/Volumes/methlab_data/HBN/EEG-ET/NDARHR944BBY/NDARHR944BBY_Video1_Samples_ET.mat, Diary, 60, 2025829804, 2143222973, 117393169
/Volumes/methlab_data/HBN/EEG-ET/NDARHR944BBY/NDARHR944BBY_Video3_Samples_ET.mat, Despicable, 60, 3311744676, 3482284486, 170539810
/Volumes/methlab_data/HBN/EEG-ET/NDARHT019ER6/NDARHT019ER6_Video1_Samples_ET.mat, Diary, 120, 176219965234, 176337362238, 117397004
/Volumes/methlab_data/HBN/EEG-ET/NDARHT019ER6/NDARHT019ER6_Video2_Samples_ET.mat, Fractals, 120, 176935829845, 177098817679, 162987834
/Volumes/methlab_data/HBN/EEG-ET/NDARHT019ER6/NDARHT019ER6_Video3_Samples_ET.mat, Despicable, 120, 177525787112, 177696334593, 170547481
/Volumes/methlab_data/HBN/EEG-ET/NDARHT095YB4/NDARHT095YB4_Video1_Samples_ET.mat, Diary, 120, 3897614057, 4015001273, 117387216
/Volumes/methlab_data/HBN/EEG-ET/NDARHT218GFA/NDARHT218GFA_Video1_Samples_ET.mat, Diary, 60, 2705753734, 2823142866, 117389132
/Volumes/methlab_data/HBN/EEG-ET/NDARHT218GFA/NDARHT218GFA_Video3_Samples_ET.mat, Despicable, 60, 2129658630, 2300210469, 170551839
/Volumes/methlab_data/HBN/EEG-ET/NDARHT403JJJ/NDARHT403JJJ_Video-TP_Samples_ET.mat, Present, 30, 3758025786, 3961303521, 203277735
/Volumes/methlab_data/HBN/EEG-ET/NDARHT403JJJ/NDARHT403JJJ_Video-WK_Samples_ET.mat, Diary, 30, 3280357081, 3397746089, 117389008
/Volumes/methlab_data/HBN/EEG-ET/NDARHT524ET0/NDARHT524ET0_Video-DM_Samples_ET.mat, Despicable, 30, 5097586388, 5268126615, 170540227
/Volumes/methlab_data/HBN/EEG-ET/NDARHT524ET0/NDARHT524ET0_Video-WK_Samples_ET.mat, Diary, 30, 5573934191, 5691320981, 117386790
/Volumes/methlab_data/HBN/EEG-ET/NDARHT774ZK1/NDARHT774ZK1_Video1_Samples_ET.mat, Diary, 60, 2513409742, 2630803663, 117393921
/Volumes/methlab_data/HBN/EEG-ET/NDARHT774ZK1/NDARHT774ZK1_Video2_Samples_ET.mat, Fractals, 60, 3036594251, 3199573399, 162979148
/Volumes/methlab_data/HBN/EEG-ET/NDARHT774ZK1/NDARHT774ZK1_Video3_Samples_ET.mat, Despicable, 60, 3461208174, 3631748624, 170540450
/Volumes/methlab_data/HBN/EEG-ET/NDARHT774ZK1/NDARHT774ZK1_Video4_Samples_ET.mat, Present, 60, 3997917223, 4200991696, 203074473
/Volumes/methlab_data/HBN/EEG-ET/NDARHT829KKB/NDARHT829KKB_Video1_Samples_ET.mat, Diary, 60, 3567177327, 3684573354, 117396027
/Volumes/methlab_data/HBN/EEG-ET/NDARHT829KKB/NDARHT829KKB_Video2_Samples_ET.mat, Fractals, 60, 2772833737, 2935818974, 162985237
/Volumes/methlab_data/HBN/EEG-ET/NDARHT829KKB/NDARHT829KKB_Video3_Samples_ET.mat, Despicable, 60, 3996033524, 4166577110, 170543586
/Volumes/methlab_data/HBN/EEG-ET/NDARHT829KKB/NDARHT829KKB_Video4_Samples_ET.mat, Present, 60, 4479719508, 4682783075, 203063567
/Volumes/methlab_data/HBN/EEG-ET/NDARHU211PYD/NDARHU211PYD_Video1_Samples_ET.mat, Diary, 60, 2802348817, 2919745983, 117397166
/Volumes/methlab_data/HBN/EEG-ET/NDARHU211PYD/NDARHU211PYD_Video3_Samples_ET.mat, Despicable, 60, 2253925335, 2424470159, 170544824
/Volumes/methlab_data/HBN/EEG-ET/NDARHU391FD7/NDARHU391FD7_Video1_Samples_ET.mat, Diary, 60, 1158531102, 1275916979, 117385877
/Volumes/methlab_data/HBN/EEG-ET/NDARHU391FD7/NDARHU391FD7_Video3_Samples_ET.mat, Despicable, 60, 1770033770, 1940583180, 170549410
/Volumes/methlab_data/HBN/EEG-ET/NDARHU423YXP/NDARHU423YXP_Video1_Samples_ET.mat, Diary, 60, 3008923780, 3126313706, 117389926
/Volumes/methlab_data/HBN/EEG-ET/NDARHU423YXP/NDARHU423YXP_Video3_Samples_ET.mat, Despicable, 60, 2505259088, 2675811548, 170552460
/Volumes/methlab_data/HBN/EEG-ET/NDARHU529JHV/NDARHU529JHV_Video-DM_Samples_ET.mat, Despicable, 60, 4502596032, 4673135306, 170539274
/Volumes/methlab_data/HBN/EEG-ET/NDARHU529JHV/NDARHU529JHV_Video-FF_Samples_ET.mat, Fractals, 60, 4965857729, 5128848698, 162990969
/Volumes/methlab_data/HBN/EEG-ET/NDARHU529JHV/NDARHU529JHV_Video-TP_Samples_ET.mat, Present, 60, 5452570975, 5655631186, 203060211
/Volumes/methlab_data/HBN/EEG-ET/NDARHU529JHV/NDARHU529JHV_Video-WK_Samples_ET.mat, Diary, 60, 3579424970, 3696808773, 117383803
/Volumes/methlab_data/HBN/EEG-ET/NDARHU831NXU/NDARHU831NXU_Video1_Samples_ET.mat, Diary, 60, 3838723407, 3956117228, 117393821
/Volumes/methlab_data/HBN/EEG-ET/NDARHU831NXU/NDARHU831NXU_Video3_Samples_ET.mat, Despicable, 60, 4094422743, 4264975038, 170552295
/Volumes/methlab_data/HBN/EEG-ET/NDARHU910KZC/NDARHU910KZC_Video1_Samples_ET.mat, Diary, 60, 4078335522, 4195727364, 117391842
/Volumes/methlab_data/HBN/EEG-ET/NDARHU910KZC/NDARHU910KZC_Video2_Samples_ET.mat, Fractals, 60, 4913629881, 5076620903, 162991022
/Volumes/methlab_data/HBN/EEG-ET/NDARHU910KZC/NDARHU910KZC_Video3_Samples_ET.mat, Despicable, 60, 5492256146, 5662792540, 170536394
/Volumes/methlab_data/HBN/EEG-ET/NDARHU910KZC/NDARHU910KZC_Video4_Samples_ET.mat, Present, 60, 6156107557, 6359171834, 203064277
/Volumes/methlab_data/HBN/EEG-ET/NDARHU954TM0/NDARHU954TM0_Video-DM_Samples_ET.mat, Despicable, 60, 6827408540, 6997953215, 170544675
/Volumes/methlab_data/HBN/EEG-ET/NDARHU954TM0/NDARHU954TM0_Video-FF_Samples_ET.mat, Fractals, 60, 5940150044, 6103131287, 162981243
/Volumes/methlab_data/HBN/EEG-ET/NDARHU954TM0/NDARHU954TM0_Video-TP_Samples_ET.mat, Present, 60, 7424011490, 7627081133, 203069643
/Volumes/methlab_data/HBN/EEG-ET/NDARHU954TM0/NDARHU954TM0_Video-WK_Samples_ET.mat, Diary, 60, 4743789857, 4861181898, 117392041
/Volumes/methlab_data/HBN/EEG-ET/NDARHV260FPW/NDARHV260FPW_Video-DM_Samples_ET.mat, Despicable, 30, 4238986256, 4409539633, 170553377
/Volumes/methlab_data/HBN/EEG-ET/NDARHV260FPW/NDARHV260FPW_Video-TP_Samples_ET.mat, Present, 30, 5276884570, 5480162017, 203277447
/Volumes/methlab_data/HBN/EEG-ET/NDARHV260FPW/NDARHV260FPW_Video-WK_Samples_ET.mat, Diary, 30, 4800262280, 4917648122, 117385842
/Volumes/methlab_data/HBN/EEG-ET/NDARHV358ZCU/NDARHV358ZCU_Video-DM_Samples_ET.mat, Despicable, 30, 4910473894, 5081007240, 170533346
/Volumes/methlab_data/HBN/EEG-ET/NDARHV358ZCU/NDARHV358ZCU_Video-TP_Samples_ET.mat, Present, 30, 5974380592, 6177645997, 203265405
/Volumes/methlab_data/HBN/EEG-ET/NDARHV358ZCU/NDARHV358ZCU_Video-WK_Samples_ET.mat, Diary, 30, 5391636391, 5509023240, 117386849
/Volumes/methlab_data/HBN/EEG-ET/NDARHV423JV3/NDARHV423JV3_Video-WK_Samples_ET.mat, Diary, 30, 5510643914, 5628029707, 117385793
/Volumes/methlab_data/HBN/EEG-ET/NDARHV527DNK/NDARHV527DNK_Video1_Samples_ET.mat, Diary, 60, 3439105078, 3556500578, 117395500
/Volumes/methlab_data/HBN/EEG-ET/NDARHV527DNK/NDARHV527DNK_Video3_Samples_ET.mat, Despicable, 60, 2978307406, 3148851715, 170544309
/Volumes/methlab_data/HBN/EEG-ET/NDARHV885JFU/NDARHV885JFU_Video-DM_Samples_ET.mat, Despicable, 30, 3605813535, 3776352996, 170539461
/Volumes/methlab_data/HBN/EEG-ET/NDARHV885JFU/NDARHV885JFU_Video-TP_Samples_ET.mat, Present, 30, 4130631209, 4333894793, 203263584
/Volumes/methlab_data/HBN/EEG-ET/NDARHV885JFU/NDARHV885JFU_Video-WK_Samples_ET.mat, Diary, 30, 2232635675, 2350024601, 117388926
/Volumes/methlab_data/HBN/EEG-ET/NDARHW467TA8/NDARHW467TA8_Video-DM_Samples_ET.mat, Despicable, 60, 3733220477, 3903764159, 170543682
/Volumes/methlab_data/HBN/EEG-ET/NDARHW467TA8/NDARHW467TA8_Video-FF_Samples_ET.mat, Fractals, 60, 2659126425, 2822117765, 162991340
/Volumes/methlab_data/HBN/EEG-ET/NDARHW467TA8/NDARHW467TA8_Video-TP_Samples_ET.mat, Present, 60, 4214463022, 4417524727, 203061705
/Volumes/methlab_data/HBN/EEG-ET/NDARHW467TA8/NDARHW467TA8_Video-WK_Samples_ET.mat, Diary, 60, 3351042034, 3468435127, 117393093
/Volumes/methlab_data/HBN/EEG-ET/NDARHW650FXU/NDARHW650FXU_Video1_Samples_ET.mat, Diary, 60, 8079570540, 8196958410, 117387870
/Volumes/methlab_data/HBN/EEG-ET/NDARHW650FXU/NDARHW650FXU_Video3_Samples_ET.mat, Despicable, 60, 7642527993, 7813065399, 170537406
/Volumes/methlab_data/HBN/EEG-ET/NDARHW718DTW/NDARHW718DTW_Video1_Samples_ET.mat, Diary, 60, 1833807348, 1951204350, 117397002
/Volumes/methlab_data/HBN/EEG-ET/NDARHW718DTW/NDARHW718DTW_Video3_Samples_ET.mat, Despicable, 60, 3044279146, 3214821742, 170542596
/Volumes/methlab_data/HBN/EEG-ET/NDARHW808VDT/NDARHW808VDT_Video-TP_Samples_ET.mat, Present, 30, 6201458915, 6404735426, 203276511
/Volumes/methlab_data/HBN/EEG-ET/NDARHW808VDT/NDARHW808VDT_Video-WK_Samples_ET.mat, Diary, 30, 4809253111, 4926639995, 117386884
/Volumes/methlab_data/HBN/EEG-ET/NDARHW933UVJ/NDARHW933UVJ_Video1_Samples_ET.mat, Diary, 120, 6760785974, 6878181862, 117395888
/Volumes/methlab_data/HBN/EEG-ET/NDARHW933UVJ/NDARHW933UVJ_Video2_Samples_ET.mat, Fractals, 120, 7711389957, 7874375626, 162985669
/Volumes/methlab_data/HBN/EEG-ET/NDARHW933UVJ/NDARHW933UVJ_Video3_Samples_ET.mat, Despicable, 120, 8173845133, 8344393647, 170548514
/Volumes/methlab_data/HBN/EEG-ET/NDARHW933UVJ/NDARHW933UVJ_Video4_Samples_ET.mat, Present, 120, 8915781802, 9118859502, 203077700
/Volumes/methlab_data/HBN/EEG-ET/NDARHW968ABB/NDARHW968ABB_Video-DM_Samples_ET.mat, Despicable, 60, 3592833174, 3763373737, 170540563
/Volumes/methlab_data/HBN/EEG-ET/NDARHW968ABB/NDARHW968ABB_Video-FF_Samples_ET.mat, Fractals, 60, 3380011804, 3542999008, 162987204
/Volumes/methlab_data/HBN/EEG-ET/NDARHW968ABB/NDARHW968ABB_Video-TP_Samples_ET.mat, Present, 60, 4289368978, 4492435905, 203066927
/Volumes/methlab_data/HBN/EEG-ET/NDARHW968ABB/NDARHW968ABB_Video-WK_Samples_ET.mat, Diary, 60, 3851464945, 3968854927, 117389982
/Volumes/methlab_data/HBN/EEG-ET/NDARHX145ZKV/NDARHX145ZKV_Video1_Samples_ET.mat, Despicable, 120, 3365429494, 3535976010, 170546516
/Volumes/methlab_data/HBN/EEG-ET/NDARHX145ZKV/NDARHX145ZKV_Video2_Samples_ET.mat, Diary, 120, 3560907818, 3678305049, 117397231
/Volumes/methlab_data/HBN/EEG-ET/NDARHX145ZKV/NDARHX145ZKV_Video3_Samples_ET.mat, Fractals, 120, 3698426004, 3861413627, 162987623
/Volumes/methlab_data/HBN/EEG-ET/NDARHX145ZKV/NDARHX145ZKV_Video4_Samples_ET.mat, Present, 120, 3882584379, 4085652020, 203067641
/Volumes/methlab_data/HBN/EEG-ET/NDARHX252NVH/NDARHX252NVH_Video-DM_Samples_ET.mat, Despicable, 60, 4839004745, 5009547408, 170542663
/Volumes/methlab_data/HBN/EEG-ET/NDARHX252NVH/NDARHX252NVH_Video-FF_Samples_ET.mat, Fractals, 60, 4411738543, 4574721836, 162983293
/Volumes/methlab_data/HBN/EEG-ET/NDARHX252NVH/NDARHX252NVH_Video-TP_Samples_ET.mat, Present, 60, 5314539071, 5517600714, 203061643
/Volumes/methlab_data/HBN/EEG-ET/NDARHX252NVH/NDARHX252NVH_Video-WK_Samples_ET.mat, Diary, 60, 3533749577, 3651142613, 117393036
/Volumes/methlab_data/HBN/EEG-ET/NDARHX418ZGJ/NDARHX418ZGJ_Video-DM_Samples_ET.mat, Despicable, 120, 5307187533, 5477734449, 170546916
/Volumes/methlab_data/HBN/EEG-ET/NDARHX418ZGJ/NDARHX418ZGJ_Video-FF_Samples_ET.mat, Fractals, 120, 4722659684, 4885649835, 162990151
/Volumes/methlab_data/HBN/EEG-ET/NDARHX418ZGJ/NDARHX418ZGJ_Video-TP_Samples_ET.mat, Present, 120, 6078243222, 6281310660, 203067438
/Volumes/methlab_data/HBN/EEG-ET/NDARHX418ZGJ/NDARHX418ZGJ_Video-WK_Samples_ET.mat, Diary, 120, 3531880087, 3649265610, 117385523
/Volumes/methlab_data/HBN/EEG-ET/NDARHX628PC6/NDARHX628PC6_Video1_Samples_ET.mat, Diary, 120, 5662982014, 5780377844, 117395830
/Volumes/methlab_data/HBN/EEG-ET/NDARHX628PC6/NDARHX628PC6_Video2_Samples_ET.mat, Despicable, 120, 7089062214, 7259610098, 170547884
/Volumes/methlab_data/HBN/EEG-ET/NDARHX628PC6/NDARHX628PC6_Video3_Samples_ET.mat, Fractals, 120, 7672029093, 7835017130, 162988037
/Volumes/methlab_data/HBN/EEG-ET/NDARHX628PC6/NDARHX628PC6_Video4_Samples_ET.mat, Present, 120, 8442875607, 8645942473, 203066866
/Volumes/methlab_data/HBN/EEG-ET/NDARHX739YBW/NDARHX739YBW_Video1_Samples_ET.mat, Diary, 60, 5891311570, 6008709469, 117397899
/Volumes/methlab_data/HBN/EEG-ET/NDARHX739YBW/NDARHX739YBW_Video3_Samples_ET.mat, Despicable, 60, 7101240704, 7271783151, 170542447
/Volumes/methlab_data/HBN/EEG-ET/NDARHX877BLQ/NDARHX877BLQ_Video1_Samples_ET.mat, Diary, 60, 2400307238, 2517696249, 117389011
/Volumes/methlab_data/HBN/EEG-ET/NDARHX877BLQ/NDARHX877BLQ_Video3_Samples_ET.mat, Despicable, 60, 2763915324, 2934454903, 170539579
/Volumes/methlab_data/HBN/EEG-ET/NDARHX934KJ5/NDARHX934KJ5_Video1_Samples_ET.mat, Diary, 120, 6751030858, 6868418353, 117387495
/Volumes/methlab_data/HBN/EEG-ET/NDARHX934KJ5/NDARHX934KJ5_Video2_Samples_ET.mat, Fractals, 120, 7272227855, 7435224971, 162997116
/Volumes/methlab_data/HBN/EEG-ET/NDARHX934KJ5/NDARHX934KJ5_Video3_Samples_ET.mat, Despicable, 120, 7791005823, 7961552932, 170547109
/Volumes/methlab_data/HBN/EEG-ET/NDARHX934KJ5/NDARHX934KJ5_Video4_Samples_ET.mat, Present, 120, 8536322283, 8739390102, 203067819
/Volumes/methlab_data/HBN/EEG-ET/NDARHY177LY9/NDARHY177LY9_Video1_Samples_ET.mat, Diary, 60, 2976014817, 3093407908, 117393091
/Volumes/methlab_data/HBN/EEG-ET/NDARHY177LY9/NDARHY177LY9_Video3_Samples_ET.mat, Despicable, 60, 2547206386, 2717751102, 170544716
/Volumes/methlab_data/HBN/EEG-ET/NDARHY255FVU/NDARHY255FVU_Video1_Samples_ET.mat, Despicable, 120, 3077931705, 3163629556, 3334178066
2.562464e+08, 1.705485e+08, /Volumes/methlab_data/HBN/EEG-ET/NDARHY255FVU/NDARHY255FVU_Video2_Samples_ET.mat, Fractals, 120, 3380387057, 3543370768, 162983711
/Volumes/methlab_data/HBN/EEG-ET/NDARHY255FVU/NDARHY255FVU_Video3_Samples_ET.mat, Diary, 120, 3600124348, 3717512428, 117388080
/Volumes/methlab_data/HBN/EEG-ET/NDARHY255FVU/NDARHY255FVU_Video4_Samples_ET.mat, Present, 120, 3768576090, 3971643253, 203067163
/Volumes/methlab_data/HBN/EEG-ET/NDARHZ255RA6/NDARHZ255RA6_Video1_Samples_ET.mat, Diary, 60, 3374089112, 3491486685, 117397573
/Volumes/methlab_data/HBN/EEG-ET/NDARHZ255RA6/NDARHZ255RA6_Video3_Samples_ET.mat, Despicable, 60, 2560547094, 2731087488, 170540394
/Volumes/methlab_data/HBN/EEG-ET/NDARHZ375JRF/NDARHZ375JRF_Video-DM_Samples_ET.mat, Despicable, 60, 5068088199, 5238627011, 170538812
/Volumes/methlab_data/HBN/EEG-ET/NDARHZ375JRF/NDARHZ375JRF_Video-TP_Samples_ET.mat, Present, 60, 5525444163, 5728721181, 203277018
/Volumes/methlab_data/HBN/EEG-ET/NDARHZ375JRF/NDARHZ375JRF_Video-WK_Samples_ET.mat, Diary, 60, 3933195305, 4050584474, 117389169
/Volumes/methlab_data/HBN/EEG-ET/NDARHZ413DZL/NDARHZ413DZL_Video-DM_Samples_ET.mat, Despicable, 120, 3143421251, 3313976143, 170554892
/Volumes/methlab_data/HBN/EEG-ET/NDARHZ413DZL/NDARHZ413DZL_Video-FF_Samples_ET.mat, Fractals, 120, 3848495982, 4011479536, 162983554
/Volumes/methlab_data/HBN/EEG-ET/NDARHZ413DZL/NDARHZ413DZL_Video-WK_Samples_ET.mat, Diary, 120, 3650020851, 3767411493, 117390642
/Volumes/methlab_data/HBN/EEG-ET/NDARHZ439EBY/NDARHZ439EBY_Video1_Samples_ET.mat, Diary, 60, 3245219311, 3362620367, 117401056
/Volumes/methlab_data/HBN/EEG-ET/NDARHZ439EBY/NDARHZ439EBY_Video3_Samples_ET.mat, Despicable, 60, 4677026980, 4847571680, 170544700
/Volumes/methlab_data/HBN/EEG-ET/NDARHZ476MJP/NDARHZ476MJP_Video-DM_Samples_ET.mat, Despicable, 120, 6948396084, 7118943778, 170547694
/Volumes/methlab_data/HBN/EEG-ET/NDARHZ476MJP/NDARHZ476MJP_Video-FF_Samples_ET.mat, Fractals, 120, 6407678889, 6570667292, 162988403
/Volumes/methlab_data/HBN/EEG-ET/NDARHZ476MJP/NDARHZ476MJP_Video-TP_Samples_ET.mat, Present, 120, 7720861761, 7923929101, 203067340
/Volumes/methlab_data/HBN/EEG-ET/NDARHZ476MJP/NDARHZ476MJP_Video-WK_Samples_ET.mat, Diary, 120, 5537675134, 5655072243, 117397109
/Volumes/methlab_data/HBN/EEG-ET/NDARHZ814MHQ/NDARHZ814MHQ_Video-DM_Samples_ET.mat, Despicable, 60, 8274143124, 8444685784, 170542660
/Volumes/methlab_data/HBN/EEG-ET/NDARHZ814MHQ/NDARHZ814MHQ_Video-FF_Samples_ET.mat, Fractals, 60, 7835817545, 7998811693, 162994148
/Volumes/methlab_data/HBN/EEG-ET/NDARHZ814MHQ/NDARHZ814MHQ_Video-TP_Samples_ET.mat, Present, 60, 8872071431, 9075133882, 203062451
/Volumes/methlab_data/HBN/EEG-ET/NDARHZ814MHQ/NDARHZ814MHQ_Video-WK_Samples_ET.mat, Diary, 60, 7251870139, 7369264044, 117393905
/Volumes/methlab_data/HBN/EEG-ET/NDARHZ852XY0/NDARHZ852XY0_Video-DM_Samples_ET.mat, Despicable, 30, 2003122271, 2173661597, 170539326
/Volumes/methlab_data/HBN/EEG-ET/NDARHZ852XY0/NDARHZ852XY0_Video-TP_Samples_ET.mat, Present, 30, 2957651735, 3160929184, 203277449
/Volumes/methlab_data/HBN/EEG-ET/NDARJ257ZU2_/NDARJ257ZU2__Video1_Samples_ET.mat, Diary, 60, 4559743966, 4677141784, 117397818
/Volumes/methlab_data/HBN/EEG-ET/NDARJ257ZU2_/NDARJ257ZU2__Video2_Samples_ET.mat, Fractals, 60, 3435746329, 3598735269, 162988940
/Volumes/methlab_data/HBN/EEG-ET/NDARJ257ZU2_/NDARJ257ZU2__Video3_Samples_ET.mat, Despicable, 60, 4069929537, 4240477835, 170548298
/Volumes/methlab_data/HBN/EEG-ET/NDARJ257ZU2_/NDARJ257ZU2__Video4_Samples_ET.mat, Present, 60, 4987367548, 5190434766, 203067218
/Volumes/methlab_data/HBN/EEG-ET/NDARJA166LHK/NDARJA166LHK_Video1_Samples_ET.mat, Despicable, 120, 6481337891, 6651884845, 170546954
/Volumes/methlab_data/HBN/EEG-ET/NDARJA166LHK/NDARJA166LHK_Video2_Samples_ET.mat, Fractals, 120, 6760645043, 6923632567, 162987524
/Volumes/methlab_data/HBN/EEG-ET/NDARJA166LHK/NDARJA166LHK_Video3_Samples_ET.mat, Diary, 120, 6972480334, 7089869765, 117389431
/Volumes/methlab_data/HBN/EEG-ET/NDARJA166LHK/NDARJA166LHK_Video4_Samples_ET.mat, Present, 120, 7186843077, 7389910986, 203067909
/Volumes/methlab_data/HBN/EEG-ET/NDARJA262HTY/NDARJA262HTY_Video1_Samples_ET.mat, Fractals, 120, 4176741381, 4339727677, 162986296
/Volumes/methlab_data/HBN/EEG-ET/NDARJA262HTY/NDARJA262HTY_Video2_Samples_ET.mat, Diary, 120, 5025507667, 5142903735, 117396068
/Volumes/methlab_data/HBN/EEG-ET/NDARJA262HTY/NDARJA262HTY_Video3_Samples_ET.mat, Despicable, 120, 5419574394, 5590121940, 170547546
/Volumes/methlab_data/HBN/EEG-ET/NDARJA262HTY/NDARJA262HTY_Video4_Samples_ET.mat, Present, 120, 6119321747, 6322388733, 203066986
/Volumes/methlab_data/HBN/EEG-ET/NDARJA315FUQ/NDARJA315FUQ_Video-DM_Samples_ET.mat, Despicable, 60, 4801416200, 4971955527, 170539327
/Volumes/methlab_data/HBN/EEG-ET/NDARJA315FUQ/NDARJA315FUQ_Video-FF_Samples_ET.mat, Fractals, 60, 4564098725, 4727075788, 162977063
/Volumes/methlab_data/HBN/EEG-ET/NDARJA315FUQ/NDARJA315FUQ_Video-TP_Samples_ET.mat, Present, 60, 5093316128, 5296385425, 203069297
/Volumes/methlab_data/HBN/EEG-ET/NDARJA315FUQ/NDARJA315FUQ_Video-WK_Samples_ET.mat, Diary, 60, 4375801863, 4493194741, 117392878
/Volumes/methlab_data/HBN/EEG-ET/NDARJA356XHT/NDARJA356XHT_Video-DM_Samples_ET.mat, Despicable, 60, 4188196522, 4358749075, 170552553
/Volumes/methlab_data/HBN/EEG-ET/NDARJA356XHT/NDARJA356XHT_Video-FF_Samples_ET.mat, Fractals, 60, 3745367608, 3908345801, 162978193
/Volumes/methlab_data/HBN/EEG-ET/NDARJA356XHT/NDARJA356XHT_Video-TP_Samples_ET.mat, Present, 60, 4672540794, 4875602320, 203061526
/Volumes/methlab_data/HBN/EEG-ET/NDARJA356XHT/NDARJA356XHT_Video-WK_Samples_ET.mat, Diary, 60, 3026687750, 3144082733, 117394983
/Volumes/methlab_data/HBN/EEG-ET/NDARJA737FAJ/NDARJA737FAJ_Video1_Samples_ET.mat, Diary, 60, 2834177875, 2951568021, 117390146
/Volumes/methlab_data/HBN/EEG-ET/NDARJA737FAJ/NDARJA737FAJ_Video2_Samples_ET.mat, Fractals, 60, 1667212283, 1830204718, 162992435
/Volumes/methlab_data/HBN/EEG-ET/NDARJA737FAJ/NDARJA737FAJ_Video3_Samples_ET.mat, Despicable, 60, 2345040377, 2515583363, 170542986
/Volumes/methlab_data/HBN/EEG-ET/NDARJA737FAJ/NDARJA737FAJ_Video4_Samples_ET.mat, Present, 60, 3277074570, 3480142805, 203068235
/Volumes/methlab_data/HBN/EEG-ET/NDARJA788CH7/NDARJA788CH7_Video1_Samples_ET.mat, Diary, 120, 4797019262, 4914416038, 117396776
/Volumes/methlab_data/HBN/EEG-ET/NDARJA788CH7/NDARJA788CH7_Video2_Samples_ET.mat, Fractals, 120, 5691184030, 5854165300, 162981270
/Volumes/methlab_data/HBN/EEG-ET/NDARJA788CH7/NDARJA788CH7_Video3_Samples_ET.mat, Despicable, 120, 6136865681, 6307404217, 170538536
/Volumes/methlab_data/HBN/EEG-ET/NDARJA788CH7/NDARJA788CH7_Video4_Samples_ET.mat, Present, 120, 6826664397, 7029728302, 203063905
/Volumes/methlab_data/HBN/EEG-ET/NDARJA830BYV/NDARJA830BYV_Video1_Samples_ET.mat, Diary, 60, 3656033883, 3773430546, 117396663
/Volumes/methlab_data/HBN/EEG-ET/NDARJA830BYV/NDARJA830BYV_Video2_Samples_ET.mat, Fractals, 60, 2196785251, 2359768414, 162983163
/Volumes/methlab_data/HBN/EEG-ET/NDARJA830BYV/NDARJA830BYV_Video3_Samples_ET.mat, Despicable, 60, 3186860620, 3357402191, 170541571
/Volumes/methlab_data/HBN/EEG-ET/NDARJA830BYV/NDARJA830BYV_Video4_Samples_ET.mat, Present, 60, 4116092652, 4319155344, 203062692
/Volumes/methlab_data/HBN/EEG-ET/NDARJB027GMR/NDARJB027GMR_Video1_Samples_ET.mat, Diary, 60, 2518218627, 2635612565, 117393938
/Volumes/methlab_data/HBN/EEG-ET/NDARJB027GMR/NDARJB027GMR_Video3_Samples_ET.mat, Despicable, 60, 3105268244, 3275809731, 170541487
/Volumes/methlab_data/HBN/EEG-ET/NDARJB233RL7/NDARJB233RL7_Video1_Samples_ET.mat, Diary, 60, 4000064114, 4117449211, 117385097
/Volumes/methlab_data/HBN/EEG-ET/NDARJB233RL7/NDARJB233RL7_Video2_Samples_ET.mat, Fractals, 60, 2992496136, 3155482496, 162986360
/Volumes/methlab_data/HBN/EEG-ET/NDARJB233RL7/NDARJB233RL7_Video3_Samples_ET.mat, Despicable, 60, 3557359822, 3727907559, 170547737
/Volumes/methlab_data/HBN/EEG-ET/NDARJB233RL7/NDARJB233RL7_Video4_Samples_ET.mat, Present, 60, 4426563917, 4629623638, 203059721
/Volumes/methlab_data/HBN/EEG-ET/NDARJB355YHK/NDARJB355YHK_Video1_Samples_ET.mat, Diary, 60, 6860304205, 6977697383, 117393178
/Volumes/methlab_data/HBN/EEG-ET/NDARJB355YHK/NDARJB355YHK_Video3_Samples_ET.mat, Despicable, 60, 6358528754, 6529072583, 170543829
/Volumes/methlab_data/HBN/EEG-ET/NDARJB366HYJ/NDARJB366HYJ_Video1_Samples_ET.mat, Diary, 60, 71782916564, 71900311631, 117395067
/Volumes/methlab_data/HBN/EEG-ET/NDARJB366HYJ/NDARJB366HYJ_Video2_Samples_ET.mat, Fractals, 60, 72374638245, 72537629615, 162991370
/Volumes/methlab_data/HBN/EEG-ET/NDARJB366HYJ/NDARJB366HYJ_Video3_Samples_ET.mat, Despicable, 60, 72877621198, 73048164086, 170542888
/Volumes/methlab_data/HBN/EEG-ET/NDARJB366HYJ/NDARJB366HYJ_Video4_Samples_ET.mat, Present, 60, 73481121235, 73684191946, 203070711
/Volumes/methlab_data/HBN/EEG-ET/NDARJB501MJL/NDARJB501MJL_Video-DM_Samples_ET.mat, Despicable, 60, 2937538605, 3108082424, 170543819
/Volumes/methlab_data/HBN/EEG-ET/NDARJB501MJL/NDARJB501MJL_Video-FF_Samples_ET.mat, Fractals, 60, 2493525087, 2656540569, 163015482
/Volumes/methlab_data/HBN/EEG-ET/NDARJB501MJL/NDARJB501MJL_Video-TP_Samples_ET.mat, Present, 60, 3472853781, 3675921626, 203067845
/Volumes/methlab_data/HBN/EEG-ET/NDARJB501MJL/NDARJB501MJL_Video-WK_Samples_ET.mat, Diary, 60, 1967988830, 2085384010, 117395180
/Volumes/methlab_data/HBN/EEG-ET/NDARJB548ML8/NDARJB548ML8_Video-DM_Samples_ET.mat, Despicable, 30, 3255285734, 3425825027, 170539293
/Volumes/methlab_data/HBN/EEG-ET/NDARJB548ML8/NDARJB548ML8_Video-WK_Samples_ET.mat, Diary, 30, 2463424310, 2580811107, 117386797
/Volumes/methlab_data/HBN/EEG-ET/NDARJC010YYF/NDARJC010YYF_Video1_Samples_ET.mat, Fractals, 120, 5401876960, 5564863808, 162986848
/Volumes/methlab_data/HBN/EEG-ET/NDARJC010YYF/NDARJC010YYF_Video2_Samples_ET.mat, Diary, 120, 7170509060, 7287907098, 117398038
/Volumes/methlab_data/HBN/EEG-ET/NDARJC010YYF/NDARJC010YYF_Video3_Samples_ET.mat, Despicable, 120, 7588357145, 7758904925, 170547780
/Volumes/methlab_data/HBN/EEG-ET/NDARJC010YYF/NDARJC010YYF_Video4_Samples_ET.mat, Present, 120, 8236744999, 8439810646, 203065647
/Volumes/methlab_data/HBN/EEG-ET/NDARJC299PRZ/NDARJC299PRZ_Video-DM_Samples_ET.mat, Despicable, 60, 1871140033, 2041676625, 170536592
/Volumes/methlab_data/HBN/EEG-ET/NDARJC299PRZ/NDARJC299PRZ_Video-TP_Samples_ET.mat, Present, 60, 2834150887, 3037417622, 203266735
/Volumes/methlab_data/HBN/EEG-ET/NDARJC299PRZ/NDARJC299PRZ_Video-WK_Samples_ET.mat, Diary, 60, 2404274944, 2521660971, 117386027
/Volumes/methlab_data/HBN/EEG-ET/NDARJC463HCM/NDARJC463HCM_Video-DM_Samples_ET.mat, Despicable, 60, 3504967602, 3675504822, 170537220
/Volumes/methlab_data/HBN/EEG-ET/NDARJC463HCM/NDARJC463HCM_Video-FF_Samples_ET.mat, Fractals, 60, 3071530536, 3234519389, 162988853
/Volumes/methlab_data/HBN/EEG-ET/NDARJC463HCM/NDARJC463HCM_Video-TP_Samples_ET.mat, Present, 60, 3983461682, 4186530039, 203068357
/Volumes/methlab_data/HBN/EEG-ET/NDARJC463HCM/NDARJC463HCM_Video-WK_Samples_ET.mat, Diary, 60, 2356780535, 2474173987, 117393452
/Volumes/methlab_data/HBN/EEG-ET/NDARJC559WW5/NDARJC559WW5_Video1_Samples_ET.mat, Diary, 60, 1313421389, 1430813327, 117391938
/Volumes/methlab_data/HBN/EEG-ET/NDARJC559WW5/NDARJC559WW5_Video3_Samples_ET.mat, Despicable, 60, 870323282, 1040866781, 170543499
/Volumes/methlab_data/HBN/EEG-ET/NDARJC559WW5/NDARJC559WW5_Video4_Samples_ET.mat, Present, 60, 1772923074, 1975983570, 203060496
/Volumes/methlab_data/HBN/EEG-ET/NDARJC644YL7/NDARJC644YL7_Video-FF_Samples_ET.mat, Fractals, 60, 3099039234, 3262033421, 162994187
/Volumes/methlab_data/HBN/EEG-ET/NDARJD142DHR/NDARJD142DHR_Video-DM_Samples_ET.mat, Despicable, 60, 4204991044, 4375529658, 170538614
/Volumes/methlab_data/HBN/EEG-ET/NDARJD142DHR/NDARJD142DHR_Video-TP_Samples_ET.mat, Present, 60, 4695215650, 4898493371, 203277721
/Volumes/methlab_data/HBN/EEG-ET/NDARJD142DHR/NDARJD142DHR_Video-WK_Samples_ET.mat, Diary, 60, 3746917251, 3864314201, 117396950
/Volumes/methlab_data/HBN/EEG-ET/NDARJD235KZA/NDARJD235KZA_Video-DM_Samples_ET.mat, Despicable, 60, 2348707291, 2519250877, 170543586
/Volumes/methlab_data/HBN/EEG-ET/NDARJD235KZA/NDARJD235KZA_Video-FF_Samples_ET.mat, Fractals, 60, 1849044021, 2012027348, 162983327
/Volumes/methlab_data/HBN/EEG-ET/NDARJD235KZA/NDARJD235KZA_Video-TP_Samples_ET.mat, Present, 60, 3223054453, 3426114024, 203059571
/Volumes/methlab_data/HBN/EEG-ET/NDARJD235KZA/NDARJD235KZA_Video-WK_Samples_ET.mat, Diary, 60, 2796366784, 2913759818, 117393034
/Volumes/methlab_data/HBN/EEG-ET/NDARJD387HWG/NDARJD387HWG_Video1_Samples_ET.mat, Diary, 60, 2656358871, 2773758220, 117399349
/Volumes/methlab_data/HBN/EEG-ET/NDARJD387HWG/NDARJD387HWG_Video3_Samples_ET.mat, Despicable, 60, 2211402044, 2381948503, 170546459
/Volumes/methlab_data/HBN/EEG-ET/NDARJD704KEM/NDARJD704KEM_Video-DM_Samples_ET.mat, Despicable, 60, 4939330430, 5109880844, 170550414
/Volumes/methlab_data/HBN/EEG-ET/NDARJD704KEM/NDARJD704KEM_Video-TP_Samples_ET.mat, Present, 60, 5485617060, 5688894579, 203277519
/Volumes/methlab_data/HBN/EEG-ET/NDARJD704KEM/NDARJD704KEM_Video-WK_Samples_ET.mat, Diary, 60, 3996612911, 4113997802, 117384891
/Volumes/methlab_data/HBN/EEG-ET/NDARJE070PLA/NDARJE070PLA_Video-DM_Samples_ET.mat, Despicable, 60, 4750273784, 4920817339, 170543555
/Volumes/methlab_data/HBN/EEG-ET/NDARJE070PLA/NDARJE070PLA_Video-FF_Samples_ET.mat, Fractals, 60, 5294185135, 5457179323, 162994188
/Volumes/methlab_data/HBN/EEG-ET/NDARJE070PLA/NDARJE070PLA_Video-TP_Samples_ET.mat, Present, 60, 5811308554, 6014373151, 203064597
/Volumes/methlab_data/HBN/EEG-ET/NDARJE070PLA/NDARJE070PLA_Video-WK_Samples_ET.mat, Diary, 60, 4005781668, 4123174667, 117392999
/Volumes/methlab_data/HBN/EEG-ET/NDARJE086YU0/NDARJE086YU0_Video1_Samples_ET.mat, Diary, 60, 1838278789, 1955679509, 117400720
/Volumes/methlab_data/HBN/EEG-ET/NDARJE086YU0/NDARJE086YU0_Video3_Samples_ET.mat, Despicable, 60, 3199172854, 3369713412, 170540558
/Volumes/methlab_data/HBN/EEG-ET/NDARJE496HC2/NDARJE496HC2_Video-DM_Samples_ET.mat, Despicable, 60, 6338224069, 6508765869, 170541800
/Volumes/methlab_data/HBN/EEG-ET/NDARJE496HC2/NDARJE496HC2_Video-FF_Samples_ET.mat, Fractals, 60, 6558203885, 6721198345, 162994460
/Volumes/methlab_data/HBN/EEG-ET/NDARJE496HC2/NDARJE496HC2_Video-TP_Samples_ET.mat, Present, 60, 6772246480, 6975309361, 203062881
/Volumes/methlab_data/HBN/EEG-ET/NDARJE496HC2/NDARJE496HC2_Video-WK_Samples_ET.mat, Diary, 60, 5501701529, 5619094672, 117393143
/Volumes/methlab_data/HBN/EEG-ET/NDARJE686DJL/NDARJE686DJL_Video1_Samples_ET.mat, Fractals, 120, 5752645884, 5915631528, 162985644
/Volumes/methlab_data/HBN/EEG-ET/NDARJE686DJL/NDARJE686DJL_Video2_Samples_ET.mat, Despicable, 120, 6712046739, 6882589315, 170542576
/Volumes/methlab_data/HBN/EEG-ET/NDARJE686DJL/NDARJE686DJL_Video3_Samples_ET.mat, Diary, 120, 7312235198, 7429632625, 117397427
/Volumes/methlab_data/HBN/EEG-ET/NDARJE686DJL/NDARJE686DJL_Video4_Samples_ET.mat, Present, 120, 8022360697, 8225428298, 203067601
/Volumes/methlab_data/HBN/EEG-ET/NDARJF027UGB/NDARJF027UGB_Video1_Samples_ET.mat, Diary, 120, 3266359899, 3383756371, 117396472
/Volumes/methlab_data/HBN/EEG-ET/NDARJF027UGB/NDARJF027UGB_Video2_Samples_ET.mat, Fractals, 120, 4651443930, 4814428776, 162984846
/Volumes/methlab_data/HBN/EEG-ET/NDARJF027UGB/NDARJF027UGB_Video3_Samples_ET.mat, Despicable, 120, 5175048610, 5345594740, 170546130
/Volumes/methlab_data/HBN/EEG-ET/NDARJF027UGB/NDARJF027UGB_Video4_Samples_ET.mat, Present, 120, 5812574263, 6015640729, 203066466
/Volumes/methlab_data/HBN/EEG-ET/NDARJF045MHG/NDARJF045MHG_Video1_Samples_ET.mat, Diary, 60, 2766045387, 2883436433, 117391046
/Volumes/methlab_data/HBN/EEG-ET/NDARJF045MHG/NDARJF045MHG_Video3_Samples_ET.mat, Despicable, 60, 2226500806, 2397043409, 170542603
/Volumes/methlab_data/HBN/EEG-ET/NDARJF322BN4/NDARJF322BN4_Video-DM_Samples_ET.mat, Despicable, 60, 5058190332, 5228731739, 170541407
/Volumes/methlab_data/HBN/EEG-ET/NDARJF322BN4/NDARJF322BN4_Video-FF_Samples_ET.mat, Fractals, 60, 6651403067, 6814395107, 162992040
/Volumes/methlab_data/HBN/EEG-ET/NDARJF322BN4/NDARJF322BN4_Video-TP_Samples_ET.mat, Present, 60, 7154224982, 7357286352, 203061370
/Volumes/methlab_data/HBN/EEG-ET/NDARJF322BN4/NDARJF322BN4_Video-WK_Samples_ET.mat, Diary, 60, 6239727455, 6357120291, 117392836
/Volumes/methlab_data/HBN/EEG-ET/NDARJF517HC8/NDARJF517HC8_Video1_Samples_ET.mat, Diary, 120, 9961117785, 10078507948, 117390163
/Volumes/methlab_data/HBN/EEG-ET/NDARJF517HC8/NDARJF517HC8_Video2_Samples_ET.mat, Fractals, 120, 10666684483, 10829681100, 162996617
/Volumes/methlab_data/HBN/EEG-ET/NDARJF517HC8/NDARJF517HC8_Video3_Samples_ET.mat, Despicable, 120, 11212738052, 11383278095, 170540043
/Volumes/methlab_data/HBN/EEG-ET/NDARJF517HC8/NDARJF517HC8_Video4_Samples_ET.mat, Present, 120, 11905277477, 12108344146, 203066669
/Volumes/methlab_data/HBN/EEG-ET/NDARJF565ZRA/NDARJF565ZRA_Video1_Samples_ET.mat, Diary, 120, 5350402694, 5467798985, 117396291
/Volumes/methlab_data/HBN/EEG-ET/NDARJF565ZRA/NDARJF565ZRA_Video2_Samples_ET.mat, Fractals, 120, 6420795367, 6583781819, 162986452
/Volumes/methlab_data/HBN/EEG-ET/NDARJF565ZRA/NDARJF565ZRA_Video3_Samples_ET.mat, Despicable, 120, 6897372155, 7067913080, 170540925
/Volumes/methlab_data/HBN/EEG-ET/NDARJF565ZRA/NDARJF565ZRA_Video4_Samples_ET.mat, Present, 120, 7540307570, 7743375884, 203068314
/Volumes/methlab_data/HBN/EEG-ET/NDARJF579EH9/NDARJF579EH9_Video1_Samples_ET.mat, Diary, 120, 3403192862, 3520589747, 117396885
/Volumes/methlab_data/HBN/EEG-ET/NDARJF579EH9/NDARJF579EH9_Video2_Samples_ET.mat, Despicable, 120, 3567301067, 3737848315, 170547248
/Volumes/methlab_data/HBN/EEG-ET/NDARJF579EH9/NDARJF579EH9_Video3_Samples_ET.mat, Fractals, 120, 3792413371, 3955399041, 162985670
/Volumes/methlab_data/HBN/EEG-ET/NDARJF579EH9/NDARJF579EH9_Video4_Samples_ET.mat, Present, 120, 4037248147, 4240315221, 203067074
/Volumes/methlab_data/HBN/EEG-ET/NDARJF792DKN/NDARJF792DKN_Video1_Samples_ET.mat, Diary, 60, 3360868416, 3478262941, 117394525
/Volumes/methlab_data/HBN/EEG-ET/NDARJF792DKN/NDARJF792DKN_Video3_Samples_ET.mat, Despicable, 60, 3754213207, 3924764546, 170551339
/Volumes/methlab_data/HBN/EEG-ET/NDARJG298YVA/NDARJG298YVA_Video1_Samples_ET.mat, Diary, 60, 5144090882, 5261484907, 117394025
/Volumes/methlab_data/HBN/EEG-ET/NDARJG298YVA/NDARJG298YVA_Video2_Samples_ET.mat, Fractals, 60, 5787577822, 5950561094, 162983272
/Volumes/methlab_data/HBN/EEG-ET/NDARJG298YVA/NDARJG298YVA_Video3_Samples_ET.mat, Despicable, 60, 6221603677, 6392146287, 170542610
/Volumes/methlab_data/HBN/EEG-ET/NDARJG298YVA/NDARJG298YVA_Video4_Samples_ET.mat, Present, 60, 6693967643, 6897030220, 203062577
/Volumes/methlab_data/HBN/EEG-ET/NDARJG300HWH/NDARJG300HWH_Video1_Samples_ET.mat, Diary, 60, 4578221729, 4695623666, 117401937
/Volumes/methlab_data/HBN/EEG-ET/NDARJG300HWH/NDARJG300HWH_Video3_Samples_ET.mat, Despicable, 60, 5045988271, 5216541944, 170553673
/Volumes/methlab_data/HBN/EEG-ET/NDARJG477THE/NDARJG477THE_Video1_Samples_ET.mat, Diary, 60, 8520019952, 8637410865, 117390913
/Volumes/methlab_data/HBN/EEG-ET/NDARJG477THE/NDARJG477THE_Video3_Samples_ET.mat, Despicable, 60, 8092842400, 8263392824, 170550424
/Volumes/methlab_data/HBN/EEG-ET/NDARJG494YDY/NDARJG494YDY_Video-DM_Samples_ET.mat, Despicable, 60, 5522265054, 5692812781, 170547727
/Volumes/methlab_data/HBN/EEG-ET/NDARJG494YDY/NDARJG494YDY_Video-FF_Samples_ET.mat, Fractals, 60, 5072610868, 5235598224, 162987356
/Volumes/methlab_data/HBN/EEG-ET/NDARJG494YDY/NDARJG494YDY_Video-TP_Samples_ET.mat, Present, 60, 6016737064, 6219806666, 203069602
/Volumes/methlab_data/HBN/EEG-ET/NDARJG494YDY/NDARJG494YDY_Video-WK_Samples_ET.mat, Diary, 60, 4295018635, 4412405821, 117387186
/Volumes/methlab_data/HBN/EEG-ET/NDARJG687YYX/NDARJG687YYX_Video1_Samples_ET.mat, Diary, 60, 4570195239, 4687590875, 117395636
/Volumes/methlab_data/HBN/EEG-ET/NDARJG687YYX/NDARJG687YYX_Video2_Samples_ET.mat, Fractals, 60, 3499196200, 3662179351, 162983151
/Volumes/methlab_data/HBN/EEG-ET/NDARJG687YYX/NDARJG687YYX_Video3_Samples_ET.mat, Despicable, 60, 4130131791, 4300673227, 170541436
/Volumes/methlab_data/HBN/EEG-ET/NDARJG687YYX/NDARJG687YYX_Video4_Samples_ET.mat, Present, 60, 4987587610, 5190648294, 203060684
/Volumes/methlab_data/HBN/EEG-ET/NDARJG738WY6/NDARJG738WY6_Video-DM_Samples_ET.mat, Despicable, 120, 15719174846, 15889718190, 170543344
/Volumes/methlab_data/HBN/EEG-ET/NDARJG738WY6/NDARJG738WY6_Video-FF_Samples_ET.mat, Fractals, 120, 15310540342, 15473528680, 162988338
/Volumes/methlab_data/HBN/EEG-ET/NDARJG738WY6/NDARJG738WY6_Video-TP_Samples_ET.mat, Present, 120, 16372877314, 16575942613, 203065299
/Volumes/methlab_data/HBN/EEG-ET/NDARJG738WY6/NDARJG738WY6_Video-WK_Samples_ET.mat, Diary, 120, 14479387299, 14596783442, 117396143
/Volumes/methlab_data/HBN/EEG-ET/NDARJG821GH3/NDARJG821GH3_Video1_Samples_ET.mat, Diary, 60, 6343663135, 6461055627, 117392492
/Volumes/methlab_data/HBN/EEG-ET/NDARJG821GH3/NDARJG821GH3_Video3_Samples_ET.mat, Despicable, 60, 5841550266, 6012089514, 170539248
/Volumes/methlab_data/HBN/EEG-ET/NDARJH367WKY/NDARJH367WKY_Video1_Samples_ET.mat, Diary, 60, 3503222080, 3620615132, 117393052
/Volumes/methlab_data/HBN/EEG-ET/NDARJH367WKY/NDARJH367WKY_Video2_Samples_ET.mat, Fractals, 60, 2538962089, 2701947370, 162985281
/Volumes/methlab_data/HBN/EEG-ET/NDARJH367WKY/NDARJH367WKY_Video3_Samples_ET.mat, Despicable, 60, 3910548156, 4081088817, 170540661
/Volumes/methlab_data/HBN/EEG-ET/NDARJH367WKY/NDARJH367WKY_Video4_Samples_ET.mat, Present, 60, 4419535156, 4622590790, 203055634
/Volumes/methlab_data/HBN/EEG-ET/NDARJH441HJD/NDARJH441HJD_Video1_Samples_ET.mat, Diary, 60, 3398676136, 3516069149, 117393013
/Volumes/methlab_data/HBN/EEG-ET/NDARJH441HJD/NDARJH441HJD_Video3_Samples_ET.mat, Despicable, 60, 2924099612, 3094643221, 170543609
/Volumes/methlab_data/HBN/EEG-ET/NDARJH492TVW/NDARJH492TVW_Video1_Samples_ET.mat, Diary, 60, 908890516, 1026286483, 117395967
/Volumes/methlab_data/HBN/EEG-ET/NDARJH492TVW/NDARJH492TVW_Video3_Samples_ET.mat, Despicable, 60, 471419386, 641957911, 170538525
/Volumes/methlab_data/HBN/EEG-ET/NDARJH492TVW/NDARJH492TVW_Video4_Samples_ET.mat, Present, 60, 1353895981, 1556965506, 203069525
/Volumes/methlab_data/HBN/EEG-ET/NDARJH513HZX/NDARJH513HZX_Video1_Samples_ET.mat, Diary, 120, 3166495329, 3283891347, 117396018
/Volumes/methlab_data/HBN/EEG-ET/NDARJH513HZX/NDARJH513HZX_Video2_Samples_ET.mat, Fractals, 120, 4382796800, 4545783505, 162986705
/Volumes/methlab_data/HBN/EEG-ET/NDARJH513HZX/NDARJH513HZX_Video3_Samples_ET.mat, Despicable, 120, 4887584378, 5058130873, 170546495
/Volumes/methlab_data/HBN/EEG-ET/NDARJH513HZX/NDARJH513HZX_Video4_Samples_ET.mat, Present, 120, 5546730589, 5749797516, 203066927
/Volumes/methlab_data/HBN/EEG-ET/NDARJH707GJM/NDARJH707GJM_Video1_Samples_ET.mat, Fractals, 120, 3352622641, 3515608893, 162986252
/Volumes/methlab_data/HBN/EEG-ET/NDARJH707GJM/NDARJH707GJM_Video2_Samples_ET.mat, Diary, 120, 4290662291, 4408051792, 117389501
/Volumes/methlab_data/HBN/EEG-ET/NDARJH707GJM/NDARJH707GJM_Video3_Samples_ET.mat, Despicable, 120, 4685252247, 4855800492, 170548245
/Volumes/methlab_data/HBN/EEG-ET/NDARJH707GJM/NDARJH707GJM_Video4_Samples_ET.mat, Present, 120, 5277388963, 5480457001, 203068038
/Volumes/methlab_data/HBN/EEG-ET/NDARJH763NPD/NDARJH763NPD_Video1_Samples_ET.mat, Diary, 120, 2891268287, 3008664219, 117395932
/Volumes/methlab_data/HBN/EEG-ET/NDARJH763NPD/NDARJH763NPD_Video2_Samples_ET.mat, Fractals, 120, 3750391224, 3913379217, 162987993
/Volumes/methlab_data/HBN/EEG-ET/NDARJH763NPD/NDARJH763NPD_Video3_Samples_ET.mat, Despicable, 120, 4292901547, 4463443778, 170542231
/Volumes/methlab_data/HBN/EEG-ET/NDARJH763NPD/NDARJH763NPD_Video4_Samples_ET.mat, Present, 120, 4930886232, 5133952857, 203066625
/Volumes/methlab_data/HBN/EEG-ET/NDARJH773JTJ/NDARJH773JTJ_Video-DM_Samples_ET.mat, Despicable, 60, 5886439275, 6056987940, 170548665
/Volumes/methlab_data/HBN/EEG-ET/NDARJH773JTJ/NDARJH773JTJ_Video-FF_Samples_ET.mat, Fractals, 60, 4651551887, 4814539186, 162987299
/Volumes/methlab_data/HBN/EEG-ET/NDARJH773JTJ/NDARJH773JTJ_Video-TP_Samples_ET.mat, Present, 60, 6474813416, 6677870088, 203056672
/Volumes/methlab_data/HBN/EEG-ET/NDARJH773JTJ/NDARJH773JTJ_Video-WK_Samples_ET.mat, Diary, 60, 5466426264, 5583813275, 117387011
/Volumes/methlab_data/HBN/EEG-ET/NDARJH910CGX/NDARJH910CGX_Video-DM_Samples_ET.mat, Despicable, 60, 4907798349, 5078346947, 170548598
/Volumes/methlab_data/HBN/EEG-ET/NDARJH910CGX/NDARJH910CGX_Video-FF_Samples_ET.mat, Fractals, 60, 4455741766, 4618731015, 162989249
/Volumes/methlab_data/HBN/EEG-ET/NDARJH910CGX/NDARJH910CGX_Video-TP_Samples_ET.mat, Present, 60, 5431298467, 5634369065, 203070598
/Volumes/methlab_data/HBN/EEG-ET/NDARJH910CGX/NDARJH910CGX_Video-WK_Samples_ET.mat, Diary, 60, 3670450578, 3787838568, 117387990
/Volumes/methlab_data/HBN/EEG-ET/NDARJH925ZCD/NDARJH925ZCD_Video1_Samples_ET.mat, Diary, 60, 1924892403, 2042285339, 117392936
/Volumes/methlab_data/HBN/EEG-ET/NDARJH925ZCD/NDARJH925ZCD_Video3_Samples_ET.mat, Despicable, 60, 3380595535, 3551136004, 170540469
/Volumes/methlab_data/HBN/EEG-ET/NDARJH99CWH_/NDARJH99CWH__Video1_Samples_ET.mat, Diary, 60, 3703108973, 3820498726, 117389753
/Volumes/methlab_data/HBN/EEG-ET/NDARJH99CWH_/NDARJH99CWH__Video2_Samples_ET.mat, Fractals, 60, 4321717142, 4484701398, 162984256
/Volumes/methlab_data/HBN/EEG-ET/NDARJH99CWH_/NDARJH99CWH__Video3_Samples_ET.mat, Despicable, 60, 4750447885, 4920989542, 170541657
/Volumes/methlab_data/HBN/EEG-ET/NDARJH99CWH_/NDARJH99CWH__Video4_Samples_ET.mat, Present, 60, 5245193713, 5448254554, 203060841
/Volumes/methlab_data/HBN/EEG-ET/NDARJJ011HZ1/NDARJJ011HZ1_Video-DM_Samples_ET.mat, Despicable, 60, 2770059333, 2940600998, 170541665
/Volumes/methlab_data/HBN/EEG-ET/NDARJJ011HZ1/NDARJJ011HZ1_Video-FF_Samples_ET.mat, Fractals, 60, 2284014572, 2446996886, 162982314
/Volumes/methlab_data/HBN/EEG-ET/NDARJJ011HZ1/NDARJJ011HZ1_Video-TP_Samples_ET.mat, Present, 60, 3316924107, 3519988737, 203064630
/Volumes/methlab_data/HBN/EEG-ET/NDARJJ011HZ1/NDARJJ011HZ1_Video-WK_Samples_ET.mat, Diary, 60, 1366156386, 1483550459, 117394073
/Volumes/methlab_data/HBN/EEG-ET/NDARJJ173BRX/NDARJJ173BRX_Video-DM_Samples_ET.mat, Despicable, 30, 3363130618, 3533677032, 170546414
/Volumes/methlab_data/HBN/EEG-ET/NDARJJ173BRX/NDARJJ173BRX_Video-TP_Samples_ET.mat, Present, 30, 3832255768, 4035521299, 203265531
/Volumes/methlab_data/HBN/EEG-ET/NDARJJ173BRX/NDARJJ173BRX_Video-WK_Samples_ET.mat, Diary, 30, 2205218239, 2322606096, 117387857
/Volumes/methlab_data/HBN/EEG-ET/NDARJJ216EGT/NDARJJ216EGT_Video-DM_Samples_ET.mat, Despicable, 60, 4032687268, 4203231912, 170544644
/Volumes/methlab_data/HBN/EEG-ET/NDARJJ216EGT/NDARJJ216EGT_Video-FF_Samples_ET.mat, Fractals, 60, 3511887949, 3674880278, 162992329
/Volumes/methlab_data/HBN/EEG-ET/NDARJJ216EGT/NDARJJ216EGT_Video-TP_Samples_ET.mat, Present, 60, 4544068943, 4747131597, 203062654
/Volumes/methlab_data/HBN/EEG-ET/NDARJJ216EGT/NDARJJ216EGT_Video-WK_Samples_ET.mat, Diary, 60, 3067453585, 3184847656, 117394071
/Volumes/methlab_data/HBN/EEG-ET/NDARJJ277JP3/NDARJJ277JP3_Video1_Samples_ET.mat, Diary, 120, 8556034666, 8673430650, 117395984
/Volumes/methlab_data/HBN/EEG-ET/NDARJJ277JP3/NDARJJ277JP3_Video2_Samples_ET.mat, Fractals, 120, 9260238198, 9423226654, 162988456
/Volumes/methlab_data/HBN/EEG-ET/NDARJJ277JP3/NDARJJ277JP3_Video3_Samples_ET.mat, Despicable, 120, 9759932141, 9930476764, 170544623
/Volumes/methlab_data/HBN/EEG-ET/NDARJJ277JP3/NDARJJ277JP3_Video4_Samples_ET.mat, Present, 120, 10449802238, 10652870567, 203068329
/Volumes/methlab_data/HBN/EEG-ET/NDARJJ343TR0/NDARJJ343TR0_Video1_Samples_ET.mat, Diary, 120, 2866937402, 2984334156, 117396754
/Volumes/methlab_data/HBN/EEG-ET/NDARJJ343TR0/NDARJJ343TR0_Video2_Samples_ET.mat, Fractals, 120, 3791290061, 3954277792, 162987731
/Volumes/methlab_data/HBN/EEG-ET/NDARJJ343TR0/NDARJJ343TR0_Video3_Samples_ET.mat, Despicable, 120, 4302657895, 4473205034, 170547139
/Volumes/methlab_data/HBN/EEG-ET/NDARJJ343TR0/NDARJJ343TR0_Video4_Samples_ET.mat, Present, 120, 4969753328, 5172820246, 203066918
/Volumes/methlab_data/HBN/EEG-ET/NDARJJ345VHW/NDARJJ345VHW_Video-DM_Samples_ET.mat, Despicable, 60, 2310171335, 2480715872, 170544537
/Volumes/methlab_data/HBN/EEG-ET/NDARJJ345VHW/NDARJJ345VHW_Video-FF_Samples_ET.mat, Fractals, 60, 2527215709, 2690206905, 162991196
/Volumes/methlab_data/HBN/EEG-ET/NDARJJ345VHW/NDARJJ345VHW_Video-TP_Samples_ET.mat, Present, 60, 2747112095, 2950170608, 203058513
/Volumes/methlab_data/HBN/EEG-ET/NDARJJ345VHW/NDARJJ345VHW_Video-WK_Samples_ET.mat, Diary, 60, 2142399768, 2259795761, 117395993
/Volumes/methlab_data/HBN/EEG-ET/NDARJJ356DAL/NDARJJ356DAL_Video1_Samples_ET.mat, Diary, 60, 3327423419, 3444816986, 117393567
/Volumes/methlab_data/HBN/EEG-ET/NDARJJ356DAL/NDARJJ356DAL_Video3_Samples_ET.mat, Despicable, 60, 3706641323, 3877185715, 170544392
/Volumes/methlab_data/HBN/EEG-ET/NDARJJ389CP2/NDARJJ389CP2_Video1_Samples_ET.mat, Diary, 60, 5126788936, 5244180929, 117391993
/Volumes/methlab_data/HBN/EEG-ET/NDARJJ389CP2/NDARJJ389CP2_Video3_Samples_ET.mat, Despicable, 60, 4906971510, 5077518121, 170546611
/Volumes/methlab_data/HBN/EEG-ET/NDARJJ512AYJ/NDARJJ512AYJ_Video-DM_Samples_ET.mat, Despicable, 60, 4874567974, 5045108617, 170540643
/Volumes/methlab_data/HBN/EEG-ET/NDARJJ512AYJ/NDARJJ512AYJ_Video-FF_Samples_ET.mat, Fractals, 60, 4310117751, 4473109050, 162991299
/Volumes/methlab_data/HBN/EEG-ET/NDARJJ512AYJ/NDARJJ512AYJ_Video-TP_Samples_ET.mat, Present, 60, 5608751255, 5811819868, 203068613
/Volumes/methlab_data/HBN/EEG-ET/NDARJJ512AYJ/NDARJJ512AYJ_Video-WK_Samples_ET.mat, Diary, 60, 3639483429, 3756875472, 117392043
/Volumes/methlab_data/HBN/EEG-ET/NDARJJ638NAC/NDARJJ638NAC_Video-DM_Samples_ET.mat, Despicable, 60, 4347693845, 4518234447, 170540602
/Volumes/methlab_data/HBN/EEG-ET/NDARJJ638NAC/NDARJJ638NAC_Video-FF_Samples_ET.mat, Fractals, 60, 3567598321, 3730585567, 162987246
/Volumes/methlab_data/HBN/EEG-ET/NDARJJ638NAC/NDARJJ638NAC_Video-TP_Samples_ET.mat, Present, 60, 5257191862, 5460249457, 203057595
/Volumes/methlab_data/HBN/EEG-ET/NDARJJ638NAC/NDARJJ638NAC_Video-WK_Samples_ET.mat, Diary, 60, 4830249010, 4947637064, 117388054
/Volumes/methlab_data/HBN/EEG-ET/NDARJJ767FBH/NDARJJ767FBH_Video1_Samples_ET.mat, Diary, 60, 4160897183, 4278294919, 117397736
/Volumes/methlab_data/HBN/EEG-ET/NDARJJ767FBH/NDARJJ767FBH_Video2_Samples_ET.mat, Fractals, 60, 3461308262, 3624291516, 162983254
/Volumes/methlab_data/HBN/EEG-ET/NDARJJ767FBH/NDARJJ767FBH_Video3_Samples_ET.mat, Despicable, 60, 4555449534, 4725992185, 170542651
/Volumes/methlab_data/HBN/EEG-ET/NDARJJ767FBH/NDARJJ767FBH_Video4_Samples_ET.mat, Present, 60, 5035415828, 5238485691, 203069863
/Volumes/methlab_data/HBN/EEG-ET/NDARJJ859RRW/NDARJJ859RRW_Video1_Samples_ET.mat, Diary, 60, 3787695126, 3905086370, 117391244
/Volumes/methlab_data/HBN/EEG-ET/NDARJJ859RRW/NDARJJ859RRW_Video3_Samples_ET.mat, Despicable, 60, 2840318751, 3010861612, 170542861
/Volumes/methlab_data/HBN/EEG-ET/NDARJK147LNJ/NDARJK147LNJ_Video-DM_Samples_ET.mat, Despicable, 60, 781855231, 952391823, 170536592
/Volumes/methlab_data/HBN/EEG-ET/NDARJK147LNJ/NDARJK147LNJ_Video-TP_Samples_ET.mat, Present, 60, 1195200466, 1398468201, 203267735
/Volumes/methlab_data/HBN/EEG-ET/NDARJK147LNJ/NDARJK147LNJ_Video-WK_Samples_ET.mat, Diary, 60, 1040643204, 1158032239, 117389035
/Volumes/methlab_data/HBN/EEG-ET/NDARJK154PF5/NDARJK154PF5_Video-DM_Samples_ET.mat, Despicable, 60, 3311775079, 3482314784, 170539705
/Volumes/methlab_data/HBN/EEG-ET/NDARJK154PF5/NDARJK154PF5_Video-TP_Samples_ET.mat, Present, 60, 3794452155, 3997727860, 203275705
/Volumes/methlab_data/HBN/EEG-ET/NDARJK154PF5/NDARJK154PF5_Video-WK_Samples_ET.mat, Diary, 60, 2860290028, 2977680033, 117390005
/Volumes/methlab_data/HBN/EEG-ET/NDARJK651XB0/NDARJK651XB0_Video1_Samples_ET.mat, Diary, 60, 4231048106, 4348445945, 117397839
/Volumes/methlab_data/HBN/EEG-ET/NDARJK651XB0/NDARJK651XB0_Video2_Samples_ET.mat, Fractals, 60, 3994587258, 4157575358, 162988100
/Volumes/methlab_data/HBN/EEG-ET/NDARJK651XB0/NDARJK651XB0_Video3_Samples_ET.mat, Despicable, 60, 3754113607, 3924664950, 170551343
/Volumes/methlab_data/HBN/EEG-ET/NDARJK651XB0/NDARJK651XB0_Video4_Samples_ET.mat, Present, 60, 4399940256, 4603009572, 203069316
/Volumes/methlab_data/HBN/EEG-ET/NDARJK842BCN/NDARJK842BCN_Video1_Samples_ET.mat, Despicable, 120, 6465899229, 6636441482, 170542253
/Volumes/methlab_data/HBN/EEG-ET/NDARJK842BCN/NDARJK842BCN_Video2_Samples_ET.mat, Diary, 120, 6799696985, 6917087950, 117390965
/Volumes/methlab_data/HBN/EEG-ET/NDARJK842BCN/NDARJK842BCN_Video3_Samples_ET.mat, Fractals, 120, 6959207209, 7122196424, 162989215
/Volumes/methlab_data/HBN/EEG-ET/NDARJK842BCN/NDARJK842BCN_Video4_Samples_ET.mat, Present, 120, 7251033356, 7454104693, 203071337
/Volumes/methlab_data/HBN/EEG-ET/NDARJK910PDK/NDARJK910PDK_Video1_Samples_ET.mat, Diary, 60, 3276512875, 3393907914, 117395039
/Volumes/methlab_data/HBN/EEG-ET/NDARJK910PDK/NDARJK910PDK_Video3_Samples_ET.mat, Despicable, 60, 2819197512, 2989739062, 170541550
/Volumes/methlab_data/HBN/EEG-ET/NDARJK995KMG/NDARJK995KMG_Video-DM_Samples_ET.mat, Despicable, 30, 3200031835, 3370577108, 170545273
/Volumes/methlab_data/HBN/EEG-ET/NDARJK995KMG/NDARJK995KMG_Video-TP_Samples_ET.mat, Present, 30, 4233989724, 4437256039, 203266315
/Volumes/methlab_data/HBN/EEG-ET/NDARJK995KMG/NDARJK995KMG_Video-WK_Samples_ET.mat, Diary, 30, 3621705092, 3739093878, 117388786
/Volumes/methlab_data/HBN/EEG-ET/NDARJL025LWZ/NDARJL025LWZ_Video-DM_Samples_ET.mat, Despicable, 60, 5591909516, 5762450048, 170540532
/Volumes/methlab_data/HBN/EEG-ET/NDARJL025LWZ/NDARJL025LWZ_Video-FF_Samples_ET.mat, Fractals, 60, 5156262687, 5319246866, 162984179
/Volumes/methlab_data/HBN/EEG-ET/NDARJL025LWZ/NDARJL025LWZ_Video-TP_Samples_ET.mat, Present, 60, 6072822361, 6275881859, 203059498
/Volumes/methlab_data/HBN/EEG-ET/NDARJL025LWZ/NDARJL025LWZ_Video-WK_Samples_ET.mat, Diary, 60, 4484056664, 4601457644, 117400980
/Volumes/methlab_data/HBN/EEG-ET/NDARJL058RDV/NDARJL058RDV_Video1_Samples_ET.mat, Despicable, 120, 2333232453, 2503779813, 170547360
/Volumes/methlab_data/HBN/EEG-ET/NDARJL058RDV/NDARJL058RDV_Video2_Samples_ET.mat, Diary, 120, 2526870507, 2644277941, 117407434
/Volumes/methlab_data/HBN/EEG-ET/NDARJL058RDV/NDARJL058RDV_Video3_Samples_ET.mat, Fractals, 120, 2664819687, 2827806813, 162987126
/Volumes/methlab_data/HBN/EEG-ET/NDARJL656RDA/NDARJL656RDA_Video-DM_Samples_ET.mat, Despicable, 60, 4240414223, 4410961783, 170547560
/Volumes/methlab_data/HBN/EEG-ET/NDARJL861WTP/NDARJL861WTP_Video1_Samples_ET.mat, Diary, 120, 3486900026, 3604287397, 117387371
/Volumes/methlab_data/HBN/EEG-ET/NDARJL861WTP/NDARJL861WTP_Video2_Samples_ET.mat, Despicable, 120, 4061176764, 4231734149, 170557385
/Volumes/methlab_data/HBN/EEG-ET/NDARJL861WTP/NDARJL861WTP_Video3_Samples_ET.mat, Fractals, 120, 4730242308, 4893230151, 162987843
/Volumes/methlab_data/HBN/EEG-ET/NDARJL861WTP/NDARJL861WTP_Video4_Samples_ET.mat, Present, 120, 5346129002, 5549196902, 203067900
/Volumes/methlab_data/HBN/EEG-ET/NDARJM036PVX/NDARJM036PVX_Video1_Samples_ET.mat, Diary, 60, 5199630055, 5317020128, 117390073
/Volumes/methlab_data/HBN/EEG-ET/NDARJM036PVX/NDARJM036PVX_Video3_Samples_ET.mat, Despicable, 60, 4738986062, 4909526791, 170540729
/Volumes/methlab_data/HBN/EEG-ET/NDARJM036PVX/NDARJM036PVX_Video4_Samples_ET.mat, Present, 60, 5644452799, 5847523515, 203070716
/Volumes/methlab_data/HBN/EEG-ET/NDARJM239GN4/NDARJM239GN4_Video1_Samples_ET.mat, Diary, 60, 752208023, 869608173, 117400150
/Volumes/methlab_data/HBN/EEG-ET/NDARJM239GN4/NDARJM239GN4_Video3_Samples_ET.mat, Despicable, 60, 316203341, 486745108, 170541767
/Volumes/methlab_data/HBN/EEG-ET/NDARJM296MDW/NDARJM296MDW_Video1_Samples_ET.mat, Diary, 60, 2518861294, 2636252340, 117391046
/Volumes/methlab_data/HBN/EEG-ET/NDARJM296MDW/NDARJM296MDW_Video2_Samples_ET.mat, Fractals, 60, 3944032272, 4107021809, 162989537
/Volumes/methlab_data/HBN/EEG-ET/NDARJM296MDW/NDARJM296MDW_Video4_Samples_ET.mat, Present, 60, 4570320237, 4773376932, 203056695
/Volumes/methlab_data/HBN/EEG-ET/NDARJM618NZH/NDARJM618NZH_Video1_Samples_ET.mat, Fractals, 120, 6703249758, 6866235981, 162986223
/Volumes/methlab_data/HBN/EEG-ET/NDARJM618NZH/NDARJM618NZH_Video2_Samples_ET.mat, Diary, 120, 6885927952, 7003335995, 117408043
/Volumes/methlab_data/HBN/EEG-ET/NDARJM618NZH/NDARJM618NZH_Video3_Samples_ET.mat, Despicable, 120, 7019316391, 7189864058, 170547667
/Volumes/methlab_data/HBN/EEG-ET/NDARJM618NZH/NDARJM618NZH_Video4_Samples_ET.mat, Present, 120, 7205627238, 7408693040, 203065802
/Volumes/methlab_data/HBN/EEG-ET/NDARJM708VGE/NDARJM708VGE_Video1_Samples_ET.mat, Diary, 60, 3891422090, 4008809045, 117386955
/Volumes/methlab_data/HBN/EEG-ET/NDARJM708VGE/NDARJM708VGE_Video3_Samples_ET.mat, Despicable, 60, 3373133842, 3543686360, 170552518
/Volumes/methlab_data/HBN/EEG-ET/NDARJM759GYH/NDARJM759GYH_Video1_Samples_ET.mat, Diary, 60, 3443085182, 3560482070, 117396888
/Volumes/methlab_data/HBN/EEG-ET/NDARJM759GYH/NDARJM759GYH_Video3_Samples_ET.mat, Despicable, 60, 3002890439, 3173438833, 170548394
/Volumes/methlab_data/HBN/EEG-ET/NDARJM765EZF/NDARJM765EZF_Video-DM_Samples_ET.mat, Despicable, 30, 2392858583, 2563393058, 170534475
/Volumes/methlab_data/HBN/EEG-ET/NDARJM765EZF/NDARJM765EZF_Video-TP_Samples_ET.mat, Present, 30, 3003967194, 3207235784, 203268590
/Volumes/methlab_data/HBN/EEG-ET/NDARJM765EZF/NDARJM765EZF_Video-WK_Samples_ET.mat, Diary, 30, 2610473285, 2727862205, 117388920
/Volumes/methlab_data/HBN/EEG-ET/NDARJM828PAL/NDARJM828PAL_Video1_Samples_ET.mat, Despicable, 120, 1624758519, 1775667398, 1946214364
3.214558e+08, 1.705470e+08, /Volumes/methlab_data/HBN/EEG-ET/NDARJM828PAL/NDARJM828PAL_Video2_Samples_ET.mat, Fractals, 120, 2010465340, 2173461645, 162996305
/Volumes/methlab_data/HBN/EEG-ET/NDARJM828PAL/NDARJM828PAL_Video3_Samples_ET.mat, Diary, 120, 2259283304, 2376680783, 117397479
/Volumes/methlab_data/HBN/EEG-ET/NDARJM828PAL/NDARJM828PAL_Video4_Samples_ET.mat, Present, 120, 2450462058, 2653528689, 203066631
/Volumes/methlab_data/HBN/EEG-ET/NDARJN531EN3/NDARJN531EN3_Video3_Samples_ET.mat, Despicable, 60, 89491040029, 89661581713, 170541684
/Volumes/methlab_data/HBN/EEG-ET/NDARJN531EN3/NDARJN531EN3_Video4_Samples_ET.mat, Present, 60, 90082480545, 90285539232, 203058687
/Volumes/methlab_data/HBN/EEG-ET/NDARJN928UPY/NDARJN928UPY_Video-DM_Samples_ET.mat, Despicable, 120, 3839186703, 4009733149, 170546446
/Volumes/methlab_data/HBN/EEG-ET/NDARJN928UPY/NDARJN928UPY_Video-FF_Samples_ET.mat, Fractals, 120, 5108188085, 5271175887, 162987802
/Volumes/methlab_data/HBN/EEG-ET/NDARJN928UPY/NDARJN928UPY_Video-TP_Samples_ET.mat, Present, 120, 5829751270, 6032811779, 203060509
/Volumes/methlab_data/HBN/EEG-ET/NDARJN928UPY/NDARJN928UPY_Video-WK_Samples_ET.mat, Diary, 120, 4686070360, 4803467932, 117397572
/Volumes/methlab_data/HBN/EEG-ET/NDARJP146GT9/NDARJP146GT9_Video1_Samples_ET.mat, Fractals, 120, 5077504333, 5240499771, 162995438
/Volumes/methlab_data/HBN/EEG-ET/NDARJP146GT9/NDARJP146GT9_Video2_Samples_ET.mat, Despicable, 120, 6198056840, 6368603890, 170547050
/Volumes/methlab_data/HBN/EEG-ET/NDARJP146GT9/NDARJP146GT9_Video3_Samples_ET.mat, Diary, 120, 6765694543, 6883089610, 117395067
/Volumes/methlab_data/HBN/EEG-ET/NDARJP146GT9/NDARJP146GT9_Video4_Samples_ET.mat, Present, 120, 7491651044, 7694717107, 203066063
/Volumes/methlab_data/HBN/EEG-ET/NDARJP304NK1/NDARJP304NK1_Video-DM_Samples_ET.mat, Despicable, 60, 4655128393, 4825667708, 170539315
/Volumes/methlab_data/HBN/EEG-ET/NDARJP304NK1/NDARJP304NK1_Video-FF_Samples_ET.mat, Fractals, 60, 4119698816, 4282679749, 162980933
/Volumes/methlab_data/HBN/EEG-ET/NDARJP304NK1/NDARJP304NK1_Video-TP_Samples_ET.mat, Present, 60, 4879131407, 5082285668, 203154261
/Volumes/methlab_data/HBN/EEG-ET/NDARJP304NK1/NDARJP304NK1_Video-WK_Samples_ET.mat, Diary, 60, 3326879697, 3444270501, 117390804
/Volumes/methlab_data/HBN/EEG-ET/NDARJP444DZM/NDARJP444DZM_Video3_Samples_ET.mat, Despicable, 30, 2554034910, 2724577270, 170542360
/Volumes/methlab_data/HBN/EEG-ET/NDARJP489HCE/NDARJP489HCE_Video1_Samples_ET.mat, Diary, 60, 3135983586, 3253374724, 117391138
/Volumes/methlab_data/HBN/EEG-ET/NDARJP489HCE/NDARJP489HCE_Video3_Samples_ET.mat, Despicable, 60, 4420944319, 4591494069, 170549750
/Volumes/methlab_data/HBN/EEG-ET/NDARJP948FJV/NDARJP948FJV_Video1_Samples_ET.mat, Fractals, 120, 9997556269, 10160543663, 162987394
/Volumes/methlab_data/HBN/EEG-ET/NDARJP948FJV/NDARJP948FJV_Video2_Samples_ET.mat, Despicable, 120, 10502912760, 10673470895, 170558135
/Volumes/methlab_data/HBN/EEG-ET/NDARJP948FJV/NDARJP948FJV_Video3_Samples_ET.mat, Diary, 120, 11014271266, 11131668240, 117396974
/Volumes/methlab_data/HBN/EEG-ET/NDARJP948FJV/NDARJP948FJV_Video4_Samples_ET.mat, Present, 120, 11722736845, 11925804620, 203067775
/Volumes/methlab_data/HBN/EEG-ET/NDARJR280FEJ/NDARJR280FEJ_Video-DM_Samples_ET.mat, Despicable, 60, 7163252430, 7333789973, 170537543
/Volumes/methlab_data/HBN/EEG-ET/NDARJR280FEJ/NDARJR280FEJ_Video-TP_Samples_ET.mat, Present, 60, 8131690780, 8334957438, 203266658
/Volumes/methlab_data/HBN/EEG-ET/NDARJR280FEJ/NDARJR280FEJ_Video-WK_Samples_ET.mat, Diary, 60, 7665056021, 7782445998, 117389977
/Volumes/methlab_data/HBN/EEG-ET/NDARJR437DJH/NDARJR437DJH_Video-DM_Samples_ET.mat, Despicable, 60, 20232929700, 20403468276, 170538576
/Volumes/methlab_data/HBN/EEG-ET/NDARJR437DJH/NDARJR437DJH_Video-TP_Samples_ET.mat, Present, 60, 20711018797, 20914294441, 203275644
/Volumes/methlab_data/HBN/EEG-ET/NDARJR437DJH/NDARJR437DJH_Video-WK_Samples_ET.mat, Diary, 60, 19199471033, 19316857060, 117386027
/Volumes/methlab_data/HBN/EEG-ET/NDARJR473HXT/NDARJR473HXT_Video-DM_Samples_ET.mat, Despicable, 120, 4728183093, 4898730476, 170547383
/Volumes/methlab_data/HBN/EEG-ET/NDARJR473HXT/NDARJR473HXT_Video-FF_Samples_ET.mat, Fractals, 120, 4347695514, 4510683062, 162987548
/Volumes/methlab_data/HBN/EEG-ET/NDARJR473HXT/NDARJR473HXT_Video-TP_Samples_ET.mat, Present, 120, 5386820685, 5589886984, 203066299
/Volumes/methlab_data/HBN/EEG-ET/NDARJR473HXT/NDARJR473HXT_Video-WK_Samples_ET.mat, Diary, 120, 3578519691, 3695907901, 117388210
/Volumes/methlab_data/HBN/EEG-ET/NDARJR525HTX/NDARJR525HTX_Video1_Samples_ET.mat, Diary, 60, 2249121498, 2366511669, 117390171
/Volumes/methlab_data/HBN/EEG-ET/NDARJR525HTX/NDARJR525HTX_Video3_Samples_ET.mat, Despicable, 60, 3437903545, 3608450410, 170546865
/Volumes/methlab_data/HBN/EEG-ET/NDARJR579FW7/NDARJR579FW7_Video1_Samples_ET.mat, Diary, 60, 4037119833, 4154514656, 117394823
/Volumes/methlab_data/HBN/EEG-ET/NDARJR579FW7/NDARJR579FW7_Video2_Samples_ET.mat, Fractals, 60, 4574138722, 4737121716, 162982994
/Volumes/methlab_data/HBN/EEG-ET/NDARJR579FW7/NDARJR579FW7_Video3_Samples_ET.mat, Despicable, 60, 5045221109, 5215779459, 170558350
/Volumes/methlab_data/HBN/EEG-ET/NDARJR579FW7/NDARJR579FW7_Video4_Samples_ET.mat, Present, 60, 5547605589, 5750666187, 203060598
/Volumes/methlab_data/HBN/EEG-ET/NDARJT064LRE/NDARJT064LRE_Video-DM_Samples_ET.mat, Despicable, 60, 3555669022, 3726208294, 170539272
/Volumes/methlab_data/HBN/EEG-ET/NDARJT064LRE/NDARJT064LRE_Video-FF_Samples_ET.mat, Fractals, 60, 2481025157, 2644015110, 162989953
/Volumes/methlab_data/HBN/EEG-ET/NDARJT064LRE/NDARJT064LRE_Video-TP_Samples_ET.mat, Present, 60, 4472987929, 4676052166, 203064237
/Volumes/methlab_data/HBN/EEG-ET/NDARJT064LRE/NDARJT064LRE_Video-WK_Samples_ET.mat, Diary, 60, 4016663124, 4134056925, 117393801
/Volumes/methlab_data/HBN/EEG-ET/NDARJT172UE0/NDARJT172UE0_Video-DM_Samples_ET.mat, Despicable, 120, 4065942413, 4236489205, 170546792
/Volumes/methlab_data/HBN/EEG-ET/NDARJT172UE0/NDARJT172UE0_Video-FF_Samples_ET.mat, Fractals, 120, 3451275459, 3614262715, 162987256
/Volumes/methlab_data/HBN/EEG-ET/NDARJT172UE0/NDARJT172UE0_Video-TP_Samples_ET.mat, Present, 120, 5349494156, 5552561752, 203067596
/Volumes/methlab_data/HBN/EEG-ET/NDARJT172UE0/NDARJT172UE0_Video-WK_Samples_ET.mat, Diary, 120, 4651588607, 4768985879, 117397272
/Volumes/methlab_data/HBN/EEG-ET/NDARJT517YHZ/NDARJT517YHZ_Video1_Samples_ET.mat, Diary, 60, 376904117, 494298320, 117394203
/Volumes/methlab_data/HBN/EEG-ET/NDARJT517YHZ/NDARJT517YHZ_Video3_Samples_ET.mat, Despicable, 60, 1321972400, 1492515277, 170542877
/Volumes/methlab_data/HBN/EEG-ET/NDARJT523MV7/NDARJT523MV7_Video1_Samples_ET.mat, Diary, 60, 2456777809, 2574173798, 117395989
/Volumes/methlab_data/HBN/EEG-ET/NDARJT523MV7/NDARJT523MV7_Video3_Samples_ET.mat, Despicable, 60, 3563991206, 3734533754, 170542548
/Volumes/methlab_data/HBN/EEG-ET/NDARJT556KAM/NDARJT556KAM_Video1_Samples_ET.mat, Diary, 60, 5020233183, 5137621203, 117388020
/Volumes/methlab_data/HBN/EEG-ET/NDARJT556KAM/NDARJT556KAM_Video3_Samples_ET.mat, Despicable, 60, 4570540408, 4741081927, 170541519
/Volumes/methlab_data/HBN/EEG-ET/NDARJT588ZAX/NDARJT588ZAX_Video1_Samples_ET.mat, Diary, 60, 4136125438, 4253520451, 117395013
/Volumes/methlab_data/HBN/EEG-ET/NDARJT588ZAX/NDARJT588ZAX_Video2_Samples_ET.mat, Fractals, 60, 5263278370, 5426272569, 162994199
/Volumes/methlab_data/HBN/EEG-ET/NDARJT588ZAX/NDARJT588ZAX_Video3_Samples_ET.mat, Despicable, 60, 4727724696, 4898279295, 170554599
/Volumes/methlab_data/HBN/EEG-ET/NDARJT588ZAX/NDARJT588ZAX_Video4_Samples_ET.mat, Present, 60, 5729121679, 5932183267, 203061588
/Volumes/methlab_data/HBN/EEG-ET/NDARJT730WP0/NDARJT730WP0_Video1_Samples_ET.mat, Diary, 60, 927085353, 1044483367, 117398014
/Volumes/methlab_data/HBN/EEG-ET/NDARJU766FBU/NDARJU766FBU_Video1_Samples_ET.mat, Diary, 60, 1217455740, 1334840757, 117385017
/Volumes/methlab_data/HBN/EEG-ET/NDARJU766FBU/NDARJU766FBU_Video3_Samples_ET.mat, Despicable, 60, 701103713, 871641268, 170537555
/Volumes/methlab_data/HBN/EEG-ET/NDARJU787GF5/NDARJU787GF5_Video3_Samples_ET.mat, Despicable, 60, 3314165534, 3484705898, 170540364
/Volumes/methlab_data/HBN/EEG-ET/NDARJU787GF5/NDARJU787GF5_Video4_Samples_ET.mat, Present, 60, 4308600589, 4511662489, 203061900
/Volumes/methlab_data/HBN/EEG-ET/NDARJU805JG5/NDARJU805JG5_Video1_Samples_ET.mat, Diary, 60, 1398363802, 1515753803, 117390001
/Volumes/methlab_data/HBN/EEG-ET/NDARJU805JG5/NDARJU805JG5_Video3_Samples_ET.mat, Despicable, 60, 1186723198, 1357261756, 170538558
/Volumes/methlab_data/HBN/EEG-ET/NDARJU903AZH/NDARJU903AZH_Video1_Samples_ET.mat, Fractals, 120, 4629192778, 4792179836, 162987058
/Volumes/methlab_data/HBN/EEG-ET/NDARJU903AZH/NDARJU903AZH_Video2_Samples_ET.mat, Diary, 120, 5474297318, 5591694281, 117396963
/Volumes/methlab_data/HBN/EEG-ET/NDARJU903AZH/NDARJU903AZH_Video3_Samples_ET.mat, Despicable, 120, 5907085627, 6077631567, 170545940
/Volumes/methlab_data/HBN/EEG-ET/NDARJU903AZH/NDARJU903AZH_Video4_Samples_ET.mat, Present, 120, 6455141028, 6658208932, 203067904
/Volumes/methlab_data/HBN/EEG-ET/NDARJV062AM0/NDARJV062AM0_Video-DM_Samples_ET.mat, Despicable, 60, 3053669502, 3224210204, 170540702
/Volumes/methlab_data/HBN/EEG-ET/NDARJV062AM0/NDARJV062AM0_Video-TP_Samples_ET.mat, Present, 60, 4016911129, 4220188982, 203277853
/Volumes/methlab_data/HBN/EEG-ET/NDARJV062AM0/NDARJV062AM0_Video-WK_Samples_ET.mat, Diary, 60, 3811752972, 3929143017, 117390045
/Volumes/methlab_data/HBN/EEG-ET/NDARJV225EYT/NDARJV225EYT_Video-DM_Samples_ET.mat, Despicable, 120, 3529509872, 3700057384, 170547512
/Volumes/methlab_data/HBN/EEG-ET/NDARJV225EYT/NDARJV225EYT_Video-FF_Samples_ET.mat, Fractals, 120, 2744375334, 2907361533, 162986199
/Volumes/methlab_data/HBN/EEG-ET/NDARJV225EYT/NDARJV225EYT_Video-TP_Samples_ET.mat, Present, 120, 4641713517, 4844780610, 203067093
/Volumes/methlab_data/HBN/EEG-ET/NDARJV225EYT/NDARJV225EYT_Video-WK_Samples_ET.mat, Diary, 120, 4070846451, 4188244573, 117398122
/Volumes/methlab_data/HBN/EEG-ET/NDARJV268PNW/NDARJV268PNW_Video1_Samples_ET.mat, Diary, 60, 3199483696, 3316872849, 117389153
/Volumes/methlab_data/HBN/EEG-ET/NDARJV268PNW/NDARJV268PNW_Video3_Samples_ET.mat, Despicable, 60, 3565185729, 3735726546, 170540817
/Volumes/methlab_data/HBN/EEG-ET/NDARJV377HG4/NDARJV377HG4_Video1_Samples_ET.mat, Diary, 60, 4641768698, 4759160066, 117391368
/Volumes/methlab_data/HBN/EEG-ET/NDARJV377HG4/NDARJV377HG4_Video3_Samples_ET.mat, Despicable, 60, 5226487664, 5397035712, 170548048
/Volumes/methlab_data/HBN/EEG-ET/NDARJV411EH6/NDARJV411EH6_Video-DM_Samples_ET.mat, Despicable, 120, 4224567591, 4395113585, 170545994
/Volumes/methlab_data/HBN/EEG-ET/NDARJV411EH6/NDARJV411EH6_Video-FF_Samples_ET.mat, Fractals, 120, 3390393455, 3553379838, 162986383
/Volumes/methlab_data/HBN/EEG-ET/NDARJV411EH6/NDARJV411EH6_Video-TP_Samples_ET.mat, Present, 120, 5343098943, 5546166039, 203067096
/Volumes/methlab_data/HBN/EEG-ET/NDARJV411EH6/NDARJV411EH6_Video-WK_Samples_ET.mat, Diary, 120, 4757232520, 4874621729, 117389209
/Volumes/methlab_data/HBN/EEG-ET/NDARJW072UJ3/NDARJW072UJ3_Video-DM_Samples_ET.mat, Despicable, 60, 6583642655, 6754189264, 170546609
/Volumes/methlab_data/HBN/EEG-ET/NDARJW072UJ3/NDARJW072UJ3_Video-FF_Samples_ET.mat, Fractals, 60, 6052422087, 6215420351, 162998264
/Volumes/methlab_data/HBN/EEG-ET/NDARJW072UJ3/NDARJW072UJ3_Video-TP_Samples_ET.mat, Present, 60, 7137912543, 7340971120, 203058577
/Volumes/methlab_data/HBN/EEG-ET/NDARJW072UJ3/NDARJW072UJ3_Video-WK_Samples_ET.mat, Diary, 60, 5421619104, 5539012159, 117393055
/Volumes/methlab_data/HBN/EEG-ET/NDARJW315BUA/NDARJW315BUA_Video1_Samples_ET.mat, Diary, 60, 2771844331, 2889232317, 117387986
/Volumes/methlab_data/HBN/EEG-ET/NDARJW315BUA/NDARJW315BUA_Video3_Samples_ET.mat, Despicable, 60, 2499138818, 2669682237, 170543419
/Volumes/methlab_data/HBN/EEG-ET/NDARJW503GA0/NDARJW503GA0_Video-DM_Samples_ET.mat, Despicable, 60, 4050933460, 4221476071, 170542611
/Volumes/methlab_data/HBN/EEG-ET/NDARJW503GA0/NDARJW503GA0_Video-FF_Samples_ET.mat, Fractals, 60, 3490731397, 3653725654, 162994257
/Volumes/methlab_data/HBN/EEG-ET/NDARJW503GA0/NDARJW503GA0_Video-TP_Samples_ET.mat, Present, 60, 4694672576, 4897732156, 203059580
/Volumes/methlab_data/HBN/EEG-ET/NDARJW503GA0/NDARJW503GA0_Video-WK_Samples_ET.mat, Diary, 60, 2942529820, 3059924836, 117395016
/Volumes/methlab_data/HBN/EEG-ET/NDARJW888AJ2/NDARJW888AJ2_Video-DM_Samples_ET.mat, Despicable, 30, 4059372897, 4229918250, 170545353
/Volumes/methlab_data/HBN/EEG-ET/NDARJW888AJ2/NDARJW888AJ2_Video-TP_Samples_ET.mat, Present, 30, 4652788603, 4856063049, 203274446
/Volumes/methlab_data/HBN/EEG-ET/NDARJW888AJ2/NDARJW888AJ2_Video-WK_Samples_ET.mat, Diary, 30, 2861332600, 2978722439, 117389839
/Volumes/methlab_data/HBN/EEG-ET/NDARJW989EM6/NDARJW989EM6_Video-DM_Samples_ET.mat, Despicable, 60, 5244474409, 5415022930, 170548521
/Volumes/methlab_data/HBN/EEG-ET/NDARJW989EM6/NDARJW989EM6_Video-FF_Samples_ET.mat, Fractals, 60, 4781783458, 4944771632, 162988174
/Volumes/methlab_data/HBN/EEG-ET/NDARJW989EM6/NDARJW989EM6_Video-TP_Samples_ET.mat, Present, 60, 5730278709, 5933380242, 203101533
/Volumes/methlab_data/HBN/EEG-ET/NDARJW989EM6/NDARJW989EM6_Video-WK_Samples_ET.mat, Diary, 60, 4251059414, 4368447390, 117387976
/Volumes/methlab_data/HBN/EEG-ET/NDARJX121GKP/NDARJX121GKP_Video-DM_Samples_ET.mat, Despicable, 60, 4593236947, 4763784707, 170547760
/Volumes/methlab_data/HBN/EEG-ET/NDARJX121GKP/NDARJX121GKP_Video-FF_Samples_ET.mat, Fractals, 60, 4154042171, 4317034510, 162992339
/Volumes/methlab_data/HBN/EEG-ET/NDARJX121GKP/NDARJX121GKP_Video-TP_Samples_ET.mat, Present, 60, 5186277594, 5389339313, 203061719
/Volumes/methlab_data/HBN/EEG-ET/NDARJX121GKP/NDARJX121GKP_Video-WK_Samples_ET.mat, Diary, 60, 3477304290, 3594697375, 117393085
/Volumes/methlab_data/HBN/EEG-ET/NDARJX258XF0/NDARJX258XF0_Video1_Samples_ET.mat, Diary, 60, 92186768308, 92304165334, 117397026
/Volumes/methlab_data/HBN/EEG-ET/NDARJX258XF0/NDARJX258XF0_Video2_Samples_ET.mat, Fractals, 60, 93525183908, 93688176192, 162992284
/Volumes/methlab_data/HBN/EEG-ET/NDARJX258XF0/NDARJX258XF0_Video3_Samples_ET.mat, Despicable, 60, 92966842992, 93137394642, 170551650
/Volumes/methlab_data/HBN/EEG-ET/NDARJX258XF0/NDARJX258XF0_Video4_Samples_ET.mat, Present, 60, 94033286259, 94236346900, 203060641
/Volumes/methlab_data/HBN/EEG-ET/NDARJX421FWR/NDARJX421FWR_Video1_Samples_ET.mat, Diary, 60, 4951496324, 5068886428, 117390104
/Volumes/methlab_data/HBN/EEG-ET/NDARJX421FWR/NDARJX421FWR_Video3_Samples_ET.mat, Despicable, 60, 3939833470, 4110386168, 170552698
/Volumes/methlab_data/HBN/EEG-ET/NDARJX458DVE/NDARJX458DVE_Video-DM_Samples_ET.mat, Despicable, 60, 4339626153, 4510169737, 170543584
/Volumes/methlab_data/HBN/EEG-ET/NDARJX458DVE/NDARJX458DVE_Video-FF_Samples_ET.mat, Fractals, 60, 3683508281, 3846499531, 162991250
/Volumes/methlab_data/HBN/EEG-ET/NDARJX458DVE/NDARJX458DVE_Video-TP_Samples_ET.mat, Present, 60, 5225291301, 5428349897, 203058596
/Volumes/methlab_data/HBN/EEG-ET/NDARJX458DVE/NDARJX458DVE_Video-WK_Samples_ET.mat, Diary, 60, 4784815920, 4902206897, 117390977
/Volumes/methlab_data/HBN/EEG-ET/NDARJX939UCQ/NDARJX939UCQ_Video1_Samples_ET.mat, Diary, 60, 2941790612, 3059182469, 117391857
/Volumes/methlab_data/HBN/EEG-ET/NDARJX939UCQ/NDARJX939UCQ_Video2_Samples_ET.mat, Fractals, 60, 1823996918, 1986984956, 162988038
/Volumes/methlab_data/HBN/EEG-ET/NDARJX939UCQ/NDARJX939UCQ_Video3_Samples_ET.mat, Despicable, 60, 2496232237, 2666777589, 170545352
/Volumes/methlab_data/HBN/EEG-ET/NDARJX939UCQ/NDARJX939UCQ_Video4_Samples_ET.mat, Present, 60, 3364873162, 3567945424, 203072262
/Volumes/methlab_data/HBN/EEG-ET/NDARJY033DKZ/NDARJY033DKZ_Video1_Samples_ET.mat, Diary, 60, 4139387936, 4256780511, 117392575
/Volumes/methlab_data/HBN/EEG-ET/NDARJY033DKZ/NDARJY033DKZ_Video3_Samples_ET.mat, Despicable, 60, 3721109239, 3891651640, 170542401
/Volumes/methlab_data/HBN/EEG-ET/NDARJY141RFE/NDARJY141RFE_Video1_Samples_ET.mat, Diary, 60, 25821293041, 25938691502, 117398461
/Volumes/methlab_data/HBN/EEG-ET/NDARJY141RFE/NDARJY141RFE_Video3_Samples_ET.mat, Despicable, 60, 26396507874, 26567048102, 170540228
/Volumes/methlab_data/HBN/EEG-ET/NDARJY577WNJ/NDARJY577WNJ_Video-DM_Samples_ET.mat, Despicable, 60, 3814886085, 3985428485, 170542400
/Volumes/methlab_data/HBN/EEG-ET/NDARJY577WNJ/NDARJY577WNJ_Video-FF_Samples_ET.mat, Fractals, 60, 3395791240, 3558776317, 162985077
/Volumes/methlab_data/HBN/EEG-ET/NDARJY577WNJ/NDARJY577WNJ_Video-TP_Samples_ET.mat, Present, 60, 4301910897, 4504972267, 203061370
/Volumes/methlab_data/HBN/EEG-ET/NDARJY577WNJ/NDARJY577WNJ_Video-WK_Samples_ET.mat, Diary, 60, 2818500705, 2935895594, 117394889
/Volumes/methlab_data/HBN/EEG-ET/NDARJY676CWZ/NDARJY676CWZ_Video1_Samples_ET.mat, Diary, 60, 5727896163, 5845290042, 117393879
/Volumes/methlab_data/HBN/EEG-ET/NDARJY676CWZ/NDARJY676CWZ_Video2_Samples_ET.mat, Fractals, 60, 4983892955, 5146874031, 162981076
/Volumes/methlab_data/HBN/EEG-ET/NDARJY676CWZ/NDARJY676CWZ_Video3_Samples_ET.mat, Despicable, 60, 5909980784, 6080554593, 170573809
/Volumes/methlab_data/HBN/EEG-ET/NDARJY676CWZ/NDARJY676CWZ_Video4_Samples_ET.mat, Present, 60, 6137341242, 6340413599, 203072357
/Volumes/methlab_data/HBN/EEG-ET/NDARJY747PRJ/NDARJY747PRJ_Video1_Samples_ET.mat, Diary, 120, 10029921295, 10147317384, 117396089
/Volumes/methlab_data/HBN/EEG-ET/NDARJY747PRJ/NDARJY747PRJ_Video2_Samples_ET.mat, Fractals, 120, 11044653256, 11207641199, 162987943
/Volumes/methlab_data/HBN/EEG-ET/NDARJY747PRJ/NDARJY747PRJ_Video3_Samples_ET.mat, Despicable, 120, 11503212516, 11673758595, 170546079
/Volumes/methlab_data/HBN/EEG-ET/NDARJY747PRJ/NDARJY747PRJ_Video4_Samples_ET.mat, Present, 120, 12085975054, 12289036762, 203061708
/Volumes/methlab_data/HBN/EEG-ET/NDARJZ089HVP/NDARJZ089HVP_Video1_Samples_ET.mat, Diary, 60, 4328133096, 4445521017, 117387921
/Volumes/methlab_data/HBN/EEG-ET/NDARJZ089HVP/NDARJZ089HVP_Video3_Samples_ET.mat, Despicable, 60, 3879604298, 4050139784, 170535486
/Volumes/methlab_data/HBN/EEG-ET/NDARJZ167VEZ/NDARJZ167VEZ_Video1_Samples_ET.mat, Diary, 120, 3595565253, 3712961326, 117396073
/Volumes/methlab_data/HBN/EEG-ET/NDARJZ167VEZ/NDARJZ167VEZ_Video2_Samples_ET.mat, Fractals, 120, 4683417420, 4846404692, 162987272
/Volumes/methlab_data/HBN/EEG-ET/NDARJZ167VEZ/NDARJZ167VEZ_Video3_Samples_ET.mat, Despicable, 120, 5233524758, 5404071583, 170546825
/Volumes/methlab_data/HBN/EEG-ET/NDARJZ167VEZ/NDARJZ167VEZ_Video4_Samples_ET.mat, Present, 120, 5806401274, 6009477885, 203076611
/Volumes/methlab_data/HBN/EEG-ET/NDARJZ274PRQ/NDARJZ274PRQ_Video1_Samples_ET.mat, Diary, 60, 4641455080, 4758848069, 117392989
/Volumes/methlab_data/HBN/EEG-ET/NDARJZ274PRQ/NDARJZ274PRQ_Video3_Samples_ET.mat, Despicable, 60, 4221579389, 4392120913, 170541524
/Volumes/methlab_data/HBN/EEG-ET/NDARJZ526HN3/NDARJZ526HN3_Video1_Samples_ET.mat, Diary, 60, 4145373823, 4262763820, 117389997
/Volumes/methlab_data/HBN/EEG-ET/NDARJZ526HN3/NDARJZ526HN3_Video3_Samples_ET.mat, Despicable, 60, 3720428510, 3890977090, 170548580
/Volumes/methlab_data/HBN/EEG-ET/NDARJZ549HU8/NDARJZ549HU8_Video1_Samples_ET.mat, Diary, 60, 3443873003, 3561300997, 117427994
/Volumes/methlab_data/HBN/EEG-ET/NDARJZ549HU8/NDARJZ549HU8_Video3_Samples_ET.mat, Despicable, 60, 2940398259, 3110938752, 170540493
/Volumes/methlab_data/HBN/EEG-ET/NDARJZ679KXJ/NDARJZ679KXJ_Video3_Samples_ET.mat, Despicable, 60, 2008173122, 2178715650, 170542528
/Volumes/methlab_data/HBN/EEG-ET/NDARJZ715FE8/NDARJZ715FE8_Video1_Samples_ET.mat, Diary, 120, 3752633047, 3870029414, 117396367
/Volumes/methlab_data/HBN/EEG-ET/NDARJZ715FE8/NDARJZ715FE8_Video2_Samples_ET.mat, Fractals, 120, 4830794655, 4993781938, 162987283
/Volumes/methlab_data/HBN/EEG-ET/NDARJZ715FE8/NDARJZ715FE8_Video3_Samples_ET.mat, Despicable, 120, 5242203235, 5412749789, 170546554
/Volumes/methlab_data/HBN/EEG-ET/NDARJZ888UX6/NDARJZ888UX6_Video1_Samples_ET.mat, Diary, 60, 3323900111, 3441294057, 117393946
/Volumes/methlab_data/HBN/EEG-ET/NDARJZ888UX6/NDARJZ888UX6_Video2_Samples_ET.mat, Fractals, 60, 4544228036, 4707223152, 162995116
/Volumes/methlab_data/HBN/EEG-ET/NDARJZ888UX6/NDARJZ888UX6_Video3_Samples_ET.mat, Despicable, 60, 4090012196, 4260556752, 170544556
/Volumes/methlab_data/HBN/EEG-ET/NDARJZ888UX6/NDARJZ888UX6_Video4_Samples_ET.mat, Present, 60, 5048710332, 5251781773, 203071441
/Volumes/methlab_data/HBN/EEG-ET/NDARKA085YRG/NDARKA085YRG_Video1_Samples_ET.mat, Diary, 60, 4624740954, 4742132863, 117391909
/Volumes/methlab_data/HBN/EEG-ET/NDARKA085YRG/NDARKA085YRG_Video3_Samples_ET.mat, Despicable, 60, 5442480226, 5613025645, 170545419
/Volumes/methlab_data/HBN/EEG-ET/NDARKA627LF8/NDARKA627LF8_Video1_Samples_ET.mat, Diary, 60, 3079577845, 3196967022, 117389177
/Volumes/methlab_data/HBN/EEG-ET/NDARKA627LF8/NDARKA627LF8_Video3_Samples_ET.mat, Despicable, 60, 2654732915, 2825283779, 170550864
/Volumes/methlab_data/HBN/EEG-ET/NDARKA946MJ1/NDARKA946MJ1_Video-DM_Samples_ET.mat, Despicable, 60, 4360341545, 4530883187, 170541642
/Volumes/methlab_data/HBN/EEG-ET/NDARKA946MJ1/NDARKA946MJ1_Video-FF_Samples_ET.mat, Fractals, 60, 3860509039, 4023500323, 162991284
/Volumes/methlab_data/HBN/EEG-ET/NDARKA946MJ1/NDARKA946MJ1_Video-TP_Samples_ET.mat, Present, 60, 4834765082, 5037843750, 203078668
/Volumes/methlab_data/HBN/EEG-ET/NDARKA946MJ1/NDARKA946MJ1_Video-WK_Samples_ET.mat, Diary, 60, 3245890333, 3363283391, 117393058
/Volumes/methlab_data/HBN/EEG-ET/NDARKA958FAH/NDARKA958FAH_Video1_Samples_ET.mat, Diary, 120, 3131316235, 3248712904, 117396669
/Volumes/methlab_data/HBN/EEG-ET/NDARKA958FAH/NDARKA958FAH_Video2_Samples_ET.mat, Fractals, 120, 4139188769, 4302176540, 162987771
/Volumes/methlab_data/HBN/EEG-ET/NDARKA958FAH/NDARKA958FAH_Video3_Samples_ET.mat, Despicable, 120, 4623160024, 4793701872, 170541848
/Volumes/methlab_data/HBN/EEG-ET/NDARKA958FAH/NDARKA958FAH_Video4_Samples_ET.mat, Present, 120, 5296252943, 5499319282, 203066339
/Volumes/methlab_data/HBN/EEG-ET/NDARKB290YNY/NDARKB290YNY_Video1_Samples_ET.mat, Diary, 60, 5352646291, 5470039757, 117393466
/Volumes/methlab_data/HBN/EEG-ET/NDARKB290YNY/NDARKB290YNY_Video2_Samples_ET.mat, Fractals, 60, 5813050532, 5976044407, 162993875
/Volumes/methlab_data/HBN/EEG-ET/NDARKB290YNY/NDARKB290YNY_Video3_Samples_ET.mat, Despicable, 60, 4704796844, 4875341110, 170544266
/Volumes/methlab_data/HBN/EEG-ET/NDARKB290YNY/NDARKB290YNY_Video4_Samples_ET.mat, Present, 60, 6283447880, 6486509217, 203061337
/Volumes/methlab_data/HBN/EEG-ET/NDARKB421MTA/NDARKB421MTA_Video-DM_Samples_ET.mat, Despicable, 60, 1239437109, 1409979646, 170542537
/Volumes/methlab_data/HBN/EEG-ET/NDARKB547TCK/NDARKB547TCK_Video1_Samples_ET.mat, Diary, 120, 4530059021, 4647456489, 117397468
/Volumes/methlab_data/HBN/EEG-ET/NDARKB547TCK/NDARKB547TCK_Video2_Samples_ET.mat, Fractals, 120, 5835279161, 5998266676, 162987515
/Volumes/methlab_data/HBN/EEG-ET/NDARKB547TCK/NDARKB547TCK_Video3_Samples_ET.mat, Despicable, 120, 6260026831, 6430574017, 170547186
/Volumes/methlab_data/HBN/EEG-ET/NDARKB547TCK/NDARKB547TCK_Video4_Samples_ET.mat, Present, 120, 6908452104, 7111519650, 203067546
/Volumes/methlab_data/HBN/EEG-ET/NDARKB607GAW/NDARKB607GAW_Video-DM_Samples_ET.mat, Despicable, 60, 3884356335, 4054892865, 170536530
/Volumes/methlab_data/HBN/EEG-ET/NDARKB607GAW/NDARKB607GAW_Video-TP_Samples_ET.mat, Present, 60, 4619458790, 4822733461, 203274671
/Volumes/methlab_data/HBN/EEG-ET/NDARKB607GAW/NDARKB607GAW_Video-WK_Samples_ET.mat, Diary, 60, 4464408229, 4581797216, 117388987
/Volumes/methlab_data/HBN/EEG-ET/NDARKB614KGY/NDARKB614KGY_Video1_Samples_ET.mat, Diary, 60, 3929046263, 4046441231, 117394968
/Volumes/methlab_data/HBN/EEG-ET/NDARKB614KGY/NDARKB614KGY_Video2_Samples_ET.mat, Fractals, 60, 4658610802, 4821594978, 162984176
/Volumes/methlab_data/HBN/EEG-ET/NDARKB614KGY/NDARKB614KGY_Video3_Samples_ET.mat, Despicable, 60, 5080207741, 5250750249, 170542508
/Volumes/methlab_data/HBN/EEG-ET/NDARKB614KGY/NDARKB614KGY_Video4_Samples_ET.mat, Present, 60, 5583902642, 5786963144, 203060502
/Volumes/methlab_data/HBN/EEG-ET/NDARKB712GAP/NDARKB712GAP_Video-DM_Samples_ET.mat, Despicable, 60, 4510923516, 4681473985, 170550469
/Volumes/methlab_data/HBN/EEG-ET/NDARKB712GAP/NDARKB712GAP_Video-FF_Samples_ET.mat, Fractals, 60, 4068441045, 4231430114, 162989069
/Volumes/methlab_data/HBN/EEG-ET/NDARKB712GAP/NDARKB712GAP_Video-TP_Samples_ET.mat, Present, 60, 5013091178, 5216158629, 203067451
/Volumes/methlab_data/HBN/EEG-ET/NDARKB712GAP/NDARKB712GAP_Video-WK_Samples_ET.mat, Diary, 60, 3369463317, 3486848242, 117384925
/Volumes/methlab_data/HBN/EEG-ET/NDARKC143BEE/NDARKC143BEE_Video1_Samples_ET.mat, Diary, 60, 747100872, 864492358, 117391486
/Volumes/methlab_data/HBN/EEG-ET/NDARKC143BEE/NDARKC143BEE_Video3_Samples_ET.mat, Despicable, 60, 320269689, 490845004, 170575315
/Volumes/methlab_data/HBN/EEG-ET/NDARKC220LZG/NDARKC220LZG_Video-DM_Samples_ET.mat, Despicable, 120, 5591951445, 5762498572, 170547127
/Volumes/methlab_data/HBN/EEG-ET/NDARKC220LZG/NDARKC220LZG_Video-FF_Samples_ET.mat, Fractals, 120, 4254359768, 4417346992, 162987224
/Volumes/methlab_data/HBN/EEG-ET/NDARKC220LZG/NDARKC220LZG_Video-TP_Samples_ET.mat, Present, 120, 6694031980, 6897100461, 203068481
/Volumes/methlab_data/HBN/EEG-ET/NDARKC220LZG/NDARKC220LZG_Video-WK_Samples_ET.mat, Diary, 120, 6085983277, 6203371846, 117388569
/Volumes/methlab_data/HBN/EEG-ET/NDARKC880ZHY/NDARKC880ZHY_Video1_Samples_ET.mat, Diary, 60, 610084409, 727476305, 117391896
/Volumes/methlab_data/HBN/EEG-ET/NDARKC880ZHY/NDARKC880ZHY_Video3_Samples_ET.mat, Despicable, 60, 136599439, 307139123, 170539684
/Volumes/methlab_data/HBN/EEG-ET/NDARKD064EVC/NDARKD064EVC_Video1_Samples_ET.mat, Diary, 60, 1035772281, 1153169498, 117397217
/Volumes/methlab_data/HBN/EEG-ET/NDARKD064EVC/NDARKD064EVC_Video2_Samples_ET.mat, Fractals, 60, 1862505173, 2025489727, 162984554
/Volumes/methlab_data/HBN/EEG-ET/NDARKD064EVC/NDARKD064EVC_Video3_Samples_ET.mat, Despicable, 60, 2316032586, 2486572477, 170539891
/Volumes/methlab_data/HBN/EEG-ET/NDARKD064EVC/NDARKD064EVC_Video4_Samples_ET.mat, Present, 60, 2864973626, 3068034562, 203060936
/Volumes/methlab_data/HBN/EEG-ET/NDARKD134TCX/NDARKD134TCX_Video1_Samples_ET.mat, Diary, 60, 3798495310, 3915891334, 117396024
/Volumes/methlab_data/HBN/EEG-ET/NDARKD134TCX/NDARKD134TCX_Video3_Samples_ET.mat, Despicable, 60, 3329936040, 3500474696, 170538656
/Volumes/methlab_data/HBN/EEG-ET/NDARKD590VF4/NDARKD590VF4_Video-DM_Samples_ET.mat, Despicable, 60, 3298478055, 3469016503, 170538448
/Volumes/methlab_data/HBN/EEG-ET/NDARKD590VF4/NDARKD590VF4_Video-FF_Samples_ET.mat, Fractals, 60, 3078081389, 3241066511, 162985122
/Volumes/methlab_data/HBN/EEG-ET/NDARKD590VF4/NDARKD590VF4_Video-TP_Samples_ET.mat, Present, 60, 3516865268, 3719928712, 203063444
/Volumes/methlab_data/HBN/EEG-ET/NDARKD590VF4/NDARKD590VF4_Video-WK_Samples_ET.mat, Diary, 60, 2575211219, 2692605117, 117393898
/Volumes/methlab_data/HBN/EEG-ET/NDARKE331EHD/NDARKE331EHD_Video1_Samples_ET.mat, Diary, 60, 1868148635, 1985546626, 117397991
/Volumes/methlab_data/HBN/EEG-ET/NDARKE331EHD/NDARKE331EHD_Video3_Samples_ET.mat, Despicable, 60, 2619548856, 2790084440, 170535584
/Volumes/methlab_data/HBN/EEG-ET/NDARKE358TFU/NDARKE358TFU_Video-DM_Samples_ET.mat, Despicable, 120, 7414355108, 7584899760, 170544652
/Volumes/methlab_data/HBN/EEG-ET/NDARKE358TFU/NDARKE358TFU_Video-FF_Samples_ET.mat, Fractals, 120, 6918247299, 7081237679, 162990380
/Volumes/methlab_data/HBN/EEG-ET/NDARKE358TFU/NDARKE358TFU_Video-TP_Samples_ET.mat, Present, 120, 8069439032, 8272511817, 203072785
/Volumes/methlab_data/HBN/EEG-ET/NDARKE358TFU/NDARKE358TFU_Video-WK_Samples_ET.mat, Diary, 120, 6139256517, 6256648300, 117391783
/Volumes/methlab_data/HBN/EEG-ET/NDARKE456BVQ/NDARKE456BVQ_Video-DM_Samples_ET.mat, Despicable, 120, 5461115689, 5631660450, 170544761
/Volumes/methlab_data/HBN/EEG-ET/NDARKE456BVQ/NDARKE456BVQ_Video-FF_Samples_ET.mat, Fractals, 120, 5259262356, 5422249343, 162986987
/Volumes/methlab_data/HBN/EEG-ET/NDARKE456BVQ/NDARKE456BVQ_Video-TP_Samples_ET.mat, Present, 120, 5669039987, 5872116960, 203076973
/Volumes/methlab_data/HBN/EEG-ET/NDARKE456BVQ/NDARKE456BVQ_Video-WK_Samples_ET.mat, Diary, 120, 4473007752, 4590395956, 117388204
/Volumes/methlab_data/HBN/EEG-ET/NDARKE604RXR/NDARKE604RXR_Video1_Samples_ET.mat, Diary, 60, 5399884208, 5517278749, 117394541
/Volumes/methlab_data/HBN/EEG-ET/NDARKE604RXR/NDARKE604RXR_Video3_Samples_ET.mat, Despicable, 60, 4925474730, 5096019076, 170544346
/Volumes/methlab_data/HBN/EEG-ET/NDARKE604RXR/NDARKE604RXR_Video4_Samples_ET.mat, Present, 60, 5852795411, 6055852870, 203057459
/Volumes/methlab_data/HBN/EEG-ET/NDARKF363RN1/NDARKF363RN1_Video-DM_Samples_ET.mat, Despicable, 60, 3614799985, 3785350588, 170550603
/Volumes/methlab_data/HBN/EEG-ET/NDARKF363RN1/NDARKF363RN1_Video-FF_Samples_ET.mat, Fractals, 60, 2998357154, 3161347520, 162990366
/Volumes/methlab_data/HBN/EEG-ET/NDARKF363RN1/NDARKF363RN1_Video-TP_Samples_ET.mat, Present, 60, 4482549470, 4685615063, 203065593
/Volumes/methlab_data/HBN/EEG-ET/NDARKF363RN1/NDARKF363RN1_Video-WK_Samples_ET.mat, Diary, 60, 4051523737, 4168912755, 117389018
/Volumes/methlab_data/HBN/EEG-ET/NDARKF442GZ5/NDARKF442GZ5_Video1_Samples_ET.mat, Diary, 120, 3629488828, 3746885462, 117396634
/Volumes/methlab_data/HBN/EEG-ET/NDARKF442GZ5/NDARKF442GZ5_Video2_Samples_ET.mat, Fractals, 120, 5669915199, 5832902727, 162987528
/Volumes/methlab_data/HBN/EEG-ET/NDARKF442GZ5/NDARKF442GZ5_Video3_Samples_ET.mat, Despicable, 120, 6184483117, 6355029823, 170546706
/Volumes/methlab_data/HBN/EEG-ET/NDARKF442GZ5/NDARKF442GZ5_Video4_Samples_ET.mat, Present, 120, 6898489285, 7101556893, 203067608
/Volumes/methlab_data/HBN/EEG-ET/NDARKF615JNZ/NDARKF615JNZ_Video1_Samples_ET.mat, Diary, 60, 3362280845, 3479674644, 117393799
/Volumes/methlab_data/HBN/EEG-ET/NDARKF615JNZ/NDARKF615JNZ_Video3_Samples_ET.mat, Despicable, 60, 5215039444, 5385581744, 170542300
/Volumes/methlab_data/HBN/EEG-ET/NDARKF704MKL/NDARKF704MKL_Video-DM_Samples_ET.mat, Despicable, 120, 3966210446, 4136756221, 170545775
/Volumes/methlab_data/HBN/EEG-ET/NDARKF704MKL/NDARKF704MKL_Video-FF_Samples_ET.mat, Fractals, 120, 3347934143, 3510930726, 162996583
/Volumes/methlab_data/HBN/EEG-ET/NDARKF704MKL/NDARKF704MKL_Video-TP_Samples_ET.mat, Present, 120, 5083072933, 5286140204, 203067271
/Volumes/methlab_data/HBN/EEG-ET/NDARKF704MKL/NDARKF704MKL_Video-WK_Samples_ET.mat, Diary, 120, 4320637620, 4438035073, 117397453
/Volumes/methlab_data/HBN/EEG-ET/NDARKF779EK2/NDARKF779EK2_Video-DM_Samples_ET.mat, Despicable, 60, 4424050250, 4594591727, 170541477
/Volumes/methlab_data/HBN/EEG-ET/NDARKF779EK2/NDARKF779EK2_Video-FF_Samples_ET.mat, Fractals, 60, 4006673450, 4169666580, 162993130
/Volumes/methlab_data/HBN/EEG-ET/NDARKF779EK2/NDARKF779EK2_Video-TP_Samples_ET.mat, Present, 60, 4893792003, 5096852463, 203060460
/Volumes/methlab_data/HBN/EEG-ET/NDARKF779EK2/NDARKF779EK2_Video-WK_Samples_ET.mat, Diary, 60, 3329087899, 3446482802, 117394903
/Volumes/methlab_data/HBN/EEG-ET/NDARKF899ZUB/NDARKF899ZUB_Video-DM_Samples_ET.mat, Despicable, 60, 3853947347, 4024480894, 170533547
/Volumes/methlab_data/HBN/EEG-ET/NDARKF899ZUB/NDARKF899ZUB_Video-TP_Samples_ET.mat, Present, 60, 4345718887, 4548987570, 203268683
/Volumes/methlab_data/HBN/EEG-ET/NDARKF899ZUB/NDARKF899ZUB_Video-WK_Samples_ET.mat, Diary, 60, 3005871105, 3123260065, 117388960
/Volumes/methlab_data/HBN/EEG-ET/NDARKG039BFE/NDARKG039BFE_Video-WK_Samples_ET.mat, Diary, 30, 5602750865, 5720140792, 117389927
/Volumes/methlab_data/HBN/EEG-ET/NDARKG460MWV/NDARKG460MWV_Video1_Samples_ET.mat, Diary, 60, 4256197451, 4373592473, 117395022
/Volumes/methlab_data/HBN/EEG-ET/NDARKG460MWV/NDARKG460MWV_Video3_Samples_ET.mat, Despicable, 60, 3809193414, 3979736001, 170542587
/Volumes/methlab_data/HBN/EEG-ET/NDARKG460MWV/NDARKG460MWV_Video4_Samples_ET.mat, Present, 60, 4670963689, 4874025267, 203061578
/Volumes/methlab_data/HBN/EEG-ET/NDARKG546AT9/NDARKG546AT9_Video-DM_Samples_ET.mat, Despicable, 60, 4585402294, 4755939583, 170537289
/Volumes/methlab_data/HBN/EEG-ET/NDARKG546AT9/NDARKG546AT9_Video-TP_Samples_ET.mat, Present, 60, 5098245984, 5301523353, 203277369
/Volumes/methlab_data/HBN/EEG-ET/NDARKG546AT9/NDARKG546AT9_Video-WK_Samples_ET.mat, Diary, 60, 3470223843, 3587610661, 117386818
/Volumes/methlab_data/HBN/EEG-ET/NDARKG594WKT/NDARKG594WKT_Video1_Samples_ET.mat, Fractals, 120, 4108860007, 4271846525, 162986518
/Volumes/methlab_data/HBN/EEG-ET/NDARKG594WKT/NDARKG594WKT_Video2_Samples_ET.mat, Despicable, 120, 4952625036, 5123174391, 170549355
/Volumes/methlab_data/HBN/EEG-ET/NDARKG594WKT/NDARKG594WKT_Video3_Samples_ET.mat, Diary, 120, 5429221056, 5546618700, 117397644
/Volumes/methlab_data/HBN/EEG-ET/NDARKG594WKT/NDARKG594WKT_Video4_Samples_ET.mat, Present, 120, 6032818098, 6235885341, 203067243
/Volumes/methlab_data/HBN/EEG-ET/NDARKG785VAJ/NDARKG785VAJ_Video1_Samples_ET.mat, Diary, 60, 4636762716, 4754157662, 117394946
/Volumes/methlab_data/HBN/EEG-ET/NDARKG785VAJ/NDARKG785VAJ_Video3_Samples_ET.mat, Despicable, 60, 5256523455, 5427064933, 170541478
/Volumes/methlab_data/HBN/EEG-ET/NDARKG859AGN/NDARKG859AGN_Video1_Samples_ET.mat, Diary, 60, 4950087348, 5067479238, 117391890
/Volumes/methlab_data/HBN/EEG-ET/NDARKG859AGN/NDARKG859AGN_Video3_Samples_ET.mat, Despicable, 60, 4522370229, 4692911703, 170541474
/Volumes/methlab_data/HBN/EEG-ET/NDARKH168MC1/NDARKH168MC1_Video-DM_Samples_ET.mat, Despicable, 30, 2649960440, 2820505970, 170545530
/Volumes/methlab_data/HBN/EEG-ET/NDARKH168MC1/NDARKH168MC1_Video-TP_Samples_ET.mat, Present, 30, 3524099140, 3727377823, 203278683
/Volumes/methlab_data/HBN/EEG-ET/NDARKH168MC1/NDARKH168MC1_Video-WK_Samples_ET.mat, Diary, 30, 3104842874, 3222231849, 117388975
/Volumes/methlab_data/HBN/EEG-ET/NDARKH171DG8/NDARKH171DG8_Video-DM_Samples_ET.mat, Despicable, 120, 3821388812, 3991930617, 170541805
/Volumes/methlab_data/HBN/EEG-ET/NDARKH171DG8/NDARKH171DG8_Video-FF_Samples_ET.mat, Fractals, 120, 3096440365, 3259426953, 162986588
/Volumes/methlab_data/HBN/EEG-ET/NDARKH171DG8/NDARKH171DG8_Video-TP_Samples_ET.mat, Present, 120, 4930277662, 5133344571, 203066909
/Volumes/methlab_data/HBN/EEG-ET/NDARKH171DG8/NDARKH171DG8_Video-WK_Samples_ET.mat, Diary, 120, 4283052099, 4400449460, 117397361
/Volumes/methlab_data/HBN/EEG-ET/NDARKH291KRE/NDARKH291KRE_Video-DM_Samples_ET.mat, Despicable, 120, 4556478926, 4727025479, 170546553
/Volumes/methlab_data/HBN/EEG-ET/NDARKH291KRE/NDARKH291KRE_Video-FF_Samples_ET.mat, Fractals, 120, 3690173983, 3853161426, 162987443
/Volumes/methlab_data/HBN/EEG-ET/NDARKH291KRE/NDARKH291KRE_Video-TP_Samples_ET.mat, Present, 120, 5597231684, 5800309075, 203077391
/Volumes/methlab_data/HBN/EEG-ET/NDARKH291KRE/NDARKH291KRE_Video-WK_Samples_ET.mat, Diary, 120, 5008855557, 5126253458, 117397901
/Volumes/methlab_data/HBN/EEG-ET/NDARKH421UB1/NDARKH421UB1_Video1_Samples_ET.mat, Diary, 60, 2534504744, 2651892546, 117387802
/Volumes/methlab_data/HBN/EEG-ET/NDARKH421UB1/NDARKH421UB1_Video3_Samples_ET.mat, Despicable, 60, 2115882515, 2286429850, 170547335
/Volumes/methlab_data/HBN/EEG-ET/NDARKH444AGK/NDARKH444AGK_Video1_Samples_ET.mat, Diary, 60, 4928213717, 5045606706, 117392989
/Volumes/methlab_data/HBN/EEG-ET/NDARKH444AGK/NDARKH444AGK_Video2_Samples_ET.mat, Fractals, 60, 3727884529, 3890875711, 162991182
/Volumes/methlab_data/HBN/EEG-ET/NDARKH444AGK/NDARKH444AGK_Video3_Samples_ET.mat, Despicable, 60, 4381092119, 4551635637, 170543518
/Volumes/methlab_data/HBN/EEG-ET/NDARKH444AGK/NDARKH444AGK_Video4_Samples_ET.mat, Present, 60, 5409357746, 5612427282, 203069536
/Volumes/methlab_data/HBN/EEG-ET/NDARKH837TB2/NDARKH837TB2_Video1_Samples_ET.mat, Diary, 60, 3090638837, 3208029118, 117390281
/Volumes/methlab_data/HBN/EEG-ET/NDARKH837TB2/NDARKH837TB2_Video3_Samples_ET.mat, Despicable, 60, 2652994414, 2823541436, 170547022
/Volumes/methlab_data/HBN/EEG-ET/NDARKH944KVE/NDARKH944KVE_Video-DM_Samples_ET.mat, Despicable, 60, 3850011792, 4020549196, 170537404
/Volumes/methlab_data/HBN/EEG-ET/NDARKH944KVE/NDARKH944KVE_Video-TP_Samples_ET.mat, Present, 60, 4319586339, 4522855798, 203269459
/Volumes/methlab_data/HBN/EEG-ET/NDARKH944KVE/NDARKH944KVE_Video-WK_Samples_ET.mat, Diary, 60, 2934523516, 3051908402, 117384886
/Volumes/methlab_data/HBN/EEG-ET/NDARKJ322ELL/NDARKJ322ELL_Video1_Samples_ET.mat, Diary, 60, 5453183497, 5570575961, 117392464
/Volumes/methlab_data/HBN/EEG-ET/NDARKJ322ELL/NDARKJ322ELL_Video2_Samples_ET.mat, Fractals, 60, 4346772134, 4509761991, 162989857
/Volumes/methlab_data/HBN/EEG-ET/NDARKJ322ELL/NDARKJ322ELL_Video3_Samples_ET.mat, Despicable, 60, 5003129632, 5173681874, 170552242
/Volumes/methlab_data/HBN/EEG-ET/NDARKJ322ELL/NDARKJ322ELL_Video4_Samples_ET.mat, Present, 60, 5887880473, 6090940860, 203060387
/Volumes/methlab_data/HBN/EEG-ET/NDARKJ871YD6/NDARKJ871YD6_Video-DM_Samples_ET.mat, Despicable, 60, 4019199782, 4189748317, 170548535
/Volumes/methlab_data/HBN/EEG-ET/NDARKJ871YD6/NDARKJ871YD6_Video-FF_Samples_ET.mat, Fractals, 60, 3314979144, 3477964360, 162985216
/Volumes/methlab_data/HBN/EEG-ET/NDARKJ871YD6/NDARKJ871YD6_Video-TP_Samples_ET.mat, Present, 60, 4983465194, 5186526697, 203061503
/Volumes/methlab_data/HBN/EEG-ET/NDARKJ871YD6/NDARKJ871YD6_Video-WK_Samples_ET.mat, Diary, 60, 4521382653, 4638774632, 117391979
/Volumes/methlab_data/HBN/EEG-ET/NDARKK000PNQ/NDARKK000PNQ_Video1_Samples_ET.mat, Diary, 60, 3362172853, 3479564014, 117391161
/Volumes/methlab_data/HBN/EEG-ET/NDARKK000PNQ/NDARKK000PNQ_Video2_Samples_ET.mat, Fractals, 60, 2154630505, 2317624975, 162994470
/Volumes/methlab_data/HBN/EEG-ET/NDARKK000PNQ/NDARKK000PNQ_Video3_Samples_ET.mat, Despicable, 60, 2872587059, 3043129876, 170542817
/Volumes/methlab_data/HBN/EEG-ET/NDARKK000PNQ/NDARKK000PNQ_Video4_Samples_ET.mat, Present, 60, 3806625680, 4009689558, 203063878
/Volumes/methlab_data/HBN/EEG-ET/NDARKK732JW3/NDARKK732JW3_Video1_Samples_ET.mat, Diary, 60, 105641166109, 105758562195, 117396086
/Volumes/methlab_data/HBN/EEG-ET/NDARKK732JW3/NDARKK732JW3_Video2_Samples_ET.mat, Fractals, 60, 104521304653, 104684289049, 162984396
/Volumes/methlab_data/HBN/EEG-ET/NDARKK732JW3/NDARKK732JW3_Video3_Samples_ET.mat, Despicable, 60, 105179016086, 105349565788, 170549702
/Volumes/methlab_data/HBN/EEG-ET/NDARKK732JW3/NDARKK732JW3_Video4_Samples_ET.mat, Present, 60, 106063613029, 106266682743, 203069714
/Volumes/methlab_data/HBN/EEG-ET/NDARKK774VP5/NDARKK774VP5_Video-DM_Samples_ET.mat, Despicable, 60, 3926544275, 4097097743, 170553468
/Volumes/methlab_data/HBN/EEG-ET/NDARKK774VP5/NDARKK774VP5_Video-FF_Samples_ET.mat, Fractals, 60, 3459403331, 3622393605, 162990274
/Volumes/methlab_data/HBN/EEG-ET/NDARKK774VP5/NDARKK774VP5_Video-TP_Samples_ET.mat, Present, 60, 4423486244, 4626549699, 203063455
/Volumes/methlab_data/HBN/EEG-ET/NDARKK774VP5/NDARKK774VP5_Video-WK_Samples_ET.mat, Diary, 60, 2990223953, 3107614901, 117390948
/Volumes/methlab_data/HBN/EEG-ET/NDARKL053DWW/NDARKL053DWW_Video-DM_Samples_ET.mat, Despicable, 30, 3854516282, 4025065399, 170549117
/Volumes/methlab_data/HBN/EEG-ET/NDARKL053DWW/NDARKL053DWW_Video-TP_Samples_ET.mat, Present, 30, 4352748074, 4556015771, 203267697
/Volumes/methlab_data/HBN/EEG-ET/NDARKL053DWW/NDARKL053DWW_Video-WK_Samples_ET.mat, Diary, 30, 2766992250, 2884391702, 117399452
/Volumes/methlab_data/HBN/EEG-ET/NDARKL156NJG/NDARKL156NJG_Video-DM_Samples_ET.mat, Despicable, 30, 3996976719, 4167525888, 170549169
/Volumes/methlab_data/HBN/EEG-ET/NDARKL156NJG/NDARKL156NJG_Video-TP_Samples_ET.mat, Present, 30, 5011271244, 5214549676, 203278432
/Volumes/methlab_data/HBN/EEG-ET/NDARKL156NJG/NDARKL156NJG_Video-WK_Samples_ET.mat, Diary, 30, 3550800752, 3668190153, 117389401
/Volumes/methlab_data/HBN/EEG-ET/NDARKL223LLF/NDARKL223LLF_Video-DM_Samples_ET.mat, Despicable, 60, 4672349850, 4842892751, 170542901
/Volumes/methlab_data/HBN/EEG-ET/NDARKL223LLF/NDARKL223LLF_Video-FF_Samples_ET.mat, Fractals, 60, 4188816179, 4351799703, 162983524
/Volumes/methlab_data/HBN/EEG-ET/NDARKL223LLF/NDARKL223LLF_Video-TP_Samples_ET.mat, Present, 60, 5179373186, 5382443110, 203069924
/Volumes/methlab_data/HBN/EEG-ET/NDARKL223LLF/NDARKL223LLF_Video-WK_Samples_ET.mat, Diary, 60, 3448889805, 3566285046, 117395241
/Volumes/methlab_data/HBN/EEG-ET/NDARKL327YDQ/NDARKL327YDQ_Video1_Samples_ET.mat, Diary, 120, 3155969167, 3273365140, 117395973
/Volumes/methlab_data/HBN/EEG-ET/NDARKL327YDQ/NDARKL327YDQ_Video2_Samples_ET.mat, Fractals, 120, 4005222221, 4168220209, 162997988
/Volumes/methlab_data/HBN/EEG-ET/NDARKL327YDQ/NDARKL327YDQ_Video3_Samples_ET.mat, Despicable, 120, 4514570554, 4685117293, 170546739
/Volumes/methlab_data/HBN/EEG-ET/NDARKL327YDQ/NDARKL327YDQ_Video4_Samples_ET.mat, Present, 120, 5196775623, 5399842718, 203067095
/Volumes/methlab_data/HBN/EEG-ET/NDARKM250ET5/NDARKM250ET5_Video1_Samples_ET.mat, Diary, 60, 6287031349, 6404432453, 117401104
/Volumes/methlab_data/HBN/EEG-ET/NDARKM250ET5/NDARKM250ET5_Video2_Samples_ET.mat, Fractals, 60, 7386981716, 7549969057, 162987341
/Volumes/methlab_data/HBN/EEG-ET/NDARKM250ET5/NDARKM250ET5_Video3_Samples_ET.mat, Despicable, 60, 6955448342, 7125995053, 170546711
/Volumes/methlab_data/HBN/EEG-ET/NDARKM250ET5/NDARKM250ET5_Video4_Samples_ET.mat, Present, 60, 7853161594, 8056232316, 203070722
/Volumes/methlab_data/HBN/EEG-ET/NDARKM301DY0/NDARKM301DY0_Video1_Samples_ET.mat, Diary, 60, 2470612733, 2588009614, 117396881
/Volumes/methlab_data/HBN/EEG-ET/NDARKM301DY0/NDARKM301DY0_Video2_Samples_ET.mat, Fractals, 60, 3605145259, 3768126267, 162981008
/Volumes/methlab_data/HBN/EEG-ET/NDARKM301DY0/NDARKM301DY0_Video3_Samples_ET.mat, Despicable, 60, 3136537602, 3307079979, 170542377
/Volumes/methlab_data/HBN/EEG-ET/NDARKM301DY0/NDARKM301DY0_Video4_Samples_ET.mat, Present, 60, 4258383171, 4461439443, 203056272
/Volumes/methlab_data/HBN/EEG-ET/NDARKM476GFK/NDARKM476GFK_Video1_Samples_ET.mat, Diary, 120, 4236617840, 4354014156, 117396316
/Volumes/methlab_data/HBN/EEG-ET/NDARKM476GFK/NDARKM476GFK_Video2_Samples_ET.mat, Fractals, 120, 5479486510, 5642472927, 162986417
/Volumes/methlab_data/HBN/EEG-ET/NDARKM476GFK/NDARKM476GFK_Video3_Samples_ET.mat, Despicable, 120, 5941316611, 6111864344, 170547733
/Volumes/methlab_data/HBN/EEG-ET/NDARKM476GFK/NDARKM476GFK_Video4_Samples_ET.mat, Present, 120, 6722062686, 6925125537, 203062851
/Volumes/methlab_data/HBN/EEG-ET/NDARKM497VKX/NDARKM497VKX_Video1_Samples_ET.mat, Diary, 120, 4439035740, 4556422727, 117386987
/Volumes/methlab_data/HBN/EEG-ET/NDARKM497VKX/NDARKM497VKX_Video2_Samples_ET.mat, Fractals, 120, 5519213829, 5682199803, 162985974
/Volumes/methlab_data/HBN/EEG-ET/NDARKM497VKX/NDARKM497VKX_Video3_Samples_ET.mat, Despicable, 120, 6234668504, 6405215341, 170546837
/Volumes/methlab_data/HBN/EEG-ET/NDARKM551DA4/NDARKM551DA4_Video1_Samples_ET.mat, Diary, 60, 176303599133, 176420992130, 117392997
/Volumes/methlab_data/HBN/EEG-ET/NDARKM551DA4/NDARKM551DA4_Video3_Samples_ET.mat, Despicable, 60, 177968829858, 178139376416, 170546558
/Volumes/methlab_data/HBN/EEG-ET/NDARKM568HJK/NDARKM568HJK_Video-DM_Samples_ET.mat, Despicable, 120, 7054427409, 7224974666, 170547257
/Volumes/methlab_data/HBN/EEG-ET/NDARKM568HJK/NDARKM568HJK_Video-FF_Samples_ET.mat, Fractals, 120, 5775371153, 5938358577, 162987424
/Volumes/methlab_data/HBN/EEG-ET/NDARKM568HJK/NDARKM568HJK_Video-TP_Samples_ET.mat, Present, 120, 7755683024, 7958750512, 203067488
/Volumes/methlab_data/HBN/EEG-ET/NDARKM568HJK/NDARKM568HJK_Video-WK_Samples_ET.mat, Diary, 120, 6659330286, 6776718101, 117387815
/Volumes/methlab_data/HBN/EEG-ET/NDARKM605AXX/NDARKM605AXX_Video1_Samples_ET.mat, Diary, 60, 3249057599, 3366456990, 117399391
/Volumes/methlab_data/HBN/EEG-ET/NDARKM605AXX/NDARKM605AXX_Video3_Samples_ET.mat, Despicable, 60, 3623758662, 3794301760, 170543098
/Volumes/methlab_data/HBN/EEG-ET/NDARKM605AXX/NDARKM605AXX_Video4_Samples_ET.mat, Present, 60, 4089445330, 4292515514, 203070184
/Volumes/methlab_data/HBN/EEG-ET/NDARKM635UY0/NDARKM635UY0_Video1_Samples_ET.mat, Diary, 120, 3258083641, 3375480475, 117396834
/Volumes/methlab_data/HBN/EEG-ET/NDARKM635UY0/NDARKM635UY0_Video2_Samples_ET.mat, Fractals, 120, 4854342009, 5017329182, 162987173
/Volumes/methlab_data/HBN/EEG-ET/NDARKM635UY0/NDARKM635UY0_Video3_Samples_ET.mat, Despicable, 120, 5336458555, 5507006672, 170548117
/Volumes/methlab_data/HBN/EEG-ET/NDARKM635UY0/NDARKM635UY0_Video4_Samples_ET.mat, Present, 120, 6067825585, 6270891526, 203065941
/Volumes/methlab_data/HBN/EEG-ET/NDARKM718VKX/NDARKM718VKX_Video-DM_Samples_ET.mat, Despicable, 60, 1941938411, 2112476577, 170538166
/Volumes/methlab_data/HBN/EEG-ET/NDARKM718VKX/NDARKM718VKX_Video-TP_Samples_ET.mat, Present, 60, 2424155155, 2627421407, 203266252
/Volumes/methlab_data/HBN/EEG-ET/NDARKM718VKX/NDARKM718VKX_Video-WK_Samples_ET.mat, Diary, 60, 529507212, 646893943, 117386731
/Volumes/methlab_data/HBN/EEG-ET/NDARKM784VA7/NDARKM784VA7_Video1_Samples_ET.mat, Diary, 60, 2088612049, 2206009420, 117397371
/Volumes/methlab_data/HBN/EEG-ET/NDARKM784VA7/NDARKM784VA7_Video3_Samples_ET.mat, Despicable, 60, 3307746661, 3478289785, 170543124
/Volumes/methlab_data/HBN/EEG-ET/NDARKM784VA7/NDARKM784VA7_Video4_Samples_ET.mat, Present, 60, 3777232998, 3980294231, 203061233
/Volumes/methlab_data/HBN/EEG-ET/NDARKM805EFA/NDARKM805EFA_Video-TP_Samples_ET.mat, Present, 30, 5445827034, 5649096795, 203269761
/Volumes/methlab_data/HBN/EEG-ET/NDARKM805EFA/NDARKM805EFA_Video-WK_Samples_ET.mat, Diary, 30, 3842680148, 3960068190, 117388042
/Volumes/methlab_data/HBN/EEG-ET/NDARKM823HJ7/NDARKM823HJ7_Video-DM_Samples_ET.mat, Despicable, 30, 2811319258, 2981854880, 170535622
/Volumes/methlab_data/HBN/EEG-ET/NDARKM823HJ7/NDARKM823HJ7_Video-TP_Samples_ET.mat, Present, 30, 3293225097, 3496501872, 203276775
/Volumes/methlab_data/HBN/EEG-ET/NDARKM823HJ7/NDARKM823HJ7_Video-WK_Samples_ET.mat, Diary, 30, 1579069718, 1696458761, 117389043
/Volumes/methlab_data/HBN/EEG-ET/NDARKM941XLL/NDARKM941XLL_Video1_Samples_ET.mat, Diary, 120, 3067319352, 3184715768, 117396416
/Volumes/methlab_data/HBN/EEG-ET/NDARKM941XLL/NDARKM941XLL_Video2_Samples_ET.mat, Fractals, 120, 4260840347, 4423838114, 162997767
/Volumes/methlab_data/HBN/EEG-ET/NDARKM941XLL/NDARKM941XLL_Video3_Samples_ET.mat, Despicable, 120, 4758317712, 4928865626, 170547914
/Volumes/methlab_data/HBN/EEG-ET/NDARKM941XLL/NDARKM941XLL_Video4_Samples_ET.mat, Present, 120, 5478175094, 5681251903, 203076809
/Volumes/methlab_data/HBN/EEG-ET/NDARKN346XZH/NDARKN346XZH_Video1_Samples_ET.mat, Diary, 60, 2805706650, 2923098518, 117391868
/Volumes/methlab_data/HBN/EEG-ET/NDARKN346XZH/NDARKN346XZH_Video2_Samples_ET.mat, Fractals, 60, 3024061774, 3187049849, 162988075
/Volumes/methlab_data/HBN/EEG-ET/NDARKN346XZH/NDARKN346XZH_Video3_Samples_ET.mat, Despicable, 60, 2579361850, 2749906247, 170544397
/Volumes/methlab_data/HBN/EEG-ET/NDARKN346XZH/NDARKN346XZH_Video4_Samples_ET.mat, Present, 60, 3239499863, 3442560217, 203060354
/Volumes/methlab_data/HBN/EEG-ET/NDARKN477EBH/NDARKN477EBH_Video-DM_Samples_ET.mat, Despicable, 120, 5677716040, 5848263068, 170547028
/Volumes/methlab_data/HBN/EEG-ET/NDARKN477EBH/NDARKN477EBH_Video-FF_Samples_ET.mat, Fractals, 120, 4955891575, 5118877441, 162985866
/Volumes/methlab_data/HBN/EEG-ET/NDARKN477EBH/NDARKN477EBH_Video-TP_Samples_ET.mat, Present, 120, 6831208889, 7034275664, 203066775
/Volumes/methlab_data/HBN/EEG-ET/NDARKN477EBH/NDARKN477EBH_Video-WK_Samples_ET.mat, Diary, 120, 6216544119, 6333940877, 117396758
/Volumes/methlab_data/HBN/EEG-ET/NDARKN509RP9/NDARKN509RP9_Video1_Samples_ET.mat, Diary, 60, 1671119193, 1788517732, 117398539
/Volumes/methlab_data/HBN/EEG-ET/NDARKN509RP9/NDARKN509RP9_Video3_Samples_ET.mat, Despicable, 60, 1459056348, 1629597712, 170541364
/Volumes/methlab_data/HBN/EEG-ET/NDARKN509RP9/NDARKN509RP9_Video4_Samples_ET.mat, Present, 60, 2060863446, 2263923929, 203060483
/Volumes/methlab_data/HBN/EEG-ET/NDARKN520GGD/NDARKN520GGD_Video-DM_Samples_ET.mat, Despicable, 60, 4355442346, 4525978873, 170536527
/Volumes/methlab_data/HBN/EEG-ET/NDARKN520GGD/NDARKN520GGD_Video-TP_Samples_ET.mat, Present, 60, 4958284335, 5161553004, 203268669
/Volumes/methlab_data/HBN/EEG-ET/NDARKN520GGD/NDARKN520GGD_Video-WK_Samples_ET.mat, Diary, 60, 2876820491, 2994208460, 117387969
/Volumes/methlab_data/HBN/EEG-ET/NDARKN633WZA/NDARKN633WZA_Video1_Samples_ET.mat, Diary, 120, 3687593317, 3804979906, 117386589
/Volumes/methlab_data/HBN/EEG-ET/NDARKN633WZA/NDARKN633WZA_Video2_Samples_ET.mat, Fractals, 120, 4521120030, 4684108354, 162988324
/Volumes/methlab_data/HBN/EEG-ET/NDARKN633WZA/NDARKN633WZA_Video3_Samples_ET.mat, Despicable, 120, 5096766476, 5267308519, 170542043
/Volumes/methlab_data/HBN/EEG-ET/NDARKN633WZA/NDARKN633WZA_Video4_Samples_ET.mat, Present, 120, 5741714009, 5944780908, 203066899
/Volumes/methlab_data/HBN/EEG-ET/NDARKN742LEV/NDARKN742LEV_Video-DM_Samples_ET.mat, Despicable, 60, 3445723522, 3616263233, 170539711
/Volumes/methlab_data/HBN/EEG-ET/NDARKN742LEV/NDARKN742LEV_Video-TP_Samples_ET.mat, Present, 60, 4012189838, 4215455489, 203265651
/Volumes/methlab_data/HBN/EEG-ET/NDARKN742LEV/NDARKN742LEV_Video-WK_Samples_ET.mat, Diary, 60, 2006369420, 2123755390, 117385970
/Volumes/methlab_data/HBN/EEG-ET/NDARKN988BRP/NDARKN988BRP_Video1_Samples_ET.mat, Diary, 60, 4780834848, 4898229633, 117394785
/Volumes/methlab_data/HBN/EEG-ET/NDARKN988BRP/NDARKN988BRP_Video3_Samples_ET.mat, Despicable, 60, 4365138684, 4535680962, 170542278
/Volumes/methlab_data/HBN/EEG-ET/NDARKN988BRP/NDARKN988BRP_Video4_Samples_ET.mat, Present, 60, 5191251270, 5394322491, 203071221
/Volumes/methlab_data/HBN/EEG-ET/NDARKP414AZ5/NDARKP414AZ5_Video-DM_Samples_ET.mat, Despicable, 120, 7467560777, 7638107030, 170546253
/Volumes/methlab_data/HBN/EEG-ET/NDARKP414AZ5/NDARKP414AZ5_Video-FF_Samples_ET.mat, Fractals, 120, 6733775595, 6896772864, 162997269
/Volumes/methlab_data/HBN/EEG-ET/NDARKP414AZ5/NDARKP414AZ5_Video-TP_Samples_ET.mat, Present, 120, 8532879797, 8735941156, 203061359
/Volumes/methlab_data/HBN/EEG-ET/NDARKP414AZ5/NDARKP414AZ5_Video-WK_Samples_ET.mat, Diary, 120, 7905007413, 8022404692, 117397279
/Volumes/methlab_data/HBN/EEG-ET/NDARKP815KPZ/NDARKP815KPZ_Video1_Samples_ET.mat, Diary, 60, 5615017569, 5732407376, 117389807
/Volumes/methlab_data/HBN/EEG-ET/NDARKP815KPZ/NDARKP815KPZ_Video3_Samples_ET.mat, Despicable, 60, 5138180429, 5308729675, 170549246
/Volumes/methlab_data/HBN/EEG-ET/NDARKR010EN7/NDARKR010EN7_Video1_Samples_ET.mat, Diary, 60, 990675205, 1108079236, 117404031
/Volumes/methlab_data/HBN/EEG-ET/NDARKR010EN7/NDARKR010EN7_Video3_Samples_ET.mat, Despicable, 60, 540584999, 711132591, 170547592
/Volumes/methlab_data/HBN/EEG-ET/NDARKR155ME9/NDARKR155ME9_Video1_Samples_ET.mat, Diary, 60, 5302896436, 5420287607, 117391171
/Volumes/methlab_data/HBN/EEG-ET/NDARKR155ME9/NDARKR155ME9_Video3_Samples_ET.mat, Despicable, 60, 6399158958, 6569703781, 170544823
/Volumes/methlab_data/HBN/EEG-ET/NDARKR155ME9/NDARKR155ME9_Video4_Samples_ET.mat, Present, 60, 6895096257, 7098158111, 203061854
/Volumes/methlab_data/HBN/EEG-ET/NDARKR195PL9/NDARKR195PL9_Video1_Samples_ET.mat, Diary, 60, 1541232228, 1658632979, 117400751
/Volumes/methlab_data/HBN/EEG-ET/NDARKR195PL9/NDARKR195PL9_Video3_Samples_ET.mat, Despicable, 60, 1333120496, 1503668787, 170548291
/Volumes/methlab_data/HBN/EEG-ET/NDARKR391CMV/NDARKR391CMV_Video-DM_Samples_ET.mat, Despicable, 60, 4682542905, 4853090562, 170547657
/Volumes/methlab_data/HBN/EEG-ET/NDARKR391CMV/NDARKR391CMV_Video-FF_Samples_ET.mat, Fractals, 60, 3483311730, 3646297013, 162985283
/Volumes/methlab_data/HBN/EEG-ET/NDARKR391CMV/NDARKR391CMV_Video-TP_Samples_ET.mat, Present, 60, 5163688206, 5366758848, 203070642
/Volumes/methlab_data/HBN/EEG-ET/NDARKR391CMV/NDARKR391CMV_Video-WK_Samples_ET.mat, Diary, 60, 4281439224, 4398834231, 117395007
/Volumes/methlab_data/HBN/EEG-ET/NDARKT032RYR/NDARKT032RYR_Video1_Samples_ET.mat, Diary, 60, 3924521402, 4041915478, 117394076
/Volumes/methlab_data/HBN/EEG-ET/NDARKT032RYR/NDARKT032RYR_Video2_Samples_ET.mat, Fractals, 60, 3645992311, 3808982664, 162990353
/Volumes/methlab_data/HBN/EEG-ET/NDARKT032RYR/NDARKT032RYR_Video3_Samples_ET.mat, Despicable, 60, 3426316855, 3596859558, 170542703
/Volumes/methlab_data/HBN/EEG-ET/NDARKT032RYR/NDARKT032RYR_Video4_Samples_ET.mat, Present, 60, 4087034407, 4290096106, 203061699
/Volumes/methlab_data/HBN/EEG-ET/NDARKT312RUD/NDARKT312RUD_Video-DM_Samples_ET.mat, Despicable, 120, 4899056721, 5069603656, 170546935
/Volumes/methlab_data/HBN/EEG-ET/NDARKT312RUD/NDARKT312RUD_Video-FF_Samples_ET.mat, Fractals, 120, 4203651768, 4366638109, 162986341
/Volumes/methlab_data/HBN/EEG-ET/NDARKT312RUD/NDARKT312RUD_Video-TP_Samples_ET.mat, Present, 120, 6009820261, 6212886851, 203066590
/Volumes/methlab_data/HBN/EEG-ET/NDARKT312RUD/NDARKT312RUD_Video-WK_Samples_ET.mat, Diary, 120, 5361993732, 5479391162, 117397430
/Volumes/methlab_data/HBN/EEG-ET/NDARKT540ZW0/NDARKT540ZW0_Video-DM_Samples_ET.mat, Despicable, 60, 7379683253, 7550230793, 170547540
/Volumes/methlab_data/HBN/EEG-ET/NDARKT540ZW0/NDARKT540ZW0_Video-FF_Samples_ET.mat, Fractals, 60, 6939608488, 7102598561, 162990073
/Volumes/methlab_data/HBN/EEG-ET/NDARKT540ZW0/NDARKT540ZW0_Video-TP_Samples_ET.mat, Present, 60, 7870177690, 8073234113, 203056423
/Volumes/methlab_data/HBN/EEG-ET/NDARKT540ZW0/NDARKT540ZW0_Video-WK_Samples_ET.mat, Diary, 60, 6308857932, 6426245891, 117387959
/Volumes/methlab_data/HBN/EEG-ET/NDARKT811ATJ/NDARKT811ATJ_Video1_Samples_ET.mat, Fractals, 120, 3456109042, 3619095847, 162986805
/Volumes/methlab_data/HBN/EEG-ET/NDARKT811ATJ/NDARKT811ATJ_Video2_Samples_ET.mat, Diary, 120, 4226593477, 4343990428, 117396951
/Volumes/methlab_data/HBN/EEG-ET/NDARKT811ATJ/NDARKT811ATJ_Video3_Samples_ET.mat, Despicable, 120, 4553421016, 4723968086, 170547070
/Volumes/methlab_data/HBN/EEG-ET/NDARKT811ATJ/NDARKT811ATJ_Video4_Samples_ET.mat, Present, 120, 5310396877, 5513464353, 203067476
/Volumes/methlab_data/HBN/EEG-ET/NDARKU043JMU/NDARKU043JMU_Video1_Samples_ET.mat, Diary, 60, 1699984686, 1817379890, 117395204
/Volumes/methlab_data/HBN/EEG-ET/NDARKU043JMU/NDARKU043JMU_Video3_Samples_ET.mat, Despicable, 60, 1289876485, 1460420205, 170543720
/Volumes/methlab_data/HBN/EEG-ET/NDARKU198KFL/NDARKU198KFL_Video1_Samples_ET.mat, Diary, 120, 3116379665, 3233777448, 117397783
/Volumes/methlab_data/HBN/EEG-ET/NDARKU198KFL/NDARKU198KFL_Video2_Samples_ET.mat, Despicable, 120, 4362762046, 4533310333, 170548287
/Volumes/methlab_data/HBN/EEG-ET/NDARKU198KFL/NDARKU198KFL_Video3_Samples_ET.mat, Fractals, 120, 4808632831, 4971616348, 162983517
/Volumes/methlab_data/HBN/EEG-ET/NDARKU198KFL/NDARKU198KFL_Video4_Samples_ET.mat, Present, 120, 5379241612, 5582306514, 203064902
/Volumes/methlab_data/HBN/EEG-ET/NDARKU278YRR/NDARKU278YRR_Video1_Samples_ET.mat, Diary, 120, 3010857477, 3128245412, 117387935
/Volumes/methlab_data/HBN/EEG-ET/NDARKU278YRR/NDARKU278YRR_Video2_Samples_ET.mat, Despicable, 120, 4020600926, 4191147927, 170547001
/Volumes/methlab_data/HBN/EEG-ET/NDARKU278YRR/NDARKU278YRR_Video3_Samples_ET.mat, Fractals, 120, 4493948379, 4656935193, 162986814
/Volumes/methlab_data/HBN/EEG-ET/NDARKU278YRR/NDARKU278YRR_Video4_Samples_ET.mat, Present, 120, 5130913163, 5333980890, 203067727
/Volumes/methlab_data/HBN/EEG-ET/NDARKU616UBL/NDARKU616UBL_Video1_Samples_ET.mat, Diary, 60, 5411929913, 5529318775, 117388862
/Volumes/methlab_data/HBN/EEG-ET/NDARKU616UBL/NDARKU616UBL_Video3_Samples_ET.mat, Despicable, 60, 4977714538, 5148254893, 170540355
/Volumes/methlab_data/HBN/EEG-ET/NDARKU649DB7/NDARKU649DB7_Video1_Samples_ET.mat, Fractals, 120, 3036709696, 3199698236, 162988540
/Volumes/methlab_data/HBN/EEG-ET/NDARKU649DB7/NDARKU649DB7_Video2_Samples_ET.mat, Diary, 120, 3724920277, 3842318155, 117397878
/Volumes/methlab_data/HBN/EEG-ET/NDARKU649DB7/NDARKU649DB7_Video3_Samples_ET.mat, Despicable, 120, 4117187907, 4287735556, 170547649
/Volumes/methlab_data/HBN/EEG-ET/NDARKU649DB7/NDARKU649DB7_Video4_Samples_ET.mat, Present, 120, 4675508074, 4878572150, 203064076
/Volumes/methlab_data/HBN/EEG-ET/NDARKU726AB4/NDARKU726AB4_Video-DM_Samples_ET.mat, Despicable, 60, 4426360346, 4596899812, 170539466
/Volumes/methlab_data/HBN/EEG-ET/NDARKU726AB4/NDARKU726AB4_Video-TP_Samples_ET.mat, Present, 60, 6210871724, 6414139311, 203267587
/Volumes/methlab_data/HBN/EEG-ET/NDARKU726AB4/NDARKU726AB4_Video-WK_Samples_ET.mat, Diary, 60, 5287060250, 5404451175, 117390925
/Volumes/methlab_data/HBN/EEG-ET/NDARKV353MTD/NDARKV353MTD_Video1_Samples_ET.mat, Diary, 60, 5785273748, 5902671471, 117397723
/Volumes/methlab_data/HBN/EEG-ET/NDARKV353MTD/NDARKV353MTD_Video2_Samples_ET.mat, Fractals, 60, 4554363901, 4717351172, 162987271
/Volumes/methlab_data/HBN/EEG-ET/NDARKV353MTD/NDARKV353MTD_Video3_Samples_ET.mat, Despicable, 60, 5262827136, 5433383816, 170556680
/Volumes/methlab_data/HBN/EEG-ET/NDARKV353MTD/NDARKV353MTD_Video4_Samples_ET.mat, Present, 60, 6235552854, 6438613720, 203060866
/Volumes/methlab_data/HBN/EEG-ET/NDARKV800DTW/NDARKV800DTW_Video-DM_Samples_ET.mat, Despicable, 120, 6046863242, 6217410207, 170546965
/Volumes/methlab_data/HBN/EEG-ET/NDARKV800DTW/NDARKV800DTW_Video-FF_Samples_ET.mat, Fractals, 120, 5349488867, 5512472698, 162983831
/Volumes/methlab_data/HBN/EEG-ET/NDARKV800DTW/NDARKV800DTW_Video-TP_Samples_ET.mat, Present, 120, 7106217567, 7309284675, 203067108
/Volumes/methlab_data/HBN/EEG-ET/NDARKV800DTW/NDARKV800DTW_Video-WK_Samples_ET.mat, Diary, 120, 6498111522, 6615508022, 117396500
/Volumes/methlab_data/HBN/EEG-ET/NDARKV807EMJ/NDARKV807EMJ_Video1_Samples_ET.mat, Diary, 120, 5233173235, 5350564271, 117391036
/Volumes/methlab_data/HBN/EEG-ET/NDARKV807EMJ/NDARKV807EMJ_Video2_Samples_ET.mat, Fractals, 120, 5853571872, 6016569569, 162997697
/Volumes/methlab_data/HBN/EEG-ET/NDARKV807EMJ/NDARKV807EMJ_Video3_Samples_ET.mat, Despicable, 120, 6336699388, 6507247897, 170548509
/Volumes/methlab_data/HBN/EEG-ET/NDARKV807EMJ/NDARKV807EMJ_Video4_Samples_ET.mat, Present, 120, 7012725950, 7215793619, 203067669
/Volumes/methlab_data/HBN/EEG-ET/NDARKV965WLU/NDARKV965WLU_Video1_Samples_ET.mat, Diary, 60, 2499687535, 2617088784, 117401249
/Volumes/methlab_data/HBN/EEG-ET/NDARKV965WLU/NDARKV965WLU_Video3_Samples_ET.mat, Despicable, 60, 2243394805, 2413944743, 170549938
/Volumes/methlab_data/HBN/EEG-ET/NDARKW010CT2/NDARKW010CT2_Video1_Samples_ET.mat, Diary, 120, 3043393558, 3160791588, 117398030
/Volumes/methlab_data/HBN/EEG-ET/NDARKW010CT2/NDARKW010CT2_Video2_Samples_ET.mat, Fractals, 120, 4165197574, 4328194347, 162996773
/Volumes/methlab_data/HBN/EEG-ET/NDARKW010CT2/NDARKW010CT2_Video3_Samples_ET.mat, Despicable, 120, 4670024768, 4840572131, 170547363
/Volumes/methlab_data/HBN/EEG-ET/NDARKW010CT2/NDARKW010CT2_Video4_Samples_ET.mat, Present, 120, 5327981760, 5531048805, 203067045
/Volumes/methlab_data/HBN/EEG-ET/NDARKW383ZPF/NDARKW383ZPF_Video1_Samples_ET.mat, Fractals, 120, 7287157149, 7450153187, 162996038
/Volumes/methlab_data/HBN/EEG-ET/NDARKW383ZPF/NDARKW383ZPF_Video2_Samples_ET.mat, Despicable, 120, 8034343812, 8204887177, 170543365
/Volumes/methlab_data/HBN/EEG-ET/NDARKW383ZPF/NDARKW383ZPF_Video3_Samples_ET.mat, Diary, 120, 8625258523, 8742656192, 117397669
/Volumes/methlab_data/HBN/EEG-ET/NDARKW383ZPF/NDARKW383ZPF_Video4_Samples_ET.mat, Present, 120, 9114305353, 9317374308, 203068955
/Volumes/methlab_data/HBN/EEG-ET/NDARKW521EMY/NDARKW521EMY_Video1_Samples_ET.mat, Diary, 60, 3805089499, 3922485009, 117395510
/Volumes/methlab_data/HBN/EEG-ET/NDARKW521EMY/NDARKW521EMY_Video3_Samples_ET.mat, Despicable, 60, 3383240438, 3553786745, 170546307
/Volumes/methlab_data/HBN/EEG-ET/NDARKW521EMY/NDARKW521EMY_Video4_Samples_ET.mat, Present, 60, 4316374214, 4519446693, 203072479
/Volumes/methlab_data/HBN/EEG-ET/NDARKW565ZT9/NDARKW565ZT9_Video-DM_Samples_ET.mat, Despicable, 120, 4693163859, 4863709812, 170545953
/Volumes/methlab_data/HBN/EEG-ET/NDARKW565ZT9/NDARKW565ZT9_Video-FF_Samples_ET.mat, Fractals, 120, 3987888008, 4150883560, 162995552
/Volumes/methlab_data/HBN/EEG-ET/NDARKW565ZT9/NDARKW565ZT9_Video-TP_Samples_ET.mat, Present, 120, 5741796106, 5944863565, 203067459
/Volumes/methlab_data/HBN/EEG-ET/NDARKW565ZT9/NDARKW565ZT9_Video-WK_Samples_ET.mat, Diary, 120, 5186359760, 5303757098, 117397338
/Volumes/methlab_data/HBN/EEG-ET/NDARKW738AMY/NDARKW738AMY_Video1_Samples_ET.mat, Despicable, 120, 4561550939, 4732097130, 170546191
/Volumes/methlab_data/HBN/EEG-ET/NDARKW738AMY/NDARKW738AMY_Video2_Samples_ET.mat, Diary, 120, 5617933895, 5735331926, 117398031
/Volumes/methlab_data/HBN/EEG-ET/NDARKW738AMY/NDARKW738AMY_Video3_Samples_ET.mat, Fractals, 120, 5851352680, 6014340765, 162988085
/Volumes/methlab_data/HBN/EEG-ET/NDARKW738AMY/NDARKW738AMY_Video4_Samples_ET.mat, Present, 120, 6058971493, 6262039133, 203067640
/Volumes/methlab_data/HBN/EEG-ET/NDARKX265YX7/NDARKX265YX7_Video-DM_Samples_ET.mat, Despicable, 60, 2008653473, 2179199076, 170545603
/Volumes/methlab_data/HBN/EEG-ET/NDARKX265YX7/NDARKX265YX7_Video-FF_Samples_ET.mat, Fractals, 60, 2312033141, 2475017617, 162984476
/Volumes/methlab_data/HBN/EEG-ET/NDARKX265YX7/NDARKX265YX7_Video-TP_Samples_ET.mat, Present, 60, 2823925727, 3026987606, 203061879
/Volumes/methlab_data/HBN/EEG-ET/NDARKX265YX7/NDARKX265YX7_Video-WK_Samples_ET.mat, Diary, 60, 2586146304, 2703539511, 117393207
/Volumes/methlab_data/HBN/EEG-ET/NDARKX346VTV/NDARKX346VTV_Video1_Samples_ET.mat, Diary, 60, 2507396637, 2624792715, 117396078
/Volumes/methlab_data/HBN/EEG-ET/NDARKX346VTV/NDARKX346VTV_Video3_Samples_ET.mat, Despicable, 60, 3696689187, 3867233898, 170544711
/Volumes/methlab_data/HBN/EEG-ET/NDARKX488MG0/NDARKX488MG0_Video-DM_Samples_ET.mat, Despicable, 60, 2217081902, 2387622512, 170540610
/Volumes/methlab_data/HBN/EEG-ET/NDARKX488MG0/NDARKX488MG0_Video-FF_Samples_ET.mat, Fractals, 60, 3323288987, 3486273230, 162984243
/Volumes/methlab_data/HBN/EEG-ET/NDARKX488MG0/NDARKX488MG0_Video-TP_Samples_ET.mat, Present, 60, 3800423314, 4003482907, 203059593
/Volumes/methlab_data/HBN/EEG-ET/NDARKX488MG0/NDARKX488MG0_Video-WK_Samples_ET.mat, Diary, 60, 2801838311, 2919231518, 117393207
/Volumes/methlab_data/HBN/EEG-ET/NDARKX528PH3/NDARKX528PH3_Video1_Samples_ET.mat, Despicable, 120, 3508501058, 3679045725, 170544667
/Volumes/methlab_data/HBN/EEG-ET/NDARKX528PH3/NDARKX528PH3_Video2_Samples_ET.mat, Diary, 120, 4565444314, 4682841297, 117396983
/Volumes/methlab_data/HBN/EEG-ET/NDARKX528PH3/NDARKX528PH3_Video3_Samples_ET.mat, Fractals, 120, 4928941812, 5091929311, 162987499
/Volumes/methlab_data/HBN/EEG-ET/NDARKX528PH3/NDARKX528PH3_Video4_Samples_ET.mat, Present, 120, 5462403625, 5665466645, 203063020
/Volumes/methlab_data/HBN/EEG-ET/NDARKX665ZD3/NDARKX665ZD3_Video1_Samples_ET.mat, Diary, 60, 4080953177, 4198343184, 117390007
/Volumes/methlab_data/HBN/EEG-ET/NDARKX665ZD3/NDARKX665ZD3_Video2_Samples_ET.mat, Fractals, 60, 2909915239, 3072906513, 162991274
/Volumes/methlab_data/HBN/EEG-ET/NDARKX665ZD3/NDARKX665ZD3_Video3_Samples_ET.mat, Despicable, 60, 3636866223, 3807409798, 170543575
/Volumes/methlab_data/HBN/EEG-ET/NDARKX665ZD3/NDARKX665ZD3_Video4_Samples_ET.mat, Present, 60, 4512977634, 4716036197, 203058563
/Volumes/methlab_data/HBN/EEG-ET/NDARKX761BH9/NDARKX761BH9_Video1_Samples_ET.mat, Diary, 60, 1967891909, 2085289830, 117397921
/Volumes/methlab_data/HBN/EEG-ET/NDARKX761BH9/NDARKX761BH9_Video3_Samples_ET.mat, Despicable, 60, 3426774791, 3597314205, 170539414
/Volumes/methlab_data/HBN/EEG-ET/NDARKX788PHG/NDARKX788PHG_Video1_Samples_ET.mat, Diary, 120, 7894594631, 8011991272, 117396641
/Volumes/methlab_data/HBN/EEG-ET/NDARKX788PHG/NDARKX788PHG_Video2_Samples_ET.mat, Fractals, 120, 9133146031, 9296134109, 162988078
/Volumes/methlab_data/HBN/EEG-ET/NDARKX788PHG/NDARKX788PHG_Video3_Samples_ET.mat, Despicable, 120, 9622145063, 9792691687, 170546624
/Volumes/methlab_data/HBN/EEG-ET/NDARKX788PHG/NDARKX788PHG_Video4_Samples_ET.mat, Present, 120, 10318804750, 10521867811, 203063061
/Volumes/methlab_data/HBN/EEG-ET/NDARKY667THK/NDARKY667THK_Video1_Samples_ET.mat, Diary, 120, 3539106302, 3656503086, 117396784
/Volumes/methlab_data/HBN/EEG-ET/NDARKY667THK/NDARKY667THK_Video2_Samples_ET.mat, Fractals, 120, 4773368482, 4936354285, 162985803
/Volumes/methlab_data/HBN/EEG-ET/NDARKY667THK/NDARKY667THK_Video3_Samples_ET.mat, Despicable, 120, 5250334181, 5420881451, 170547270
/Volumes/methlab_data/HBN/EEG-ET/NDARKY667THK/NDARKY667THK_Video4_Samples_ET.mat, Present, 120, 5916820085, 6119887432, 203067347
/Volumes/methlab_data/HBN/EEG-ET/NDARKZ031NJZ/NDARKZ031NJZ_Video-DM_Samples_ET.mat, Despicable, 120, 3829077759, 3999627424, 170549665
/Volumes/methlab_data/HBN/EEG-ET/NDARKZ031NJZ/NDARKZ031NJZ_Video-FF_Samples_ET.mat, Fractals, 120, 3454303799, 3617289702, 162985903
/Volumes/methlab_data/HBN/EEG-ET/NDARKZ031NJZ/NDARKZ031NJZ_Video-TP_Samples_ET.mat, Present, 120, 4372655712, 4575718054, 203062342
/Volumes/methlab_data/HBN/EEG-ET/NDARKZ031NJZ/NDARKZ031NJZ_Video-WK_Samples_ET.mat, Diary, 120, 2775258098, 2892654023, 117395925
/Volumes/methlab_data/HBN/EEG-ET/NDARKZ085UKQ/NDARKZ085UKQ_Video1_Samples_ET.mat, Diary, 60, 2327152078, 2444546449, 117394371
/Volumes/methlab_data/HBN/EEG-ET/NDARKZ085UKQ/NDARKZ085UKQ_Video2_Samples_ET.mat, Fractals, 60, 2822454761, 2985439491, 162984730
/Volumes/methlab_data/HBN/EEG-ET/NDARKZ085UKQ/NDARKZ085UKQ_Video3_Samples_ET.mat, Despicable, 60, 3238622241, 3409167622, 170545381
/Volumes/methlab_data/HBN/EEG-ET/NDARKZ085UKQ/NDARKZ085UKQ_Video4_Samples_ET.mat, Present, 60, 3705452707, 3908511914, 203059207
/Volumes/methlab_data/HBN/EEG-ET/NDARKZ198TAA/NDARKZ198TAA_Video-DM_Samples_ET.mat, Despicable, 120, 4163313868, 4333857029, 170543161
/Volumes/methlab_data/HBN/EEG-ET/NDARKZ198TAA/NDARKZ198TAA_Video-FF_Samples_ET.mat, Fractals, 120, 3516963727, 3679950146, 162986419
/Volumes/methlab_data/HBN/EEG-ET/NDARKZ198TAA/NDARKZ198TAA_Video-TP_Samples_ET.mat, Present, 120, 5078671824, 5281735565, 203063741
/Volumes/methlab_data/HBN/EEG-ET/NDARKZ198TAA/NDARKZ198TAA_Video-WK_Samples_ET.mat, Diary, 120, 4556216004, 4673613264, 117397260
/Volumes/methlab_data/HBN/EEG-ET/NDARKZ312XR1/NDARKZ312XR1_Video1_Samples_ET.mat, Despicable, 120, 4887480573, 5058028657, 170548084
/Volumes/methlab_data/HBN/EEG-ET/NDARKZ312XR1/NDARKZ312XR1_Video2_Samples_ET.mat, Diary, 120, 5115199571, 5232597126, 117397555
/Volumes/methlab_data/HBN/EEG-ET/NDARKZ312XR1/NDARKZ312XR1_Video3_Samples_ET.mat, Fractals, 120, 5361037435, 5524025261, 162987826
/Volumes/methlab_data/HBN/EEG-ET/NDARKZ312XR1/NDARKZ312XR1_Video4_Samples_ET.mat, Present, 120, 5580687503, 5783756710, 203069207
/Volumes/methlab_data/HBN/EEG-ET/NDARKZ479FC8/NDARKZ479FC8_Video1_Samples_ET.mat, Diary, 120, 3200608797, 3318006200, 117397403
/Volumes/methlab_data/HBN/EEG-ET/NDARKZ479FC8/NDARKZ479FC8_Video2_Samples_ET.mat, Fractals, 120, 4336531997, 4499519531, 162987534
/Volumes/methlab_data/HBN/EEG-ET/NDARKZ479FC8/NDARKZ479FC8_Video3_Samples_ET.mat, Despicable, 120, 4867438879, 5037986814, 170547935
/Volumes/methlab_data/HBN/EEG-ET/NDARKZ479FC8/NDARKZ479FC8_Video4_Samples_ET.mat, Present, 120, 5664084457, 5867152208, 203067751
/Volumes/methlab_data/HBN/EEG-ET/NDARKZ634RVX/NDARKZ634RVX_Video1_Samples_ET.mat, Diary, 120, 3614391951, 3731788252, 117396301
/Volumes/methlab_data/HBN/EEG-ET/NDARKZ634RVX/NDARKZ634RVX_Video2_Samples_ET.mat, Fractals, 120, 4301376888, 4464363747, 162986859
/Volumes/methlab_data/HBN/EEG-ET/NDARKZ634RVX/NDARKZ634RVX_Video3_Samples_ET.mat, Despicable, 120, 4760323921, 4930870665, 170546744
/Volumes/methlab_data/HBN/EEG-ET/NDARKZ634RVX/NDARKZ634RVX_Video4_Samples_ET.mat, Present, 120, 5414739217, 5617806778, 203067561
/Volumes/methlab_data/HBN/EEG-ET/NDARKZ949UAL/NDARKZ949UAL_Video-DM_Samples_ET.mat, Despicable, 60, 4940270145, 5110817430, 170547285
/Volumes/methlab_data/HBN/EEG-ET/NDARKZ949UAL/NDARKZ949UAL_Video-TP_Samples_ET.mat, Present, 60, 5985470245, 6188736600, 203266355
/Volumes/methlab_data/HBN/EEG-ET/NDARKZ949UAL/NDARKZ949UAL_Video-WK_Samples_ET.mat, Diary, 60, 5452255184, 5569642999, 117387815
/Volumes/methlab_data/HBN/EEG-ET/NDARLA226ADX/NDARLA226ADX_Video-DM_Samples_ET.mat, Despicable, 60, 4996330955, 5166871186, 170540231
/Volumes/methlab_data/HBN/EEG-ET/NDARLA226ADX/NDARLA226ADX_Video-FF_Samples_ET.mat, Fractals, 60, 4541970028, 4704956920, 162986892
/Volumes/methlab_data/HBN/EEG-ET/NDARLA226ADX/NDARLA226ADX_Video-TP_Samples_ET.mat, Present, 60, 5502674840, 5705747215, 203072375
/Volumes/methlab_data/HBN/EEG-ET/NDARLA226ADX/NDARLA226ADX_Video-WK_Samples_ET.mat, Diary, 60, 3808250575, 3925649002, 117398427
/Volumes/methlab_data/HBN/EEG-ET/NDARLA457ELH/NDARLA457ELH_Video-DM_Samples_ET.mat, Despicable, 60, 4232347272, 4402892546, 170545274
/Volumes/methlab_data/HBN/EEG-ET/NDARLA457ELH/NDARLA457ELH_Video-FF_Samples_ET.mat, Fractals, 60, 4834079921, 4997062003, 162982082
/Volumes/methlab_data/HBN/EEG-ET/NDARLA457ELH/NDARLA457ELH_Video-TP_Samples_ET.mat, Present, 60, 5878672329, 6081733714, 203061385
/Volumes/methlab_data/HBN/EEG-ET/NDARLA457ELH/NDARLA457ELH_Video-WK_Samples_ET.mat, Diary, 60, 5351471179, 5468864065, 117392886
/Volumes/methlab_data/HBN/EEG-ET/NDARLA516PH1/NDARLA516PH1_Video1_Samples_ET.mat, Diary, 60, 2897751351, 3015145187, 117393836
/Volumes/methlab_data/HBN/EEG-ET/NDARLA516PH1/NDARLA516PH1_Video3_Samples_ET.mat, Despicable, 60, 2432214879, 2602761236, 170546357
/Volumes/methlab_data/HBN/EEG-ET/NDARLA623HN3/NDARLA623HN3_Video1_Samples_ET.mat, Diary, 120, 4523068356, 4640465813, 117397457
/Volumes/methlab_data/HBN/EEG-ET/NDARLA623HN3/NDARLA623HN3_Video2_Samples_ET.mat, Fractals, 120, 5705010660, 5867999064, 162988404
/Volumes/methlab_data/HBN/EEG-ET/NDARLA623HN3/NDARLA623HN3_Video3_Samples_ET.mat, Despicable, 120, 6229658600, 6400205790, 170547190
/Volumes/methlab_data/HBN/EEG-ET/NDARLA788EWU/NDARLA788EWU_Video1_Samples_ET.mat, Diary, 60, 5782871163, 5900259382, 117388219
/Volumes/methlab_data/HBN/EEG-ET/NDARLA788EWU/NDARLA788EWU_Video2_Samples_ET.mat, Fractals, 60, 4659222837, 4822211341, 162988504
/Volumes/methlab_data/HBN/EEG-ET/NDARLA788EWU/NDARLA788EWU_Video3_Samples_ET.mat, Despicable, 60, 5311714256, 5482266137, 170551881
/Volumes/methlab_data/HBN/EEG-ET/NDARLA788EWU/NDARLA788EWU_Video4_Samples_ET.mat, Present, 60, 6243192424, 6446252321, 203059897
/Volumes/methlab_data/HBN/EEG-ET/NDARLA998XAC/NDARLA998XAC_Video-DM_Samples_ET.mat, Despicable, 120, 5041052472, 5211594657, 170542185
/Volumes/methlab_data/HBN/EEG-ET/NDARLA998XAC/NDARLA998XAC_Video-FF_Samples_ET.mat, Fractals, 120, 4562385203, 4725371458, 162986255
/Volumes/methlab_data/HBN/EEG-ET/NDARLA998XAC/NDARLA998XAC_Video-TP_Samples_ET.mat, Present, 120, 5691905634, 5894968526, 203062892
/Volumes/methlab_data/HBN/EEG-ET/NDARLA998XAC/NDARLA998XAC_Video-WK_Samples_ET.mat, Diary, 120, 3596095061, 3713493249, 117398188
/Volumes/methlab_data/HBN/EEG-ET/NDARLB017MBJ/NDARLB017MBJ_Video1_Samples_ET.mat, Diary, 60, 1856617287, 1974006220, 117388933
/Volumes/methlab_data/HBN/EEG-ET/NDARLB017MBJ/NDARLB017MBJ_Video3_Samples_ET.mat, Despicable, 60, 3186176334, 3356726818, 170550484
/Volumes/methlab_data/HBN/EEG-ET/NDARLB162XP2/NDARLB162XP2_Video1_Samples_ET.mat, Diary, 120, 4298766056, 4416161520, 117395464
/Volumes/methlab_data/HBN/EEG-ET/NDARLB162XP2/NDARLB162XP2_Video2_Samples_ET.mat, Fractals, 120, 5331489455, 5494475069, 162985614
/Volumes/methlab_data/HBN/EEG-ET/NDARLB162XP2/NDARLB162XP2_Video3_Samples_ET.mat, Despicable, 120, 5738748002, 5909292852, 170544850
/Volumes/methlab_data/HBN/EEG-ET/NDARLB162XP2/NDARLB162XP2_Video4_Samples_ET.mat, Present, 120, 6334076341, 6537139429, 203063088
/Volumes/methlab_data/HBN/EEG-ET/NDARLB291FBV/NDARLB291FBV_Video-DM_Samples_ET.mat, Despicable, 30, 2905706676, 3076244307, 170537631
/Volumes/methlab_data/HBN/EEG-ET/NDARLB547HJD/NDARLB547HJD_Video1_Samples_ET.mat, Diary, 60, 3688552965, 3805948951, 117395986
/Volumes/methlab_data/HBN/EEG-ET/NDARLB547HJD/NDARLB547HJD_Video3_Samples_ET.mat, Despicable, 60, 3256350569, 3426892094, 170541525
/Volumes/methlab_data/HBN/EEG-ET/NDARLB547HJD/NDARLB547HJD_Video4_Samples_ET.mat, Present, 60, 4113432230, 4316492719, 203060489
/Volumes/methlab_data/HBN/EEG-ET/NDARLB581AXF/NDARLB581AXF_Video1_Samples_ET.mat, Diary, 60, 5808459200, 5925852161, 117392961
/Volumes/methlab_data/HBN/EEG-ET/NDARLB581AXF/NDARLB581AXF_Video2_Samples_ET.mat, Fractals, 60, 4389569523, 4552560733, 162991210
/Volumes/methlab_data/HBN/EEG-ET/NDARLB581AXF/NDARLB581AXF_Video3_Samples_ET.mat, Despicable, 60, 5343052316, 5513607866, 170555550
/Volumes/methlab_data/HBN/EEG-ET/NDARLB581AXF/NDARLB581AXF_Video4_Samples_ET.mat, Present, 60, 6337929323, 6541078967, 203149644
/Volumes/methlab_data/HBN/EEG-ET/NDARLB629BJ1/NDARLB629BJ1_Video1_Samples_ET.mat, Diary, 60, 2236653385, 2354048239, 117394854
/Volumes/methlab_data/HBN/EEG-ET/NDARLC358CYJ/NDARLC358CYJ_Video1_Samples_ET.mat, Diary, 60, 3152425636, 3269823534, 117397898
/Volumes/methlab_data/HBN/EEG-ET/NDARLC358CYJ/NDARLC358CYJ_Video3_Samples_ET.mat, Despicable, 60, 2396467979, 2567013402, 170545423
/Volumes/methlab_data/HBN/EEG-ET/NDARLC655XBR/NDARLC655XBR_Video-DM_Samples_ET.mat, Despicable, 60, 2818726257, 2989277747, 170551490
/Volumes/methlab_data/HBN/EEG-ET/NDARLC655XBR/NDARLC655XBR_Video-FF_Samples_ET.mat, Fractals, 60, 2361021974, 2524003086, 162981112
/Volumes/methlab_data/HBN/EEG-ET/NDARLC655XBR/NDARLC655XBR_Video-TP_Samples_ET.mat, Present, 60, 3316437783, 3519497223, 203059440
/Volumes/methlab_data/HBN/EEG-ET/NDARLC655XBR/NDARLC655XBR_Video-WK_Samples_ET.mat, Diary, 60, 1920457805, 2037849743, 117391938
/Volumes/methlab_data/HBN/EEG-ET/NDARLC770YL9/NDARLC770YL9_Video-DM_Samples_ET.mat, Despicable, 30, 3282762340, 3453313830, 170551490
/Volumes/methlab_data/HBN/EEG-ET/NDARLC770YL9/NDARLC770YL9_Video-TP_Samples_ET.mat, Present, 30, 3785175188, 3988452779, 203277591
/Volumes/methlab_data/HBN/EEG-ET/NDARLC770YL9/NDARLC770YL9_Video-WK_Samples_ET.mat, Diary, 30, 2133352568, 2250743460, 117390892
/Volumes/methlab_data/HBN/EEG-ET/NDARLD016VCA/NDARLD016VCA_Video1_Samples_ET.mat, Diary, 60, 8391663014, 8509054951, 117391937
/Volumes/methlab_data/HBN/EEG-ET/NDARLD016VCA/NDARLD016VCA_Video3_Samples_ET.mat, Despicable, 60, 7930169080, 8100710539, 170541459
/Volumes/methlab_data/HBN/EEG-ET/NDARLD287MLP/NDARLD287MLP_Video-DM_Samples_ET.mat, Despicable, 60, 4590577440, 4761118977, 170541537
/Volumes/methlab_data/HBN/EEG-ET/NDARLD287MLP/NDARLD287MLP_Video-FF_Samples_ET.mat, Fractals, 60, 4164988692, 4327972899, 162984207
/Volumes/methlab_data/HBN/EEG-ET/NDARLD287MLP/NDARLD287MLP_Video-TP_Samples_ET.mat, Present, 60, 5137797132, 5340860647, 203063515
/Volumes/methlab_data/HBN/EEG-ET/NDARLD287MLP/NDARLD287MLP_Video-WK_Samples_ET.mat, Diary, 60, 3562368866, 3679766841, 117397975
/Volumes/methlab_data/HBN/EEG-ET/NDARLD738DUM/NDARLD738DUM_Video1_Samples_ET.mat, Diary, 60, 1857691447, 1975084508, 117393061
/Volumes/methlab_data/HBN/EEG-ET/NDARLD738DUM/NDARLD738DUM_Video2_Samples_ET.mat, Fractals, 60, 2751727777, 2914710070, 162982293
/Volumes/methlab_data/HBN/EEG-ET/NDARLD738DUM/NDARLD738DUM_Video3_Samples_ET.mat, Despicable, 60, 3207478113, 3378016775, 170538662
/Volumes/methlab_data/HBN/EEG-ET/NDARLD738DUM/NDARLD738DUM_Video4_Samples_ET.mat, Present, 60, 3699875368, 3902947018, 203071650
/Volumes/methlab_data/HBN/EEG-ET/NDARLD978JVJ/NDARLD978JVJ_Video1_Samples_ET.mat, Diary, 60, 4881324218, 4998719060, 117394842
/Volumes/methlab_data/HBN/EEG-ET/NDARLD978JVJ/NDARLD978JVJ_Video2_Samples_ET.mat, Fractals, 60, 5873309124, 6036299160, 162990036
/Volumes/methlab_data/HBN/EEG-ET/NDARLD978JVJ/NDARLD978JVJ_Video3_Samples_ET.mat, Despicable, 60, 6109408718, 6279954065, 170545347
/Volumes/methlab_data/HBN/EEG-ET/NDARLD978JVJ/NDARLD978JVJ_Video4_Samples_ET.mat, Present, 60, 6344690748, 6547761029, 203070281
/Volumes/methlab_data/HBN/EEG-ET/NDARLD990NH4/NDARLD990NH4_Video1_Samples_ET.mat, Diary, 60, 1016576361, 1133969434, 117393073
/Volumes/methlab_data/HBN/EEG-ET/NDARLD990NH4/NDARLD990NH4_Video3_Samples_ET.mat, Despicable, 60, 760644213, 931187919, 170543706
/Volumes/methlab_data/HBN/EEG-ET/NDARLE091XAZ/NDARLE091XAZ_Video1_Samples_ET.mat, Diary, 60, 4633677978, 4751074886, 117396908
/Volumes/methlab_data/HBN/EEG-ET/NDARLE091XAZ/NDARLE091XAZ_Video2_Samples_ET.mat, Fractals, 60, 5174048457, 5337033595, 162985138
/Volumes/methlab_data/HBN/EEG-ET/NDARLE091XAZ/NDARLE091XAZ_Video3_Samples_ET.mat, Despicable, 60, 5600784688, 5771330127, 170545439
/Volumes/methlab_data/HBN/EEG-ET/NDARLE091XAZ/NDARLE091XAZ_Video4_Samples_ET.mat, Present, 60, 6086348465, 6289408839, 203060374
/Volumes/methlab_data/HBN/EEG-ET/NDARLE282UHJ/NDARLE282UHJ_Video-DM_Samples_ET.mat, Despicable, 30, 3634179413, 3804717890, 170538477
/Volumes/methlab_data/HBN/EEG-ET/NDARLE282UHJ/NDARLE282UHJ_Video-TP_Samples_ET.mat, Present, 30, 4474746097, 4678016685, 203270588
/Volumes/methlab_data/HBN/EEG-ET/NDARLE282UHJ/NDARLE282UHJ_Video-WK_Samples_ET.mat, Diary, 30, 4061886491, 4179276428, 117389937
/Volumes/methlab_data/HBN/EEG-ET/NDARLE335PRN/NDARLE335PRN_Video-DM_Samples_ET.mat, Despicable, 60, 10672396183, 10842944399, 170548216
/Volumes/methlab_data/HBN/EEG-ET/NDARLE335PRN/NDARLE335PRN_Video-TP_Samples_ET.mat, Present, 60, 11593996825, 11797274148, 203277323
/Volumes/methlab_data/HBN/EEG-ET/NDARLE335PRN/NDARLE335PRN_Video-WK_Samples_ET.mat, Diary, 60, 11138052404, 11255454188, 117401784
/Volumes/methlab_data/HBN/EEG-ET/NDARLE412VD5/NDARLE412VD5_Video-DM_Samples_ET.mat, Despicable, 60, 3394966581, 3565518187, 170551606
/Volumes/methlab_data/HBN/EEG-ET/NDARLE412VD5/NDARLE412VD5_Video-FF_Samples_ET.mat, Fractals, 60, 2758983919, 2921971225, 162987306
/Volumes/methlab_data/HBN/EEG-ET/NDARLE412VD5/NDARLE412VD5_Video-TP_Samples_ET.mat, Present, 60, 4289673148, 4492743743, 203070595
/Volumes/methlab_data/HBN/EEG-ET/NDARLE412VD5/NDARLE412VD5_Video-WK_Samples_ET.mat, Diary, 60, 3861601496, 3979000484, 117398988
/Volumes/methlab_data/HBN/EEG-ET/NDARLE417FRX/NDARLE417FRX_Video1_Samples_ET.mat, Diary, 60, 4213518147, 4330910893, 117392746
/Volumes/methlab_data/HBN/EEG-ET/NDARLE417FRX/NDARLE417FRX_Video3_Samples_ET.mat, Despicable, 60, 3751512630, 3922055808, 170543178
/Volumes/methlab_data/HBN/EEG-ET/NDARLE417FRX/NDARLE417FRX_Video4_Samples_ET.mat, Present, 60, 4692279490, 4895342574, 203063084
/Volumes/methlab_data/HBN/EEG-ET/NDARLE417RA4/NDARLE417RA4_Video1_Samples_ET.mat, Diary, 60, 5165078397, 5282471412, 117393015
/Volumes/methlab_data/HBN/EEG-ET/NDARLE417RA4/NDARLE417RA4_Video2_Samples_ET.mat, Fractals, 60, 3896731658, 4059726920, 162995262
/Volumes/methlab_data/HBN/EEG-ET/NDARLE417RA4/NDARLE417RA4_Video3_Samples_ET.mat, Despicable, 60, 4691764750, 4862316390, 170551640
/Volumes/methlab_data/HBN/EEG-ET/NDARLE417RA4/NDARLE417RA4_Video4_Samples_ET.mat, Present, 60, 5631882417, 5834944014, 203061597
/Volumes/methlab_data/HBN/EEG-ET/NDARLE849LCR/NDARLE849LCR_Video-DM_Samples_ET.mat, Despicable, 60, 4088503270, 4259047017, 170543747
/Volumes/methlab_data/HBN/EEG-ET/NDARLE849LCR/NDARLE849LCR_Video-FF_Samples_ET.mat, Fractals, 60, 3657186883, 3820172308, 162985425
/Volumes/methlab_data/HBN/EEG-ET/NDARLE849LCR/NDARLE849LCR_Video-TP_Samples_ET.mat, Present, 60, 4562207616, 4765270397, 203062781
/Volumes/methlab_data/HBN/EEG-ET/NDARLE849LCR/NDARLE849LCR_Video-WK_Samples_ET.mat, Diary, 60, 3057887582, 3175281713, 117394131
/Volumes/methlab_data/HBN/EEG-ET/NDARLF032LXH/NDARLF032LXH_Video1_Samples_ET.mat, Diary, 60, 2199550627, 2316935657, 117385030
/Volumes/methlab_data/HBN/EEG-ET/NDARLF032LXH/NDARLF032LXH_Video2_Samples_ET.mat, Fractals, 60, 2365851238, 2528842536, 162991298
/Volumes/methlab_data/HBN/EEG-ET/NDARLF032LXH/NDARLF032LXH_Video3_Samples_ET.mat, Despicable, 60, 1981418340, 2151955972, 170537632
/Volumes/methlab_data/HBN/EEG-ET/NDARLF032LXH/NDARLF032LXH_Video4_Samples_ET.mat, Present, 60, 2602442573, 2805511219, 203068646
/Volumes/methlab_data/HBN/EEG-ET/NDARLF142AF5/NDARLF142AF5_Video1_Samples_ET.mat, Diary, 60, 12806398327, 12923795274, 117396947
/Volumes/methlab_data/HBN/EEG-ET/NDARLF142AF5/NDARLF142AF5_Video3_Samples_ET.mat, Despicable, 60, 12365795951, 12536336518, 170540567
/Volumes/methlab_data/HBN/EEG-ET/NDARLF283KJX/NDARLF283KJX_Video1_Samples_ET.mat, Diary, 60, 7527279764, 7644668647, 117388883
/Volumes/methlab_data/HBN/EEG-ET/NDARLF283KJX/NDARLF283KJX_Video3_Samples_ET.mat, Despicable, 60, 8664848840, 8835388257, 170539417
/Volumes/methlab_data/HBN/EEG-ET/NDARLF446MT5/NDARLF446MT5_Video1_Samples_ET.mat, Fractals, 120, 6494275415, 6657261468, 162986053
/Volumes/methlab_data/HBN/EEG-ET/NDARLF446MT5/NDARLF446MT5_Video2_Samples_ET.mat, Diary, 120, 7571558350, 7688955376, 117397026
/Volumes/methlab_data/HBN/EEG-ET/NDARLF446MT5/NDARLF446MT5_Video3_Samples_ET.mat, Despicable, 120, 8018361886, 8188902941, 170541055
/Volumes/methlab_data/HBN/EEG-ET/NDARLF446MT5/NDARLF446MT5_Video4_Samples_ET.mat, Present, 120, 8696162661, 8899226066, 203063405
/Volumes/methlab_data/HBN/EEG-ET/NDARLF480DMW/NDARLF480DMW_Video1_Samples_ET.mat, Diary, 60, 3380639831, 3498028710, 117388879
/Volumes/methlab_data/HBN/EEG-ET/NDARLF480DMW/NDARLF480DMW_Video3_Samples_ET.mat, Despicable, 60, 2880886039, 3051436446, 170550407
/Volumes/methlab_data/HBN/EEG-ET/NDARLF484WJL/NDARLF484WJL_Video-DM_Samples_ET.mat, Despicable, 120, 6156743103, 6327289687, 170546584
/Volumes/methlab_data/HBN/EEG-ET/NDARLF484WJL/NDARLF484WJL_Video-FF_Samples_ET.mat, Fractals, 120, 5549927369, 5712923177, 162995808
/Volumes/methlab_data/HBN/EEG-ET/NDARLF484WJL/NDARLF484WJL_Video-TP_Samples_ET.mat, Present, 120, 7230915933, 7433983064, 203067131
/Volumes/methlab_data/HBN/EEG-ET/NDARLF484WJL/NDARLF484WJL_Video-WK_Samples_ET.mat, Diary, 120, 6621200195, 6738597029, 117396834
/Volumes/methlab_data/HBN/EEG-ET/NDARLF616PBU/NDARLF616PBU_Video1_Samples_ET.mat, Diary, 120, 5309614009, 5427010076, 117396067
/Volumes/methlab_data/HBN/EEG-ET/NDARLF616PBU/NDARLF616PBU_Video2_Samples_ET.mat, Fractals, 120, 6178166089, 6341153943, 162987854
/Volumes/methlab_data/HBN/EEG-ET/NDARLF616PBU/NDARLF616PBU_Video3_Samples_ET.mat, Despicable, 120, 6777142635, 6947689656, 170547021
/Volumes/methlab_data/HBN/EEG-ET/NDARLF616PBU/NDARLF616PBU_Video4_Samples_ET.mat, Present, 120, 7523168190, 7726234842, 203066652
/Volumes/methlab_data/HBN/EEG-ET/NDARLG154ZA3/NDARLG154ZA3_Video1_Samples_ET.mat, Diary, 60, 4039619998, 4157015281, 117395283
/Volumes/methlab_data/HBN/EEG-ET/NDARLG154ZA3/NDARLG154ZA3_Video3_Samples_ET.mat, Despicable, 60, 3612564998, 3783106105, 170541107
/Volumes/methlab_data/HBN/EEG-ET/NDARLG154ZA3/NDARLG154ZA3_Video4_Samples_ET.mat, Present, 60, 4455586083, 4658649131, 203063048
/Volumes/methlab_data/HBN/EEG-ET/NDARLG564TMD/NDARLG564TMD_Video-DM_Samples_ET.mat, Despicable, 30, 4996850127, 5167395362, 170545235
/Volumes/methlab_data/HBN/EEG-ET/NDARLG564TMD/NDARLG564TMD_Video-WK_Samples_ET.mat, Diary, 30, 5329744799, 5447133569, 117388770
/Volumes/methlab_data/HBN/EEG-ET/NDARLG890JDU/NDARLG890JDU_Video1_Samples_ET.mat, Diary, 60, 3462558505, 3579949685, 117391180
/Volumes/methlab_data/HBN/EEG-ET/NDARLG890JDU/NDARLG890JDU_Video3_Samples_ET.mat, Despicable, 60, 3841602993, 4012150834, 170547841
/Volumes/methlab_data/HBN/EEG-ET/NDARLG918MG8/NDARLG918MG8_Video-DM_Samples_ET.mat, Despicable, 120, 4412586772, 4583133551, 170546779
/Volumes/methlab_data/HBN/EEG-ET/NDARLG918MG8/NDARLG918MG8_Video-FF_Samples_ET.mat, Fractals, 120, 3625101939, 3788089217, 162987278
/Volumes/methlab_data/HBN/EEG-ET/NDARLG918MG8/NDARLG918MG8_Video-TP_Samples_ET.mat, Present, 120, 5608068755, 5811136664, 203067909
/Volumes/methlab_data/HBN/EEG-ET/NDARLG918MG8/NDARLG918MG8_Video-WK_Samples_ET.mat, Diary, 120, 4964832388, 5082230893, 117398505
/Volumes/methlab_data/HBN/EEG-ET/NDARLG942AZ1/NDARLG942AZ1_Video1_Samples_ET.mat, Diary, 60, 2588616446, 2706016450, 117400004
/Volumes/methlab_data/HBN/EEG-ET/NDARLG942AZ1/NDARLG942AZ1_Video3_Samples_ET.mat, Despicable, 60, 2371989374, 2542529909, 170540535
/Volumes/methlab_data/HBN/EEG-ET/NDARLG943AAN/NDARLG943AAN_Video1_Samples_ET.mat, Diary, 120, 3268858301, 3386255505, 117397204
/Volumes/methlab_data/HBN/EEG-ET/NDARLG943AAN/NDARLG943AAN_Video2_Samples_ET.mat, Fractals, 120, 4771846064, 4934828559, 162982495
/Volumes/methlab_data/HBN/EEG-ET/NDARLG943AAN/NDARLG943AAN_Video3_Samples_ET.mat, Despicable, 120, 5217055869, 5387603283, 170547414
/Volumes/methlab_data/HBN/EEG-ET/NDARLG943AAN/NDARLG943AAN_Video4_Samples_ET.mat, Present, 120, 6737616394, 6940683649, 203067255
/Volumes/methlab_data/HBN/EEG-ET/NDARLG987WB0/NDARLG987WB0_Video-DM_Samples_ET.mat, Despicable, 120, 3648804328, 3819351476, 170547148
/Volumes/methlab_data/HBN/EEG-ET/NDARLG987WB0/NDARLG987WB0_Video-FF_Samples_ET.mat, Fractals, 120, 4082741599, 4245729878, 162988279
/Volumes/methlab_data/HBN/EEG-ET/NDARLG987WB0/NDARLG987WB0_Video-TP_Samples_ET.mat, Present, 120, 4733854541, 4936919101, 203064560
/Volumes/methlab_data/HBN/EEG-ET/NDARLG987WB0/NDARLG987WB0_Video-WK_Samples_ET.mat, Diary, 120, 3052428507, 3169824920, 117396413
/Volumes/methlab_data/HBN/EEG-ET/NDARLH043YDK/NDARLH043YDK_Video-DM_Samples_ET.mat, Despicable, 60, 4094721087, 4265272627, 170551540
/Volumes/methlab_data/HBN/EEG-ET/NDARLH043YDK/NDARLH043YDK_Video-FF_Samples_ET.mat, Fractals, 60, 3525985897, 3688975058, 162989161
/Volumes/methlab_data/HBN/EEG-ET/NDARLH043YDK/NDARLH043YDK_Video-TP_Samples_ET.mat, Present, 60, 4617520555, 4820587240, 203066685
/Volumes/methlab_data/HBN/EEG-ET/NDARLH043YDK/NDARLH043YDK_Video-WK_Samples_ET.mat, Diary, 60, 3012411020, 3129800693, 117389673
/Volumes/methlab_data/HBN/EEG-ET/NDARLH263KCL/NDARLH263KCL_Video-DM_Samples_ET.mat, Despicable, 120, 4800680021, 4971227733, 170547712
/Volumes/methlab_data/HBN/EEG-ET/NDARLH263KCL/NDARLH263KCL_Video-FF_Samples_ET.mat, Fractals, 120, 5315176961, 5478173818, 162996857
/Volumes/methlab_data/HBN/EEG-ET/NDARLH263KCL/NDARLH263KCL_Video-TP_Samples_ET.mat, Present, 120, 5989752258, 6192820070, 203067812
/Volumes/methlab_data/HBN/EEG-ET/NDARLH263KCL/NDARLH263KCL_Video-WK_Samples_ET.mat, Diary, 120, 3646008022, 3763404278, 117396256
/Volumes/methlab_data/HBN/EEG-ET/NDARLH423CR7/NDARLH423CR7_Video-DM_Samples_ET.mat, Despicable, 60, 4120726325, 4291269793, 170543468
/Volumes/methlab_data/HBN/EEG-ET/NDARLH423CR7/NDARLH423CR7_Video-FF_Samples_ET.mat, Fractals, 60, 3655321616, 3818314747, 162993131
/Volumes/methlab_data/HBN/EEG-ET/NDARLH423CR7/NDARLH423CR7_Video-TP_Samples_ET.mat, Present, 60, 4381854793, 4584926204, 203071411
/Volumes/methlab_data/HBN/EEG-ET/NDARLH423CR7/NDARLH423CR7_Video-WK_Samples_ET.mat, Diary, 60, 3007646158, 3125039093, 117392935
/Volumes/methlab_data/HBN/EEG-ET/NDARLH881FBD/NDARLH881FBD_Video1_Samples_ET.mat, Diary, 120, 6065656079, 6183052562, 117396483
/Volumes/methlab_data/HBN/EEG-ET/NDARLH881FBD/NDARLH881FBD_Video2_Samples_ET.mat, Fractals, 120, 7176944551, 7339929225, 162984674
/Volumes/methlab_data/HBN/EEG-ET/NDARLH881FBD/NDARLH881FBD_Video3_Samples_ET.mat, Despicable, 120, 7767166387, 7937713136, 170546749
/Volumes/methlab_data/HBN/EEG-ET/NDARLH881FBD/NDARLH881FBD_Video4_Samples_ET.mat, Present, 120, 8544091536, 8747158677, 203067141
/Volumes/methlab_data/HBN/EEG-ET/NDARLH979WFX/NDARLH979WFX_Video1_Samples_ET.mat, Despicable, 120, 2822166811, 2992713191, 170546380
/Volumes/methlab_data/HBN/EEG-ET/NDARLH979WFX/NDARLH979WFX_Video2_Samples_ET.mat, Diary, 120, 6377472068, 6494878600, 117406532
/Volumes/methlab_data/HBN/EEG-ET/NDARLH979WFX/NDARLH979WFX_Video3_Samples_ET.mat, Fractals, 120, 6806659322, 6969645713, 162986391
/Volumes/methlab_data/HBN/EEG-ET/NDARLH979WFX/NDARLH979WFX_Video4_Samples_ET.mat, Present, 120, 7474094583, 7677161766, 203067183
/Volumes/methlab_data/HBN/EEG-ET/NDARLJ148JH2/NDARLJ148JH2_Video1_Samples_ET.mat, Diary, 30, 3769501909, 3886897295, 117395386
/Volumes/methlab_data/HBN/EEG-ET/NDARLJ148JH2/NDARLJ148JH2_Video3_Samples_ET.mat, Despicable, 30, 3333241158, 3503788272, 170547114
/Volumes/methlab_data/HBN/EEG-ET/NDARLJ148JH2/NDARLJ148JH2_Video4_Samples_ET.mat, Present, 30, 4182709307, 4385780500, 203071193
/Volumes/methlab_data/HBN/EEG-ET/NDARLJ280UCN/NDARLJ280UCN_Video-DM_Samples_ET.mat, Despicable, 60, 4310558072, 4481098481, 170540409
/Volumes/methlab_data/HBN/EEG-ET/NDARLJ280UCN/NDARLJ280UCN_Video-FF_Samples_ET.mat, Fractals, 60, 4779647261, 4942631293, 162984032
/Volumes/methlab_data/HBN/EEG-ET/NDARLJ280UCN/NDARLJ280UCN_Video-TP_Samples_ET.mat, Present, 60, 5251618418, 5454683784, 203065366
/Volumes/methlab_data/HBN/EEG-ET/NDARLJ280UCN/NDARLJ280UCN_Video-WK_Samples_ET.mat, Diary, 60, 3412907388, 3530299385, 117391997
/Volumes/methlab_data/HBN/EEG-ET/NDARLJ311YNA/NDARLJ311YNA_Video1_Samples_ET.mat, Diary, 60, 5206086611, 5323480621, 117394010
/Volumes/methlab_data/HBN/EEG-ET/NDARLJ311YNA/NDARLJ311YNA_Video3_Samples_ET.mat, Despicable, 60, 4962644497, 5133188090, 170543593
/Volumes/methlab_data/HBN/EEG-ET/NDARLJ334YD0/NDARLJ334YD0_Video1_Samples_ET.mat, Diary, 60, 3661977326, 3779372302, 117394976
/Volumes/methlab_data/HBN/EEG-ET/NDARLJ334YD0/NDARLJ334YD0_Video3_Samples_ET.mat, Despicable, 60, 3215004479, 3385549031, 170544552
/Volumes/methlab_data/HBN/EEG-ET/NDARLJ334YD0/NDARLJ334YD0_Video4_Samples_ET.mat, Present, 60, 4126186358, 4329252866, 203066508
/Volumes/methlab_data/HBN/EEG-ET/NDARLJ355VAG/NDARLJ355VAG_Video-DM_Samples_ET.mat, Despicable, 60, 4831927866, 5002465329, 170537463
/Volumes/methlab_data/HBN/EEG-ET/NDARLJ355VAG/NDARLJ355VAG_Video-FF_Samples_ET.mat, Fractals, 60, 3984551377, 4147541540, 162990163
/Volumes/methlab_data/HBN/EEG-ET/NDARLJ355VAG/NDARLJ355VAG_Video-TP_Samples_ET.mat, Present, 60, 5794573776, 5997641251, 203067475
/Volumes/methlab_data/HBN/EEG-ET/NDARLJ355VAG/NDARLJ355VAG_Video-WK_Samples_ET.mat, Diary, 60, 5345131339, 5462518265, 117386926
/Volumes/methlab_data/HBN/EEG-ET/NDARLJ356HAQ/NDARLJ356HAQ_Video1_Samples_ET.mat, Diary, 60, 1052854961, 1170261262, 117406301
/Volumes/methlab_data/HBN/EEG-ET/NDARLJ356HAQ/NDARLJ356HAQ_Video3_Samples_ET.mat, Despicable, 60, 332467044, 503013652, 170546608
/Volumes/methlab_data/HBN/EEG-ET/NDARLJ472DLM/NDARLJ472DLM_Video-DM_Samples_ET.mat, Despicable, 60, 5268332850, 5438876461, 170543611
/Volumes/methlab_data/HBN/EEG-ET/NDARLJ472DLM/NDARLJ472DLM_Video-FF_Samples_ET.mat, Fractals, 60, 4813172897, 4976160193, 162987296
/Volumes/methlab_data/HBN/EEG-ET/NDARLJ472DLM/NDARLJ472DLM_Video-TP_Samples_ET.mat, Present, 60, 5782986821, 5986058471, 203071650
/Volumes/methlab_data/HBN/EEG-ET/NDARLJ472DLM/NDARLJ472DLM_Video-WK_Samples_ET.mat, Diary, 60, 4215410123, 4332804184, 117394061
/Volumes/methlab_data/HBN/EEG-ET/NDARLJ549WTT/NDARLJ549WTT_Video1_Samples_ET.mat, Fractals, 120, 4751619569, 4914606104, 162986535
/Volumes/methlab_data/HBN/EEG-ET/NDARLJ549WTT/NDARLJ549WTT_Video2_Samples_ET.mat, Diary, 120, 7762779612, 7880176522, 117396910
/Volumes/methlab_data/HBN/EEG-ET/NDARLJ549WTT/NDARLJ549WTT_Video3_Samples_ET.mat, Despicable, 120, 8424454475, 8595012512, 170558037
/Volumes/methlab_data/HBN/EEG-ET/NDARLJ654TZ0/NDARLJ654TZ0_Video1_Samples_ET.mat, Diary, 60, 3982088154, 4099476489, 117388335
/Volumes/methlab_data/HBN/EEG-ET/NDARLJ654TZ0/NDARLJ654TZ0_Video3_Samples_ET.mat, Despicable, 60, 3395843113, 3566393181, 170550068
/Volumes/methlab_data/HBN/EEG-ET/NDARLJ886BFK/NDARLJ886BFK_Video1_Samples_ET.mat, Diary, 60, 3265342994, 3382739965, 117396971
/Volumes/methlab_data/HBN/EEG-ET/NDARLJ886BFK/NDARLJ886BFK_Video3_Samples_ET.mat, Despicable, 60, 3653009912, 3823551456, 170541544
/Volumes/methlab_data/HBN/EEG-ET/NDARLJ970DEY/NDARLJ970DEY_Video-DM_Samples_ET.mat, Despicable, 60, 4032903123, 4203445530, 170542407
/Volumes/methlab_data/HBN/EEG-ET/NDARLJ970DEY/NDARLJ970DEY_Video-FF_Samples_ET.mat, Fractals, 60, 3612290195, 3775281279, 162991084
/Volumes/methlab_data/HBN/EEG-ET/NDARLJ970DEY/NDARLJ970DEY_Video-TP_Samples_ET.mat, Present, 60, 4505499742, 4708560108, 203060366
/Volumes/methlab_data/HBN/EEG-ET/NDARLJ970DEY/NDARLJ970DEY_Video-WK_Samples_ET.mat, Diary, 60, 3040957878, 3158352789, 117394911
/Volumes/methlab_data/HBN/EEG-ET/NDARLK551KXD/NDARLK551KXD_Video1_Samples_ET.mat, Fractals, 120, 8057500281, 8220485886, 162985605
/Volumes/methlab_data/HBN/EEG-ET/NDARLK551KXD/NDARLK551KXD_Video2_Samples_ET.mat, Despicable, 120, 8967724867, 9138270978, 170546111
/Volumes/methlab_data/HBN/EEG-ET/NDARLK551KXD/NDARLK551KXD_Video3_Samples_ET.mat, Diary, 120, 9442520862, 9559918610, 117397748
/Volumes/methlab_data/HBN/EEG-ET/NDARLK551KXD/NDARLK551KXD_Video4_Samples_ET.mat, Present, 120, 10069942138, 10273006890, 203064752
/Volumes/methlab_data/HBN/EEG-ET/NDARLK690ZK9/NDARLK690ZK9_Video-DM_Samples_ET.mat, Despicable, 30, 4024171978, 4194711774, 170539796
/Volumes/methlab_data/HBN/EEG-ET/NDARLK963HXP/NDARLK963HXP_Video1_Samples_ET.mat, Diary, 60, 4360652919, 4478046951, 117394032
/Volumes/methlab_data/HBN/EEG-ET/NDARLK963HXP/NDARLK963HXP_Video3_Samples_ET.mat, Despicable, 60, 3915184863, 4085719482, 170534619
/Volumes/methlab_data/HBN/EEG-ET/NDARLL181EGQ/NDARLL181EGQ_Video-DM_Samples_ET.mat, Despicable, 60, 4618952046, 4789498477, 170546431
/Volumes/methlab_data/HBN/EEG-ET/NDARLL181EGQ/NDARLL181EGQ_Video-FF_Samples_ET.mat, Fractals, 60, 4114209524, 4277198627, 162989103
/Volumes/methlab_data/HBN/EEG-ET/NDARLL181EGQ/NDARLL181EGQ_Video-TP_Samples_ET.mat, Present, 60, 5110985504, 5314055947, 203070443
/Volumes/methlab_data/HBN/EEG-ET/NDARLL181EGQ/NDARLL181EGQ_Video-WK_Samples_ET.mat, Diary, 60, 3476624178, 3594016116, 117391938
/Volumes/methlab_data/HBN/EEG-ET/NDARLL572UP2/NDARLL572UP2_Video-DM_Samples_ET.mat, Despicable, 60, 2900577778, 3071124259, 170546481
/Volumes/methlab_data/HBN/EEG-ET/NDARLL572UP2/NDARLL572UP2_Video-FF_Samples_ET.mat, Fractals, 60, 2469995646, 2632987826, 162992180
/Volumes/methlab_data/HBN/EEG-ET/NDARLL572UP2/NDARLL572UP2_Video-TP_Samples_ET.mat, Present, 60, 3447451045, 3650520470, 203069425
/Volumes/methlab_data/HBN/EEG-ET/NDARLL572UP2/NDARLL572UP2_Video-WK_Samples_ET.mat, Diary, 60, 1693126960, 1810590980, 117464020
/Volumes/methlab_data/HBN/EEG-ET/NDARLL720BGU/NDARLL720BGU_Video1_Samples_ET.mat, Diary, 60, 5458557480, 5575952456, 117394976
/Volumes/methlab_data/HBN/EEG-ET/NDARLL720BGU/NDARLL720BGU_Video3_Samples_ET.mat, Despicable, 60, 4992224958, 5162769490, 170544532
/Volumes/methlab_data/HBN/EEG-ET/NDARLL790WLF/NDARLL790WLF_Video1_Samples_ET.mat, Despicable, 120, 2986420744, 3156968322, 170547578
/Volumes/methlab_data/HBN/EEG-ET/NDARLL790WLF/NDARLL790WLF_Video2_Samples_ET.mat, Fractals, 120, 3309918516, 3472905820, 162987304
/Volumes/methlab_data/HBN/EEG-ET/NDARLL790WLF/NDARLL790WLF_Video3_Samples_ET.mat, Diary, 120, 3669987318, 3787385154, 117397836
/Volumes/methlab_data/HBN/EEG-ET/NDARLL790WLF/NDARLL790WLF_Video4_Samples_ET.mat, Present, 120, 3918836219, 4121912635, 203076416
/Volumes/methlab_data/HBN/EEG-ET/NDARLL894HC3/NDARLL894HC3_Video-DM_Samples_ET.mat, Despicable, 60, 4020767542, 4191303842, 170536300
/Volumes/methlab_data/HBN/EEG-ET/NDARLL894HC3/NDARLL894HC3_Video-FF_Samples_ET.mat, Fractals, 60, 3402051944, 3565041970, 162990026
/Volumes/methlab_data/HBN/EEG-ET/NDARLL894HC3/NDARLL894HC3_Video-TP_Samples_ET.mat, Present, 60, 4892368464, 5095437772, 203069308
/Volumes/methlab_data/HBN/EEG-ET/NDARLL894HC3/NDARLL894HC3_Video-WK_Samples_ET.mat, Diary, 60, 4464155359, 4581546183, 117390824
/Volumes/methlab_data/HBN/EEG-ET/NDARLL914UW4/NDARLL914UW4_Video1_Samples_ET.mat, Diary, 60, 5783961581, 5901353749, 117392168
/Volumes/methlab_data/HBN/EEG-ET/NDARLL914UW4/NDARLL914UW4_Video3_Samples_ET.mat, Despicable, 60, 5352522985, 5523066798, 170543813
/Volumes/methlab_data/HBN/EEG-ET/NDARLL968KK1/NDARLL968KK1_Video-DM_Samples_ET.mat, Despicable, 60, 3468835757, 3639371334, 170535577
/Volumes/methlab_data/HBN/EEG-ET/NDARLL968KK1/NDARLL968KK1_Video-TP_Samples_ET.mat, Present, 60, 3964711201, 4167988845, 203277644
/Volumes/methlab_data/HBN/EEG-ET/NDARLL968KK1/NDARLL968KK1_Video-WK_Samples_ET.mat, Diary, 60, 2309914823, 2427302809, 117387986
/Volumes/methlab_data/HBN/EEG-ET/NDARLM196YRG/NDARLM196YRG_Video1_Samples_ET.mat, Fractals, 120, 5364500848, 5527486999, 162986151
/Volumes/methlab_data/HBN/EEG-ET/NDARLM196YRG/NDARLM196YRG_Video2_Samples_ET.mat, Despicable, 120, 6150034565, 6320576678, 170542113
/Volumes/methlab_data/HBN/EEG-ET/NDARLM196YRG/NDARLM196YRG_Video3_Samples_ET.mat, Diary, 120, 6725307072, 6842696896, 117389824
/Volumes/methlab_data/HBN/EEG-ET/NDARLM196YRG/NDARLM196YRG_Video4_Samples_ET.mat, Present, 120, 7421687577, 7624755094, 203067517
/Volumes/methlab_data/HBN/EEG-ET/NDARLM313FVX/NDARLM313FVX_Video1_Samples_ET.mat, Diary, 60, 3254822701, 3372224688, 117401987
/Volumes/methlab_data/HBN/EEG-ET/NDARLM313FVX/NDARLM313FVX_Video2_Samples_ET.mat, Fractals, 60, 2072875487, 2235863677, 162988190
/Volumes/methlab_data/HBN/EEG-ET/NDARLM313FVX/NDARLM313FVX_Video3_Samples_ET.mat, Despicable, 60, 2789208662, 2959760231, 170551569
/Volumes/methlab_data/HBN/EEG-ET/NDARLM313FVX/NDARLM313FVX_Video4_Samples_ET.mat, Present, 60, 3750905262, 3953977780, 203072518
/Volumes/methlab_data/HBN/EEG-ET/NDARLM877UZM/NDARLM877UZM_Video-DM_Samples_ET.mat, Despicable, 60, 4726423931, 4896964248, 170540317
/Volumes/methlab_data/HBN/EEG-ET/NDARLM877UZM/NDARLM877UZM_Video-FF_Samples_ET.mat, Fractals, 60, 5193885600, 5356877564, 162991964
/Volumes/methlab_data/HBN/EEG-ET/NDARLM877UZM/NDARLM877UZM_Video-TP_Samples_ET.mat, Present, 60, 5764304878, 5967365124, 203060246
/Volumes/methlab_data/HBN/EEG-ET/NDARLM877UZM/NDARLM877UZM_Video-WK_Samples_ET.mat, Diary, 60, 3974607768, 4092001602, 117393834
/Volumes/methlab_data/HBN/EEG-ET/NDARLN070VX7/NDARLN070VX7_Video1_Samples_ET.mat, Diary, 60, 5452684784, 5570078737, 117393953
/Volumes/methlab_data/HBN/EEG-ET/NDARLN070VX7/NDARLN070VX7_Video3_Samples_ET.mat, Despicable, 60, 4922258172, 5092801627, 170543455
/Volumes/methlab_data/HBN/EEG-ET/NDARLN550RM6/NDARLN550RM6_Video-DM_Samples_ET.mat, Despicable, 120, 4809522953, 4980070510, 170547557
/Volumes/methlab_data/HBN/EEG-ET/NDARLN550RM6/NDARLN550RM6_Video-FF_Samples_ET.mat, Fractals, 120, 4418245047, 4581232892, 162987845
/Volumes/methlab_data/HBN/EEG-ET/NDARLN550RM6/NDARLN550RM6_Video-TP_Samples_ET.mat, Present, 120, 5406190625, 5609255903, 203065278
/Volumes/methlab_data/HBN/EEG-ET/NDARLN550RM6/NDARLN550RM6_Video-WK_Samples_ET.mat, Diary, 120, 3719780445, 3837177364, 117396919
/Volumes/methlab_data/HBN/EEG-ET/NDARLN749FML/NDARLN749FML_Video-DM_Samples_ET.mat, Despicable, 60, 3816935415, 3987472402, 170536987
/Volumes/methlab_data/HBN/EEG-ET/NDARLN749FML/NDARLN749FML_Video-TP_Samples_ET.mat, Present, 60, 4284201898, 4487481067, 203279169
/Volumes/methlab_data/HBN/EEG-ET/NDARLN749FML/NDARLN749FML_Video-WK_Samples_ET.mat, Diary, 60, 2685301746, 2802693026, 117391280
/Volumes/methlab_data/HBN/EEG-ET/NDARLN961XGP/NDARLN961XGP_Video1_Samples_ET.mat, Diary, 60, 2906350890, 3023743905, 117393015
/Volumes/methlab_data/HBN/EEG-ET/NDARLN961XGP/NDARLN961XGP_Video3_Samples_ET.mat, Despicable, 60, 2488332512, 2658881063, 170548551
/Volumes/methlab_data/HBN/EEG-ET/NDARLN961XGP/NDARLN961XGP_Video4_Samples_ET.mat, Present, 60, 3068464463, 3271525980, 203061517
/Volumes/methlab_data/HBN/EEG-ET/NDARLP246NT6/NDARLP246NT6_Video1_Samples_ET.mat, Fractals, 120, 3538002737, 3700988639, 162985902
/Volumes/methlab_data/HBN/EEG-ET/NDARLP246NT6/NDARLP246NT6_Video2_Samples_ET.mat, Despicable, 120, 4384006814, 4554553398, 170546584
/Volumes/methlab_data/HBN/EEG-ET/NDARLP246NT6/NDARLP246NT6_Video3_Samples_ET.mat, Diary, 120, 4911194768, 5028591754, 117396986
/Volumes/methlab_data/HBN/EEG-ET/NDARLP246NT6/NDARLP246NT6_Video4_Samples_ET.mat, Present, 120, 5529509825, 5732578305, 203068480
/Volumes/methlab_data/HBN/EEG-ET/NDARLP417RC6/NDARLP417RC6_Video-DM_Samples_ET.mat, Despicable, 60, 5380415339, 5550957928, 170542589
/Volumes/methlab_data/HBN/EEG-ET/NDARLP417RC6/NDARLP417RC6_Video-FF_Samples_ET.mat, Fractals, 60, 5849448948, 6012434207, 162985259
/Volumes/methlab_data/HBN/EEG-ET/NDARLP417RC6/NDARLP417RC6_Video-TP_Samples_ET.mat, Present, 60, 6333644276, 6536712858, 203068582
/Volumes/methlab_data/HBN/EEG-ET/NDARLP417RC6/NDARLP417RC6_Video-WK_Samples_ET.mat, Diary, 60, 4535973318, 4653370342, 117397024
/Volumes/methlab_data/HBN/EEG-ET/NDARLP624GFH/NDARLP624GFH_Video1_Samples_ET.mat, Diary, 60, 821223916, 938619644, 117395728
/Volumes/methlab_data/HBN/EEG-ET/NDARLP624GFH/NDARLP624GFH_Video3_Samples_ET.mat, Despicable, 60, 372418473, 542969628, 170551155
/Volumes/methlab_data/HBN/EEG-ET/NDARLR030EW6/NDARLR030EW6_Video1_Samples_ET.mat, Diary, 60, 8991833443, 9109228770, 117395327
/Volumes/methlab_data/HBN/EEG-ET/NDARLR030EW6/NDARLR030EW6_Video3_Samples_ET.mat, Despicable, 60, 8554506112, 8725053145, 170547033
/Volumes/methlab_data/HBN/EEG-ET/NDARLR039GJL/NDARLR039GJL_Video-DM_Samples_ET.mat, Despicable, 60, 3377422959, 3547967467, 170544508
/Volumes/methlab_data/HBN/EEG-ET/NDARLR039GJL/NDARLR039GJL_Video-FF_Samples_ET.mat, Fractals, 60, 2266831136, 2429822325, 162991189
/Volumes/methlab_data/HBN/EEG-ET/NDARLR039GJL/NDARLR039GJL_Video-TP_Samples_ET.mat, Present, 60, 3999533533, 4202609063, 203075530
/Volumes/methlab_data/HBN/EEG-ET/NDARLR039GJL/NDARLR039GJL_Video-WK_Samples_ET.mat, Diary, 60, 2950336124, 3067738157, 117402033
/Volumes/methlab_data/HBN/EEG-ET/NDARLR083PKF/NDARLR083PKF_Video-DM_Samples_ET.mat, Despicable, 60, 3925814898, 4096365283, 170550385
/Volumes/methlab_data/HBN/EEG-ET/NDARLR083PKF/NDARLR083PKF_Video-FF_Samples_ET.mat, Fractals, 60, 3498426355, 3661410364, 162984009
/Volumes/methlab_data/HBN/EEG-ET/NDARLR083PKF/NDARLR083PKF_Video-TP_Samples_ET.mat, Present, 60, 4405294222, 4608367525, 203073303
/Volumes/methlab_data/HBN/EEG-ET/NDARLR083PKF/NDARLR083PKF_Video-WK_Samples_ET.mat, Diary, 60, 3062642880, 3180035712, 117392832
/Volumes/methlab_data/HBN/EEG-ET/NDARLR586MPX/NDARLR586MPX_Video-DM_Samples_ET.mat, Despicable, 60, 5896852274, 6067399822, 170547548
/Volumes/methlab_data/HBN/EEG-ET/NDARLR586MPX/NDARLR586MPX_Video-FF_Samples_ET.mat, Fractals, 60, 4200533610, 4363517776, 162984166
/Volumes/methlab_data/HBN/EEG-ET/NDARLR586MPX/NDARLR586MPX_Video-TP_Samples_ET.mat, Present, 60, 6134904488, 6337964007, 203059519
/Volumes/methlab_data/HBN/EEG-ET/NDARLR586MPX/NDARLR586MPX_Video-WK_Samples_ET.mat, Diary, 60, 5731261274, 5848654240, 117392966
/Volumes/methlab_data/HBN/EEG-ET/NDARLR620FW6/NDARLR620FW6_Video1_Samples_ET.mat, Diary, 60, 2497136677, 2614526619, 117389942
/Volumes/methlab_data/HBN/EEG-ET/NDARLR620FW6/NDARLR620FW6_Video3_Samples_ET.mat, Despicable, 60, 3789697619, 3960244098, 170546479
/Volumes/methlab_data/HBN/EEG-ET/NDARLR765LA3/NDARLR765LA3_Video-DM_Samples_ET.mat, Despicable, 60, 5039478934, 5210022405, 170543471
/Volumes/methlab_data/HBN/EEG-ET/NDARLR765LA3/NDARLR765LA3_Video-FF_Samples_ET.mat, Fractals, 60, 4585295151, 4748287277, 162992126
/Volumes/methlab_data/HBN/EEG-ET/NDARLR765LA3/NDARLR765LA3_Video-WK_Samples_ET.mat, Diary, 60, 3592866952, 3710261144, 117394192
/Volumes/methlab_data/HBN/EEG-ET/NDARLR924YAV/NDARLR924YAV_Video-DM_Samples_ET.mat, Despicable, 60, 4359464385, 4530013744, 170549359
/Volumes/methlab_data/HBN/EEG-ET/NDARLR924YAV/NDARLR924YAV_Video-TP_Samples_ET.mat, Present, 60, 4912840848, 5116105297, 203264449
/Volumes/methlab_data/HBN/EEG-ET/NDARLR924YAV/NDARLR924YAV_Video-WK_Samples_ET.mat, Diary, 60, 3124159804, 3241548666, 117388862
/Volumes/methlab_data/HBN/EEG-ET/NDARLT216FTN/NDARLT216FTN_Video-DM_Samples_ET.mat, Despicable, 60, 6127071783, 6297620383, 170548600
/Volumes/methlab_data/HBN/EEG-ET/NDARLT216FTN/NDARLT216FTN_Video-FF_Samples_ET.mat, Fractals, 60, 5678099665, 5841087824, 162988159
/Volumes/methlab_data/HBN/EEG-ET/NDARLT216FTN/NDARLT216FTN_Video-TP_Samples_ET.mat, Present, 60, 6647454309, 6850521755, 203067446
/Volumes/methlab_data/HBN/EEG-ET/NDARLT216FTN/NDARLT216FTN_Video-WK_Samples_ET.mat, Diary, 60, 4952703325, 5070093259, 117389934
/Volumes/methlab_data/HBN/EEG-ET/NDARLT365LHK/NDARLT365LHK_Video-DM_Samples_ET.mat, Despicable, 120, 4079624234, 4250170406, 170546172
/Volumes/methlab_data/HBN/EEG-ET/NDARLT365LHK/NDARLT365LHK_Video-FF_Samples_ET.mat, Fractals, 120, 3788821661, 3951810027, 162988366
/Volumes/methlab_data/HBN/EEG-ET/NDARLT365LHK/NDARLT365LHK_Video-TP_Samples_ET.mat, Present, 120, 4289292566, 4492359607, 203067041
/Volumes/methlab_data/HBN/EEG-ET/NDARLT365LHK/NDARLT365LHK_Video-WK_Samples_ET.mat, Diary, 120, 3323062713, 3440449223, 117386510
/Volumes/methlab_data/HBN/EEG-ET/NDARLU111UYF/NDARLU111UYF_Video1_Samples_ET.mat, Diary, 60, 81669154953, 81786547943, 117392990
/Volumes/methlab_data/HBN/EEG-ET/NDARLU111UYF/NDARLU111UYF_Video2_Samples_ET.mat, Fractals, 60, 80669288022, 80832271267, 162983245
/Volumes/methlab_data/HBN/EEG-ET/NDARLU111UYF/NDARLU111UYF_Video3_Samples_ET.mat, Despicable, 60, 81209768156, 81380311726, 170543570
/Volumes/methlab_data/HBN/EEG-ET/NDARLU111UYF/NDARLU111UYF_Video4_Samples_ET.mat, Present, 60, 81824378676, 82027449258, 203070582
/Volumes/methlab_data/HBN/EEG-ET/NDARLU529MP7/NDARLU529MP7_Video-DM_Samples_ET.mat, Despicable, 60, 2827428743, 2997965163, 170536420
/Volumes/methlab_data/HBN/EEG-ET/NDARLU529MP7/NDARLU529MP7_Video-TP_Samples_ET.mat, Present, 60, 3793181490, 3996458002, 203276512
/Volumes/methlab_data/HBN/EEG-ET/NDARLU529MP7/NDARLU529MP7_Video-WK_Samples_ET.mat, Diary, 60, 2220655423, 2338044283, 117388860
/Volumes/methlab_data/HBN/EEG-ET/NDARLU939YX4/NDARLU939YX4_Video1_Samples_ET.mat, Diary, 120, 5654768832, 5772165945, 117397113
/Volumes/methlab_data/HBN/EEG-ET/NDARLU939YX4/NDARLU939YX4_Video2_Samples_ET.mat, Fractals, 120, 6337559754, 6500552620, 162992866
/Volumes/methlab_data/HBN/EEG-ET/NDARLU939YX4/NDARLU939YX4_Video3_Samples_ET.mat, Despicable, 120, 6824399160, 6994949990, 170550830
/Volumes/methlab_data/HBN/EEG-ET/NDARLU939YX4/NDARLU939YX4_Video4_Samples_ET.mat, Present, 120, 7382141636, 7585212086, 203070450
/Volumes/methlab_data/HBN/EEG-ET/NDARLV086DEH/NDARLV086DEH_Video1_Samples_ET.mat, Diary, 120, 3846460753, 3963848793, 117388040
/Volumes/methlab_data/HBN/EEG-ET/NDARLV086DEH/NDARLV086DEH_Video2_Samples_ET.mat, Fractals, 120, 5783437943, 5946426226, 162988283
/Volumes/methlab_data/HBN/EEG-ET/NDARLV086DEH/NDARLV086DEH_Video3_Samples_ET.mat, Despicable, 120, 6266766669, 6437313259, 170546590
/Volumes/methlab_data/HBN/EEG-ET/NDARLV252DY2/NDARLV252DY2_Video-DM_Samples_ET.mat, Despicable, 60, 3337604285, 3508160012, 170555727
/Volumes/methlab_data/HBN/EEG-ET/NDARLV252DY2/NDARLV252DY2_Video-FF_Samples_ET.mat, Fractals, 60, 2648768849, 2811751195, 162982346
/Volumes/methlab_data/HBN/EEG-ET/NDARLV252DY2/NDARLV252DY2_Video-TP_Samples_ET.mat, Present, 60, 4515088539, 4718160219, 203071680
/Volumes/methlab_data/HBN/EEG-ET/NDARLV252DY2/NDARLV252DY2_Video-WK_Samples_ET.mat, Diary, 60, 3919669176, 4037060307, 117391131
/Volumes/methlab_data/HBN/EEG-ET/NDARLV387GP4/NDARLV387GP4_Video1_Samples_ET.mat, Diary, 60, 1570184544, 1687575506, 117390962
/Volumes/methlab_data/HBN/EEG-ET/NDARLV387GP4/NDARLV387GP4_Video3_Samples_ET.mat, Despicable, 60, 1356934842, 1527480394, 170545552
/Volumes/methlab_data/HBN/EEG-ET/NDARLV812JXX/NDARLV812JXX_Video-DM_Samples_ET.mat, Despicable, 120, 5177259430, 5347808815, 170549385
/Volumes/methlab_data/HBN/EEG-ET/NDARLV812JXX/NDARLV812JXX_Video-FF_Samples_ET.mat, Fractals, 120, 4774954660, 4937938120, 162983460
/Volumes/methlab_data/HBN/EEG-ET/NDARLV812JXX/NDARLV812JXX_Video-TP_Samples_ET.mat, Present, 120, 5762058313, 5965121421, 203063108
/Volumes/methlab_data/HBN/EEG-ET/NDARLV812JXX/NDARLV812JXX_Video-WK_Samples_ET.mat, Diary, 120, 4142834818, 4260235635, 117400817
/Volumes/methlab_data/HBN/EEG-ET/NDARLW308UR0/NDARLW308UR0_Video1_Samples_ET.mat, Diary, 60, 4887612273, 5005012431, 117400158
/Volumes/methlab_data/HBN/EEG-ET/NDARLW308UR0/NDARLW308UR0_Video3_Samples_ET.mat, Despicable, 60, 5266121244, 5436665056, 170543812
/Volumes/methlab_data/HBN/EEG-ET/NDARLW774VY1/NDARLW774VY1_Video1_Samples_ET.mat, Diary, 60, 2875503822, 2992895790, 117391968
/Volumes/methlab_data/HBN/EEG-ET/NDARLW774VY1/NDARLW774VY1_Video2_Samples_ET.mat, Fractals, 60, 2670098678, 2833081860, 162983182
/Volumes/methlab_data/HBN/EEG-ET/NDARLW774VY1/NDARLW774VY1_Video3_Samples_ET.mat, Despicable, 60, 2446644750, 2617188315, 170543565
/Volumes/methlab_data/HBN/EEG-ET/NDARLW774VY1/NDARLW774VY1_Video4_Samples_ET.mat, Present, 60, 3083348684, 3286414197, 203065513
/Volumes/methlab_data/HBN/EEG-ET/NDARLX816JUZ/NDARLX816JUZ_Video1_Samples_ET.mat, Diary, 60, 4241137765, 4358532997, 117395232
/Volumes/methlab_data/HBN/EEG-ET/NDARLX816JUZ/NDARLX816JUZ_Video3_Samples_ET.mat, Despicable, 60, 3818452255, 3988998104, 170545849
/Volumes/methlab_data/HBN/EEG-ET/NDARLX836EHJ/NDARLX836EHJ_Video1_Samples_ET.mat, Diary, 60, 4452271445, 4569668489, 117397044
/Volumes/methlab_data/HBN/EEG-ET/NDARLX836EHJ/NDARLX836EHJ_Video3_Samples_ET.mat, Despicable, 60, 4042844981, 4213387574, 170542593
/Volumes/methlab_data/HBN/EEG-ET/NDARLY030ZBG/NDARLY030ZBG_Video-DM_Samples_ET.mat, Despicable, 60, 8604704690, 8775248615, 170543925
/Volumes/methlab_data/HBN/EEG-ET/NDARLY030ZBG/NDARLY030ZBG_Video-FF_Samples_ET.mat, Fractals, 60, 9071441631, 9234433355, 162991724
/Volumes/methlab_data/HBN/EEG-ET/NDARLY030ZBG/NDARLY030ZBG_Video-TP_Samples_ET.mat, Present, 60, 9617292659, 9820355660, 203063001
/Volumes/methlab_data/HBN/EEG-ET/NDARLY030ZBG/NDARLY030ZBG_Video-WK_Samples_ET.mat, Diary, 60, 8043513789, 8160906097, 117392308
/Volumes/methlab_data/HBN/EEG-ET/NDARLY125HMB/NDARLY125HMB_Video1_Samples_ET.mat, Fractals, 120, 3749658566, 3912644811, 162986245
/Volumes/methlab_data/HBN/EEG-ET/NDARLY125HMB/NDARLY125HMB_Video2_Samples_ET.mat, Diary, 120, 4629243947, 4746637115, 117393168
/Volumes/methlab_data/HBN/EEG-ET/NDARLY125HMB/NDARLY125HMB_Video3_Samples_ET.mat, Despicable, 120, 5167716649, 5338264208, 170547559
/Volumes/methlab_data/HBN/EEG-ET/NDARLY125HMB/NDARLY125HMB_Video4_Samples_ET.mat, Present, 120, 5806784038, 6009850689, 203066651
/Volumes/methlab_data/HBN/EEG-ET/NDARLY465LNP/NDARLY465LNP_Video-DM_Samples_ET.mat, Despicable, 30, 9393143910, 9563691535, 170547625
/Volumes/methlab_data/HBN/EEG-ET/NDARLY465LNP/NDARLY465LNP_Video-TP_Samples_ET.mat, Present, 30, 9954050609, 10157327400, 203276791
/Volumes/methlab_data/HBN/EEG-ET/NDARLY465LNP/NDARLY465LNP_Video-WK_Samples_ET.mat, Diary, 30, 8305802851, 8423190892, 117388041
/Volumes/methlab_data/HBN/EEG-ET/NDARLY483UNZ/NDARLY483UNZ_Video1_Samples_ET.mat, Diary, 60, 5236067243, 5353460813, 117393570
/Volumes/methlab_data/HBN/EEG-ET/NDARLY483UNZ/NDARLY483UNZ_Video3_Samples_ET.mat, Despicable, 60, 4714002017, 4884545287, 170543270
/Volumes/methlab_data/HBN/EEG-ET/NDARLY483UNZ/NDARLY483UNZ_Video4_Samples_ET.mat, Present, 60, 5739870491, 5942930944, 203060453
/Volumes/methlab_data/HBN/EEG-ET/NDARLY585ZVN/NDARLY585ZVN_Video1_Samples_ET.mat, Diary, 60, 4882317692, 4999712896, 117395204
/Volumes/methlab_data/HBN/EEG-ET/NDARLY585ZVN/NDARLY585ZVN_Video3_Samples_ET.mat, Despicable, 60, 4464002392, 4634543809, 170541417
/Volumes/methlab_data/HBN/EEG-ET/NDARLY687YDQ/NDARLY687YDQ_Video1_Samples_ET.mat, Diary, 60, 3058928622, 3176318469, 117389847
/Volumes/methlab_data/HBN/EEG-ET/NDARLY687YDQ/NDARLY687YDQ_Video2_Samples_ET.mat, Fractals, 60, 3719293584, 3882280576, 162986992
/Volumes/methlab_data/HBN/EEG-ET/NDARLY867ZD4/NDARLY867ZD4_Video-DM_Samples_ET.mat, Despicable, 60, 15569410585, 15739953993, 170543408
/Volumes/methlab_data/HBN/EEG-ET/NDARLY867ZD4/NDARLY867ZD4_Video-FF_Samples_ET.mat, Fractals, 60, 14800017427, 14963004532, 162987105
/Volumes/methlab_data/HBN/EEG-ET/NDARLY867ZD4/NDARLY867ZD4_Video-TP_Samples_ET.mat, Present, 60, 16070873605, 16273942938, 203069333
/Volumes/methlab_data/HBN/EEG-ET/NDARLY867ZD4/NDARLY867ZD4_Video-WK_Samples_ET.mat, Diary, 60, 14118622443, 14236015336, 117392893
/Volumes/methlab_data/HBN/EEG-ET/NDARLYO38AJZ/NDARLYO38AJZ_Video-DM_Samples_ET.mat, Despicable, 30, 2862856397, 3033390925, 170534528
/Volumes/methlab_data/HBN/EEG-ET/NDARLYO38AJZ/NDARLYO38AJZ_Video-TP_Samples_ET.mat, Present, 30, 3505707673, 3708972330, 203264657
/Volumes/methlab_data/HBN/EEG-ET/NDARLYO38AJZ/NDARLYO38AJZ_Video-WK_Samples_ET.mat, Diary, 30, 3090060959, 3207450929, 117389970
/Volumes/methlab_data/HBN/EEG-ET/NDARLZ007NHG/NDARLZ007NHG_Video-DM_Samples_ET.mat, Despicable, 120, 4673676026, 4844222798, 170546772
/Volumes/methlab_data/HBN/EEG-ET/NDARLZ007NHG/NDARLZ007NHG_Video-FF_Samples_ET.mat, Fractals, 120, 4033402438, 4196386831, 162984393
/Volumes/methlab_data/HBN/EEG-ET/NDARLZ007NHG/NDARLZ007NHG_Video-TP_Samples_ET.mat, Present, 120, 5225214300, 5428278348, 203064048
/Volumes/methlab_data/HBN/EEG-ET/NDARLZ007NHG/NDARLZ007NHG_Video-WK_Samples_ET.mat, Diary, 120, 3012676708, 3130064727, 117388019
/Volumes/methlab_data/HBN/EEG-ET/NDARLZ104NDT/NDARLZ104NDT_Video1_Samples_ET.mat, Diary, 60, 3113856006, 3231251055, 117395049
/Volumes/methlab_data/HBN/EEG-ET/NDARLZ104NDT/NDARLZ104NDT_Video3_Samples_ET.mat, Despicable, 60, 2676082410, 2846624013, 170541603
/Volumes/methlab_data/HBN/EEG-ET/NDARLZ228PCB/NDARLZ228PCB_Video1_Samples_ET.mat, Diary, 60, 1906491609, 2023887983, 117396374
/Volumes/methlab_data/HBN/EEG-ET/NDARLZ228PCB/NDARLZ228PCB_Video3_Samples_ET.mat, Despicable, 60, 3192495729, 3363038841, 170543112
/Volumes/methlab_data/HBN/EEG-ET/NDARLZ701LJ3/NDARLZ701LJ3_Video1_Samples_ET.mat, Diary, 120, 2700188507, 2817577958, 117389451
/Volumes/methlab_data/HBN/EEG-ET/NDARLZ701LJ3/NDARLZ701LJ3_Video2_Samples_ET.mat, Fractals, 120, 3739689865, 3902677594, 162987729
/Volumes/methlab_data/HBN/EEG-ET/NDARLZ701LJ3/NDARLZ701LJ3_Video3_Samples_ET.mat, Despicable, 120, 4296194457, 4466736092, 170541635
/Volumes/methlab_data/HBN/EEG-ET/NDARLZ701LJ3/NDARLZ701LJ3_Video4_Samples_ET.mat, Present, 120, 5000047225, 5203112014, 203064789
/Volumes/methlab_data/HBN/EEG-ET/NDARLZ986JLL/NDARLZ986JLL_Video1_Samples_ET.mat, Diary, 120, 4591214941, 4708605079, 117390138
/Volumes/methlab_data/HBN/EEG-ET/NDARLZ986JLL/NDARLZ986JLL_Video2_Samples_ET.mat, Despicable, 120, 5248542453, 5419089602, 170547149
/Volumes/methlab_data/HBN/EEG-ET/NDARLZ986JLL/NDARLZ986JLL_Video3_Samples_ET.mat, Fractals, 120, 5461769420, 5624755281, 162985861
/Volumes/methlab_data/HBN/EEG-ET/NDARLZ986JLL/NDARLZ986JLL_Video4_Samples_ET.mat, Present, 120, 6081488591, 6284554790, 203066199
/Volumes/methlab_data/HBN/EEG-ET/NDARMA390CHB/NDARMA390CHB_Video-DM_Samples_ET.mat, Despicable, 120, 3689874702, 3860421650, 170546948
/Volumes/methlab_data/HBN/EEG-ET/NDARMA390CHB/NDARMA390CHB_Video-FF_Samples_ET.mat, Fractals, 120, 2877479576, 3040476824, 162997248
/Volumes/methlab_data/HBN/EEG-ET/NDARMA390CHB/NDARMA390CHB_Video-TP_Samples_ET.mat, Present, 120, 4828467153, 5031534343, 203067190
/Volumes/methlab_data/HBN/EEG-ET/NDARMA390CHB/NDARMA390CHB_Video-WK_Samples_ET.mat, Diary, 120, 4227161051, 4344558475, 117397424
/Volumes/methlab_data/HBN/EEG-ET/NDARMA584EM0/NDARMA584EM0_Video1_Samples_ET.mat, Diary, 120, 3476690573, 3594081032, 117390459
/Volumes/methlab_data/HBN/EEG-ET/NDARMA584EM0/NDARMA584EM0_Video2_Samples_ET.mat, Fractals, 120, 4580776238, 4743764004, 162987766
/Volumes/methlab_data/HBN/EEG-ET/NDARMA584EM0/NDARMA584EM0_Video3_Samples_ET.mat, Despicable, 120, 5109553878, 5280101194, 170547316
/Volumes/methlab_data/HBN/EEG-ET/NDARMA629XDR/NDARMA629XDR_Video-DM_Samples_ET.mat, Despicable, 30, 4607304880, 4777843474, 170538594
/Volumes/methlab_data/HBN/EEG-ET/NDARMA629XDR/NDARMA629XDR_Video-TP_Samples_ET.mat, Present, 30, 5584822996, 5788101741, 203278745
/Volumes/methlab_data/HBN/EEG-ET/NDARMA629XDR/NDARMA629XDR_Video-WK_Samples_ET.mat, Diary, 30, 3705784513, 3823172537, 117388024
/Volumes/methlab_data/HBN/EEG-ET/NDARMB216LA6/NDARMB216LA6_Video1_Samples_ET.mat, Fractals, 120, 5971172488, 6134157983, 162985495
/Volumes/methlab_data/HBN/EEG-ET/NDARMB216LA6/NDARMB216LA6_Video2_Samples_ET.mat, Despicable, 120, 6822106256, 6992652748, 170546492
/Volumes/methlab_data/HBN/EEG-ET/NDARMB216LA6/NDARMB216LA6_Video3_Samples_ET.mat, Diary, 120, 7313415764, 7430807716, 117391952
/Volumes/methlab_data/HBN/EEG-ET/NDARMB216LA6/NDARMB216LA6_Video4_Samples_ET.mat, Present, 120, 7905459838, 8108526216, 203066378
/Volumes/methlab_data/HBN/EEG-ET/NDARMB273TED/NDARMB273TED_Video-DM_Samples_ET.mat, Despicable, 120, 3070525664, 3241069334, 170543670
/Volumes/methlab_data/HBN/EEG-ET/NDARMB273TED/NDARMB273TED_Video-FF_Samples_ET.mat, Fractals, 120, 3492775213, 3655762635, 162987422
/Volumes/methlab_data/HBN/EEG-ET/NDARMB273TED/NDARMB273TED_Video-TP_Samples_ET.mat, Present, 120, 3752543340, 3955610846, 203067506
/Volumes/methlab_data/HBN/EEG-ET/NDARMB273TED/NDARMB273TED_Video-WK_Samples_ET.mat, Diary, 120, 3304538669, 3421930245, 117391576
/Volumes/methlab_data/HBN/EEG-ET/NDARMB290GPL/NDARMB290GPL_Video-DM_Samples_ET.mat, Despicable, 60, 5657800491, 5828341186, 170540695
/Volumes/methlab_data/HBN/EEG-ET/NDARMB290GPL/NDARMB290GPL_Video-FF_Samples_ET.mat, Fractals, 60, 5169886199, 5332877568, 162991369
/Volumes/methlab_data/HBN/EEG-ET/NDARMB290GPL/NDARMB290GPL_Video-TP_Samples_ET.mat, Present, 60, 6143391081, 6346464794, 203073713
/Volumes/methlab_data/HBN/EEG-ET/NDARMB290GPL/NDARMB290GPL_Video-WK_Samples_ET.mat, Diary, 60, 4191998220, 4309394314, 117396094
/Volumes/methlab_data/HBN/EEG-ET/NDARMC325JCN/NDARMC325JCN_Video1_Samples_ET.mat, Diary, 60, 5334398856, 5451799672, 117400816
/Volumes/methlab_data/HBN/EEG-ET/NDARMC325JCN/NDARMC325JCN_Video3_Samples_ET.mat, Despicable, 60, 4847259446, 5017806689, 170547243
/Volumes/methlab_data/HBN/EEG-ET/NDARMC325JCN/NDARMC325JCN_Video4_Samples_ET.mat, Present, 60, 5863903126, 6066972324, 203069198
/Volumes/methlab_data/HBN/EEG-ET/NDARMC337WLJ/NDARMC337WLJ_Video-DM_Samples_ET.mat, Despicable, 60, 4675001026, 4845539494, 170538468
/Volumes/methlab_data/HBN/EEG-ET/NDARMC337WLJ/NDARMC337WLJ_Video-TP_Samples_ET.mat, Present, 60, 5612704318, 5815979903, 203275585
/Volumes/methlab_data/HBN/EEG-ET/NDARMC337WLJ/NDARMC337WLJ_Video-WK_Samples_ET.mat, Diary, 60, 5189946759, 5307333688, 117386929
/Volumes/methlab_data/HBN/EEG-ET/NDARMC473UHD/NDARMC473UHD_Video1_Samples_ET.mat, Diary, 60, 3092112520, 3209506433, 117393913
/Volumes/methlab_data/HBN/EEG-ET/NDARMC473UHD/NDARMC473UHD_Video2_Samples_ET.mat, Fractals, 60, 3630346290, 3793327305, 162981015
/Volumes/methlab_data/HBN/EEG-ET/NDARMC473UHD/NDARMC473UHD_Video3_Samples_ET.mat, Despicable, 60, 4050208542, 4220753882, 170545340
/Volumes/methlab_data/HBN/EEG-ET/NDARMC473UHD/NDARMC473UHD_Video4_Samples_ET.mat, Present, 60, 4570110387, 4773172666, 203062279
/Volumes/methlab_data/HBN/EEG-ET/NDARMC481AWW/NDARMC481AWW_Video-DM_Samples_ET.mat, Despicable, 120, 5014948310, 5185505308, 170556998
/Volumes/methlab_data/HBN/EEG-ET/NDARMC481AWW/NDARMC481AWW_Video-FF_Samples_ET.mat, Fractals, 120, 3924486302, 4087473041, 162986739
/Volumes/methlab_data/HBN/EEG-ET/NDARMC481AWW/NDARMC481AWW_Video-TP_Samples_ET.mat, Present, 120, 6033080275, 6236147695, 203067420
/Volumes/methlab_data/HBN/EEG-ET/NDARMC481AWW/NDARMC481AWW_Video-WK_Samples_ET.mat, Diary, 120, 5410783362, 5528172611, 117389249
/Volumes/methlab_data/HBN/EEG-ET/NDARMC694YF3/NDARMC694YF3_Video-DM_Samples_ET.mat, Despicable, 60, 5402993366, 5573529876, 170536510
/Volumes/methlab_data/HBN/EEG-ET/NDARMC694YF3/NDARMC694YF3_Video-TP_Samples_ET.mat, Present, 60, 5887749747, 6091017408, 203267661
/Volumes/methlab_data/HBN/EEG-ET/NDARMC694YF3/NDARMC694YF3_Video-WK_Samples_ET.mat, Diary, 60, 2842762107, 2960151054, 117388947
/Volumes/methlab_data/HBN/EEG-ET/NDARMC759CX3/NDARMC759CX3_Video1_Samples_ET.mat, Diary, 60, 4858218831, 4975611764, 117392933
/Volumes/methlab_data/HBN/EEG-ET/NDARMC759CX3/NDARMC759CX3_Video3_Samples_ET.mat, Despicable, 60, 5235895545, 5406439030, 170543485
/Volumes/methlab_data/HBN/EEG-ET/NDARMC760NEC/NDARMC760NEC_Video1_Samples_ET.mat, Diary, 60, 4279332324, 4396727370, 117395046
/Volumes/methlab_data/HBN/EEG-ET/NDARMC760NEC/NDARMC760NEC_Video3_Samples_ET.mat, Despicable, 60, 4666977494, 4837531155, 170553661
/Volumes/methlab_data/HBN/EEG-ET/NDARMC774PRM/NDARMC774PRM_Video2_Samples_ET.mat, Fractals, 120, 1795567687, 1958555748, 162988061
/Volumes/methlab_data/HBN/EEG-ET/NDARMC774PRM/NDARMC774PRM_Video3_Samples_ET.mat, Diary, 120, 2124906174, 2242304205, 117398031
/Volumes/methlab_data/HBN/EEG-ET/NDARMC774PRM/NDARMC774PRM_Video4_Samples_ET.mat, Present, 120, 2356328672, 2559390497, 203061825
/Volumes/methlab_data/HBN/EEG-ET/NDARMC950EUL/NDARMC950EUL_Video-DM_Samples_ET.mat, Despicable, 120, 4003427043, 4173967465, 170540422
/Volumes/methlab_data/HBN/EEG-ET/NDARMC950EUL/NDARMC950EUL_Video-FF_Samples_ET.mat, Fractals, 120, 4468872080, 4631860214, 162988134
/Volumes/methlab_data/HBN/EEG-ET/NDARMC950EUL/NDARMC950EUL_Video-TP_Samples_ET.mat, Present, 120, 5121108964, 5324186352, 203077388
/Volumes/methlab_data/HBN/EEG-ET/NDARMC950EUL/NDARMC950EUL_Video-WK_Samples_ET.mat, Diary, 120, 3395850239, 3513246359, 117396120
/Volumes/methlab_data/HBN/EEG-ET/NDARMD134JRU/NDARMD134JRU_Video-DM_Samples_ET.mat, Despicable, 120, 2873879831, 3044426784, 170546953
/Volumes/methlab_data/HBN/EEG-ET/NDARMD134JRU/NDARMD134JRU_Video-FF_Samples_ET.mat, Fractals, 120, 3088086701, 3251075020, 162988319
/Volumes/methlab_data/HBN/EEG-ET/NDARMD134JRU/NDARMD134JRU_Video-TP_Samples_ET.mat, Present, 120, 3578344503, 3781412577, 203068074
/Volumes/methlab_data/HBN/EEG-ET/NDARMD134JRU/NDARMD134JRU_Video-WK_Samples_ET.mat, Diary, 120, 3352596635, 3469993588, 117396953
/Volumes/methlab_data/HBN/EEG-ET/NDARMD567YYM/NDARMD567YYM_Video1_Samples_ET.mat, Diary, 60, 1372111578, 1489503789, 117392211
/Volumes/methlab_data/HBN/EEG-ET/NDARMD567YYM/NDARMD567YYM_Video3_Samples_ET.mat, Despicable, 60, 932135382, 1102678072, 170542690
/Volumes/methlab_data/HBN/EEG-ET/NDARMD575AXD/NDARMD575AXD_Video1_Samples_ET.mat, Fractals, 120, 5493226350, 5656213461, 162987111
/Volumes/methlab_data/HBN/EEG-ET/NDARMD575AXD/NDARMD575AXD_Video2_Samples_ET.mat, Despicable, 120, 6039613784, 6210159625, 170545841
/Volumes/methlab_data/HBN/EEG-ET/NDARMD987YR6/NDARMD987YR6_Video-DM_Samples_ET.mat, Despicable, 30, 5778951798, 5949488268, 170536470
/Volumes/methlab_data/HBN/EEG-ET/NDARMD987YR6/NDARMD987YR6_Video-TP_Samples_ET.mat, Present, 30, 7296894906, 7500368626, 203473720
/Volumes/methlab_data/HBN/EEG-ET/NDARME563AK8/NDARME563AK8_Video-DM_Samples_ET.mat, Despicable, 120, 3771000692, 3941547304, 170546612
/Volumes/methlab_data/HBN/EEG-ET/NDARME563AK8/NDARME563AK8_Video-FF_Samples_ET.mat, Fractals, 120, 3064903692, 3227891056, 162987364
/Volumes/methlab_data/HBN/EEG-ET/NDARME563AK8/NDARME563AK8_Video-TP_Samples_ET.mat, Present, 120, 4855624573, 5058701178, 203076605
/Volumes/methlab_data/HBN/EEG-ET/NDARME563AK8/NDARME563AK8_Video-WK_Samples_ET.mat, Diary, 120, 4234277019, 4351675095, 117398076
/Volumes/methlab_data/HBN/EEG-ET/NDARME573TRB/NDARME573TRB_Video-WK_Samples_ET.mat, Diary, 120, 2831270091, 2948658372, 117388281
/Volumes/methlab_data/HBN/EEG-ET/NDARME656MTN/NDARME656MTN_Video1_Samples_ET.mat, Diary, 60, 2834906966, 2952300919, 117393953
/Volumes/methlab_data/HBN/EEG-ET/NDARME656MTN/NDARME656MTN_Video3_Samples_ET.mat, Despicable, 60, 4078899582, 4249446052, 170546470
/Volumes/methlab_data/HBN/EEG-ET/NDARME689TAF/NDARME689TAF_Video-DM_Samples_ET.mat, Despicable, 120, 6981871935, 7152428796, 170556861
/Volumes/methlab_data/HBN/EEG-ET/NDARME689TAF/NDARME689TAF_Video-FF_Samples_ET.mat, Fractals, 120, 7412548832, 7575541523, 162992691
/Volumes/methlab_data/HBN/EEG-ET/NDARME689TAF/NDARME689TAF_Video-TP_Samples_ET.mat, Present, 120, 8036095223, 8239162105, 203066882
/Volumes/methlab_data/HBN/EEG-ET/NDARME689TAF/NDARME689TAF_Video-WK_Samples_ET.mat, Diary, 120, 7195589700, 7312987249, 117397549
/Volumes/methlab_data/HBN/EEG-ET/NDARME724FJE/NDARME724FJE_Video-DM_Samples_ET.mat, Despicable, 60, 4156135555, 4326678088, 170542533
/Volumes/methlab_data/HBN/EEG-ET/NDARME724FJE/NDARME724FJE_Video-FF_Samples_ET.mat, Fractals, 60, 3721325289, 3884313497, 162988208
/Volumes/methlab_data/HBN/EEG-ET/NDARME724FJE/NDARME724FJE_Video-TP_Samples_ET.mat, Present, 60, 4635609375, 4838682890, 203073515
/Volumes/methlab_data/HBN/EEG-ET/NDARME724FJE/NDARME724FJE_Video-WK_Samples_ET.mat, Diary, 60, 3185691778, 3303084754, 117392976
/Volumes/methlab_data/HBN/EEG-ET/NDARME789TD2/NDARME789TD2_Video-DM_Samples_ET.mat, Despicable, 60, 3924412098, 4094954632, 170542534
/Volumes/methlab_data/HBN/EEG-ET/NDARME789TD2/NDARME789TD2_Video-FF_Samples_ET.mat, Fractals, 60, 4364946392, 4527940605, 162994213
/Volumes/methlab_data/HBN/EEG-ET/NDARME789TD2/NDARME789TD2_Video-TP_Samples_ET.mat, Present, 60, 4838161786, 5041229327, 203067541
/Volumes/methlab_data/HBN/EEG-ET/NDARME789TD2/NDARME789TD2_Video-WK_Samples_ET.mat, Diary, 60, 3330417355, 3447814314, 117396959
/Volumes/methlab_data/HBN/EEG-ET/NDARME880JD7/NDARME880JD7_Video1_Samples_ET.mat, Diary, 60, 7972714805, 8090104796, 117389991
/Volumes/methlab_data/HBN/EEG-ET/NDARME880JD7/NDARME880JD7_Video3_Samples_ET.mat, Despicable, 60, 7532905817, 7703453439, 170547622
/Volumes/methlab_data/HBN/EEG-ET/NDARME880JD7/NDARME880JD7_Video4_Samples_ET.mat, Present, 60, 8413088121, 8616150708, 203062587
/Volumes/methlab_data/HBN/EEG-ET/NDARME930DE7/NDARME930DE7_Video1_Samples_ET.mat, Diary, 60, 1318829121, 1436226142, 117397021
/Volumes/methlab_data/HBN/EEG-ET/NDARME930DE7/NDARME930DE7_Video3_Samples_ET.mat, Despicable, 60, 504964710, 675511311, 170546601
/Volumes/methlab_data/HBN/EEG-ET/NDARMF116AFR/NDARMF116AFR_Video1_Samples_ET.mat, Diary, 120, 3101084364, 3218481510, 117397146
/Volumes/methlab_data/HBN/EEG-ET/NDARMF116AFR/NDARMF116AFR_Video2_Samples_ET.mat, Fractals, 120, 4387165068, 4550163220, 162998152
/Volumes/methlab_data/HBN/EEG-ET/NDARMF116AFR/NDARMF116AFR_Video3_Samples_ET.mat, Despicable, 120, 4883112746, 5053659756, 170547010
/Volumes/methlab_data/HBN/EEG-ET/NDARMF116AFR/NDARMF116AFR_Video4_Samples_ET.mat, Present, 120, 5555589489, 5758655417, 203065928
/Volumes/methlab_data/HBN/EEG-ET/NDARMF508PA2/NDARMF508PA2_Video1_Samples_ET.mat, Diary, 60, 3025569866, 3142963909, 117394043
/Volumes/methlab_data/HBN/EEG-ET/NDARMF508PA2/NDARMF508PA2_Video3_Samples_ET.mat, Despicable, 60, 4425783199, 4596325842, 170542643
/Volumes/methlab_data/HBN/EEG-ET/NDARMF508PA2/NDARMF508PA2_Video4_Samples_ET.mat, Present, 60, 4907837132, 5110897799, 203060667
/Volumes/methlab_data/HBN/EEG-ET/NDARMF560MUH/NDARMF560MUH_Video-FF_Samples_ET.mat, Fractals, 60, 2823830424, 2986820557, 162990133
/Volumes/methlab_data/HBN/EEG-ET/NDARMF668NU5/NDARMF668NU5_Video1_Samples_ET.mat, Diary, 60, 5931106424, 6048498408, 117391984
/Volumes/methlab_data/HBN/EEG-ET/NDARMF668NU5/NDARMF668NU5_Video3_Samples_ET.mat, Despicable, 60, 7461121975, 7631663394, 170541419
/Volumes/methlab_data/HBN/EEG-ET/NDARMF668NU5/NDARMF668NU5_Video4_Samples_ET.mat, Present, 60, 7956793715, 8159855026, 203061311
/Volumes/methlab_data/HBN/EEG-ET/NDARMF846EVR/NDARMF846EVR_Video-DM_Samples_ET.mat, Despicable, 60, 5763339125, 5933876661, 170537536
/Volumes/methlab_data/HBN/EEG-ET/NDARMF846EVR/NDARMF846EVR_Video-WK_Samples_ET.mat, Diary, 60, 4704002553, 4821385542, 117382989
/Volumes/methlab_data/HBN/EEG-ET/NDARMF939FNX/NDARMF939FNX_Video1_Samples_ET.mat, Fractals, 120, 3587130818, 3750117561, 162986743
/Volumes/methlab_data/HBN/EEG-ET/NDARMF939FNX/NDARMF939FNX_Video2_Samples_ET.mat, Despicable, 120, 4342436822, 4512983730, 170546908
/Volumes/methlab_data/HBN/EEG-ET/NDARMF939FNX/NDARMF939FNX_Video3_Samples_ET.mat, Diary, 120, 4892993592, 5010391269, 117397677
/Volumes/methlab_data/HBN/EEG-ET/NDARMF939FNX/NDARMF939FNX_Video4_Samples_ET.mat, Present, 120, 5424238113, 5627312362, 203074249
/Volumes/methlab_data/HBN/EEG-ET/NDARMG196KV4/NDARMG196KV4_Video1_Samples_ET.mat, Diary, 60, 842768441, 960157258, 117388817
/Volumes/methlab_data/HBN/EEG-ET/NDARMG196KV4/NDARMG196KV4_Video2_Samples_ET.mat, Fractals, 60, 1210821996, 1373814963, 162992967
/Volumes/methlab_data/HBN/EEG-ET/NDARMG196KV4/NDARMG196KV4_Video3_Samples_ET.mat, Despicable, 60, 110010696, 280552983, 170542287
/Volumes/methlab_data/HBN/EEG-ET/NDARMG196KV4/NDARMG196KV4_Video4_Samples_ET.mat, Present, 60, 1680376271, 1883438377, 203062106
/Volumes/methlab_data/HBN/EEG-ET/NDARMG239GUV/NDARMG239GUV_Video-DM_Samples_ET.mat, Despicable, 120, 4678426113, 4848967124, 170541011
/Volumes/methlab_data/HBN/EEG-ET/NDARMG239GUV/NDARMG239GUV_Video-FF_Samples_ET.mat, Fractals, 120, 4064358741, 4227355144, 162996403
/Volumes/methlab_data/HBN/EEG-ET/NDARMG239GUV/NDARMG239GUV_Video-TP_Samples_ET.mat, Present, 120, 5467538847, 5670605263, 203066416
/Volumes/methlab_data/HBN/EEG-ET/NDARMG239GUV/NDARMG239GUV_Video-WK_Samples_ET.mat, Diary, 120, 3389248370, 3506633946, 117385576
/Volumes/methlab_data/HBN/EEG-ET/NDARMG263JRX/NDARMG263JRX_Video-DM_Samples_ET.mat, Despicable, 60, 2965089609, 3135628138, 170538529
/Volumes/methlab_data/HBN/EEG-ET/NDARMG263JRX/NDARMG263JRX_Video-TP_Samples_ET.mat, Present, 60, 3534877251, 3738153924, 203276673
/Volumes/methlab_data/HBN/EEG-ET/NDARMG263JRX/NDARMG263JRX_Video-WK_Samples_ET.mat, Diary, 60, 2576616105, 2694016074, 117399969
/Volumes/methlab_data/HBN/EEG-ET/NDARMG278GYH/NDARMG278GYH_Video1_Samples_ET.mat, Diary, 60, 3638438272, 3755836226, 117397954
/Volumes/methlab_data/HBN/EEG-ET/NDARMG278GYH/NDARMG278GYH_Video3_Samples_ET.mat, Despicable, 60, 4087128306, 4257679856, 170551550
/Volumes/methlab_data/HBN/EEG-ET/NDARMG405RZK/NDARMG405RZK_Video-DM_Samples_ET.mat, Despicable, 60, 2677039344, 2847588698, 170549354
/Volumes/methlab_data/HBN/EEG-ET/NDARMG405RZK/NDARMG405RZK_Video-FF_Samples_ET.mat, Fractals, 60, 2220626319, 2383619335, 162993016
/Volumes/methlab_data/HBN/EEG-ET/NDARMG405RZK/NDARMG405RZK_Video-TP_Samples_ET.mat, Present, 60, 3528440072, 3731513375, 203073303
/Volumes/methlab_data/HBN/EEG-ET/NDARMG405RZK/NDARMG405RZK_Video-WK_Samples_ET.mat, Diary, 60, 3109644594, 3227040429, 117395835
/Volumes/methlab_data/HBN/EEG-ET/NDARMG675JB4/NDARMG675JB4_Video-DM_Samples_ET.mat, Despicable, 120, 1723176943, 1893724386, 170547443
/Volumes/methlab_data/HBN/EEG-ET/NDARMG675JB4/NDARMG675JB4_Video-FF_Samples_ET.mat, Fractals, 120, 1943810629, 2106797522, 162986893
/Volumes/methlab_data/HBN/EEG-ET/NDARMG675JB4/NDARMG675JB4_Video-TP_Samples_ET.mat, Present, 120, 2334097024, 2537159820, 203062796
/Volumes/methlab_data/HBN/EEG-ET/NDARMG675JB4/NDARMG675JB4_Video-WK_Samples_ET.mat, Diary, 120, 2171791841, 2289183187, 117391346
/Volumes/methlab_data/HBN/EEG-ET/NDARMG741FDL/NDARMG741FDL_Video-DM_Samples_ET.mat, Despicable, 60, 4574213388, 4744756905, 170543517
/Volumes/methlab_data/HBN/EEG-ET/NDARMG741FDL/NDARMG741FDL_Video-FF_Samples_ET.mat, Fractals, 60, 3853037771, 4016034960, 162997189
/Volumes/methlab_data/HBN/EEG-ET/NDARMG741FDL/NDARMG741FDL_Video-TP_Samples_ET.mat, Present, 60, 5850211085, 6053280577, 203069492
/Volumes/methlab_data/HBN/EEG-ET/NDARMG741FDL/NDARMG741FDL_Video-WK_Samples_ET.mat, Diary, 60, 5145944393, 5263339378, 117394985
/Volumes/methlab_data/HBN/EEG-ET/NDARMH559LKK/NDARMH559LKK_Video1_Samples_ET.mat, Diary, 60, 376997839, 494386975, 117389136
/Volumes/methlab_data/HBN/EEG-ET/NDARMH559LKK/NDARMH559LKK_Video2_Samples_ET.mat, Fractals, 60, 2441987581, 2604977000, 162989419
/Volumes/methlab_data/HBN/EEG-ET/NDARMH559LKK/NDARMH559LKK_Video3_Samples_ET.mat, Despicable, 60, 3158100598, 3328642352, 170541754
/Volumes/methlab_data/HBN/EEG-ET/NDARMH559LKK/NDARMH559LKK_Video4_Samples_ET.mat, Present, 60, 918874470, 1121937268, 203062798
/Volumes/methlab_data/HBN/EEG-ET/NDARMH625WKL/NDARMH625WKL_Video1_Samples_ET.mat, Diary, 60, 41681744, 159075781, 117394037
/Volumes/methlab_data/HBN/EEG-ET/NDARMH625WKL/NDARMH625WKL_Video3_Samples_ET.mat, Despicable, 60, 1207606364, 1378145006, 170538642
/Volumes/methlab_data/HBN/EEG-ET/NDARMH763YZD/NDARMH763YZD_Video1_Samples_ET.mat, Diary, 120, 3587533217, 3704930763, 117397546
/Volumes/methlab_data/HBN/EEG-ET/NDARMH763YZD/NDARMH763YZD_Video2_Samples_ET.mat, Fractals, 120, 5212053088, 5375039618, 162986530
/Volumes/methlab_data/HBN/EEG-ET/NDARMH763YZD/NDARMH763YZD_Video3_Samples_ET.mat, Despicable, 120, 5753408655, 5923956389, 170547734
/Volumes/methlab_data/HBN/EEG-ET/NDARMJ219AKU/NDARMJ219AKU_Video1_Samples_ET.mat, Diary, 60, 3505845391, 3623234446, 117389055
/Volumes/methlab_data/HBN/EEG-ET/NDARMJ219AKU/NDARMJ219AKU_Video3_Samples_ET.mat, Despicable, 60, 5571531426, 5742080044, 170548618
/Volumes/methlab_data/HBN/EEG-ET/NDARMJ333WJM/NDARMJ333WJM_Video-DM_Samples_ET.mat, Despicable, 60, 4094066888, 4264612239, 170545351
/Volumes/methlab_data/HBN/EEG-ET/NDARMJ333WJM/NDARMJ333WJM_Video-TP_Samples_ET.mat, Present, 60, 4996454586, 5199723019, 203268433
/Volumes/methlab_data/HBN/EEG-ET/NDARMJ333WJM/NDARMJ333WJM_Video-WK_Samples_ET.mat, Diary, 60, 4531900810, 4649287645, 117386835
/Volumes/methlab_data/HBN/EEG-ET/NDARMJ495DE0/NDARMJ495DE0_Video1_Samples_ET.mat, Diary, 60, 2689102645, 2806498556, 117395911
/Volumes/methlab_data/HBN/EEG-ET/NDARMJ495DE0/NDARMJ495DE0_Video2_Samples_ET.mat, Fractals, 60, 3200698774, 3363687869, 162989095
/Volumes/methlab_data/HBN/EEG-ET/NDARMJ495DE0/NDARMJ495DE0_Video3_Samples_ET.mat, Despicable, 60, 3640450230, 3810993645, 170543415
/Volumes/methlab_data/HBN/EEG-ET/NDARMJ495DE0/NDARMJ495DE0_Video4_Samples_ET.mat, Present, 60, 4194320224, 4397383585, 203063361
/Volumes/methlab_data/HBN/EEG-ET/NDARMJ699RJN/NDARMJ699RJN_Video1_Samples_ET.mat, Diary, 60, 3816854366, 3934245099, 117390733
/Volumes/methlab_data/HBN/EEG-ET/NDARMJ699RJN/NDARMJ699RJN_Video3_Samples_ET.mat, Despicable, 60, 3595932704, 3766473901, 170541197
/Volumes/methlab_data/HBN/EEG-ET/NDARMJ845MJA/NDARMJ845MJA_Video-DM_Samples_ET.mat, Despicable, 60, 888044780, 1058592500, 170547720
/Volumes/methlab_data/HBN/EEG-ET/NDARMJ845MJA/NDARMJ845MJA_Video-TP_Samples_ET.mat, Present, 60, 1442357025, 1645636895, 203279870
/Volumes/methlab_data/HBN/EEG-ET/NDARMJ845MJA/NDARMJ845MJA_Video-WK_Samples_ET.mat, Diary, 60, 4412229091, 4529617176, 117388085
/Volumes/methlab_data/HBN/EEG-ET/NDARMJ849UKD/NDARMJ849UKD_Video1_Samples_ET.mat, Diary, 60, 964068161, 1081459134, 117390973
/Volumes/methlab_data/HBN/EEG-ET/NDARMJ849UKD/NDARMJ849UKD_Video3_Samples_ET.mat, Despicable, 60, 395566469, 566107958, 170541489
/Volumes/methlab_data/HBN/EEG-ET/NDARMJ877UTP/NDARMJ877UTP_Video-DM_Samples_ET.mat, Despicable, 60, 4712184451, 4882721816, 170537365
/Volumes/methlab_data/HBN/EEG-ET/NDARMJ877UTP/NDARMJ877UTP_Video-TP_Samples_ET.mat, Present, 60, 5589190243, 5792452690, 203262447
/Volumes/methlab_data/HBN/EEG-ET/NDARMJ877UTP/NDARMJ877UTP_Video-WK_Samples_ET.mat, Diary, 60, 5179731327, 5297119183, 117387856
/Volumes/methlab_data/HBN/EEG-ET/NDARMK046ZRK/NDARMK046ZRK_Video-DM_Samples_ET.mat, Despicable, 30, 3065782055, 3236319472, 170537417
/Volumes/methlab_data/HBN/EEG-ET/NDARMK046ZRK/NDARMK046ZRK_Video-TP_Samples_ET.mat, Present, 30, 5140138410, 5343414922, 203276512
/Volumes/methlab_data/HBN/EEG-ET/NDARMK046ZRK/NDARMK046ZRK_Video-WK_Samples_ET.mat, Diary, 30, 4229439514, 4346839413, 117399899
/Volumes/methlab_data/HBN/EEG-ET/NDARMK100DJR/NDARMK100DJR_Video-DM_Samples_ET.mat, Despicable, 30, 3569470035, 3740006455, 170536420
/Volumes/methlab_data/HBN/EEG-ET/NDARMK100DJR/NDARMK100DJR_Video-TP_Samples_ET.mat, Present, 30, 4645687776, 4848971308, 203283532
/Volumes/methlab_data/HBN/EEG-ET/NDARMK416UUQ/NDARMK416UUQ_Video1_Samples_ET.mat, Diary, 60, 3469304962, 3586695992, 117391030
/Volumes/methlab_data/HBN/EEG-ET/NDARMK416UUQ/NDARMK416UUQ_Video2_Samples_ET.mat, Fractals, 60, 4134190039, 4297182309, 162992270
/Volumes/methlab_data/HBN/EEG-ET/NDARMK416UUQ/NDARMK416UUQ_Video3_Samples_ET.mat, Despicable, 60, 4565066652, 4735610339, 170543687
/Volumes/methlab_data/HBN/EEG-ET/NDARMK416UUQ/NDARMK416UUQ_Video4_Samples_ET.mat, Present, 60, 5079780579, 5282843166, 203062587
/Volumes/methlab_data/HBN/EEG-ET/NDARMK525TGP/NDARMK525TGP_Video1_Samples_ET.mat, Diary, 60, 4183633900, 4301028911, 117395011
/Volumes/methlab_data/HBN/EEG-ET/NDARMK525TGP/NDARMK525TGP_Video2_Samples_ET.mat, Fractals, 60, 5354053583, 5517035702, 162982119
/Volumes/methlab_data/HBN/EEG-ET/NDARMK525TGP/NDARMK525TGP_Video3_Samples_ET.mat, Despicable, 60, 4826321826, 4996864302, 170542476
/Volumes/methlab_data/HBN/EEG-ET/NDARMK525TGP/NDARMK525TGP_Video4_Samples_ET.mat, Present, 60, 5878635056, 6081697518, 203062462
/Volumes/methlab_data/HBN/EEG-ET/NDARMK825WAX/NDARMK825WAX_Video1_Samples_ET.mat, Fractals, 120, 4311713501, 4474702140, 162988639
/Volumes/methlab_data/HBN/EEG-ET/NDARMK825WAX/NDARMK825WAX_Video2_Samples_ET.mat, Diary, 120, 5185017068, 5302414500, 117397432
/Volumes/methlab_data/HBN/EEG-ET/NDARMK825WAX/NDARMK825WAX_Video3_Samples_ET.mat, Despicable, 120, 5656945193, 5827491917, 170546724
/Volumes/methlab_data/HBN/EEG-ET/NDARMK825WAX/NDARMK825WAX_Video4_Samples_ET.mat, Present, 120, 6183611621, 6386688901, 203077280
/Volumes/methlab_data/HBN/EEG-ET/NDARML024FF2/NDARML024FF2_Video1_Samples_ET.mat, Diary, 60, 7019103287, 7136494214, 117390927
/Volumes/methlab_data/HBN/EEG-ET/NDARML024FF2/NDARML024FF2_Video3_Samples_ET.mat, Despicable, 60, 6549582668, 6720119140, 170536472
/Volumes/methlab_data/HBN/EEG-ET/NDARML148UCE/NDARML148UCE_Video1_Samples_ET.mat, Diary, 60, 1146954720, 1264349859, 117395139
/Volumes/methlab_data/HBN/EEG-ET/NDARML148UCE/NDARML148UCE_Video3_Samples_ET.mat, Despicable, 60, 683907896, 854451658, 170543762
/Volumes/methlab_data/HBN/EEG-ET/NDARML406ZB8/NDARML406ZB8_Video1_Samples_ET.mat, Diary, 60, 2458386867, 2575781867, 117395000
/Volumes/methlab_data/HBN/EEG-ET/NDARML406ZB8/NDARML406ZB8_Video3_Samples_ET.mat, Despicable, 60, 3754159516, 3924697053, 170537537
/Volumes/methlab_data/HBN/EEG-ET/NDARML626PGU/NDARML626PGU_Video-DM_Samples_ET.mat, Despicable, 60, 8382275281, 8552823893, 170548612
/Volumes/methlab_data/HBN/EEG-ET/NDARML626PGU/NDARML626PGU_Video-FF_Samples_ET.mat, Fractals, 60, 6930383770, 7093375255, 162991485
/Volumes/methlab_data/HBN/EEG-ET/NDARML626PGU/NDARML626PGU_Video-TP_Samples_ET.mat, Present, 60, 8850318165, 9053376760, 203058595
/Volumes/methlab_data/HBN/EEG-ET/NDARML626PGU/NDARML626PGU_Video-WK_Samples_ET.mat, Diary, 60, 7990282147, 8107683159, 117401012
/Volumes/methlab_data/HBN/EEG-ET/NDARML926NEG/NDARML926NEG_Video1_Samples_ET.mat, Fractals, 120, 4331406439, 4536394842, 4660233616
4.823222e+09, 4.918152e+08, 286826838, 162988064, /Volumes/methlab_data/HBN/EEG-ET/NDARML926NEG/NDARML926NEG_Video2_Samples_ET.mat, Despicable, 120, 5605429092, 5775976013, 170546921
/Volumes/methlab_data/HBN/EEG-ET/NDARML926NEG/NDARML926NEG_Video3_Samples_ET.mat, Diary, 120, 6128295055, 6245692736, 117397681
/Volumes/methlab_data/HBN/EEG-ET/NDARMM005DLK/NDARMM005DLK_Video1_Samples_ET.mat, Diary, 60, 6152797161, 6270186517, 117389356
/Volumes/methlab_data/HBN/EEG-ET/NDARMM005DLK/NDARMM005DLK_Video3_Samples_ET.mat, Despicable, 60, 5085125456, 5255675516, 170550060
/Volumes/methlab_data/HBN/EEG-ET/NDARMM137PT6/NDARMM137PT6_Video1_Samples_ET.mat, Diary, 60, 3131972892, 3249360780, 117387888
/Volumes/methlab_data/HBN/EEG-ET/NDARMM137PT6/NDARMM137PT6_Video3_Samples_ET.mat, Despicable, 60, 2701854261, 2872403663, 170549402
/Volumes/methlab_data/HBN/EEG-ET/NDARMM326JCB/NDARMM326JCB_Video1_Samples_ET.mat, Diary, 120, 2793292037, 2910689818, 117397781
/Volumes/methlab_data/HBN/EEG-ET/NDARMM326JCB/NDARMM326JCB_Video2_Samples_ET.mat, Fractals, 120, 3972144799, 4135131962, 162987163
/Volumes/methlab_data/HBN/EEG-ET/NDARMM326JCB/NDARMM326JCB_Video3_Samples_ET.mat, Despicable, 120, 4418091982, 4588638797, 170546815
/Volumes/methlab_data/HBN/EEG-ET/NDARMM326JCB/NDARMM326JCB_Video4_Samples_ET.mat, Present, 120, 5064997161, 5268074075, 203076914
/Volumes/methlab_data/HBN/EEG-ET/NDARMM486AJU/NDARMM486AJU_Video-DM_Samples_ET.mat, Despicable, 60, 8932500915, 9103038100, 170537185
/Volumes/methlab_data/HBN/EEG-ET/NDARMM486AJU/NDARMM486AJU_Video-TP_Samples_ET.mat, Present, 60, 9959177324, 10162445578, 203268254
/Volumes/methlab_data/HBN/EEG-ET/NDARMM486AJU/NDARMM486AJU_Video-WK_Samples_ET.mat, Diary, 60, 8238989290, 8356377002, 117387712
/Volumes/methlab_data/HBN/EEG-ET/NDARMM782KJK/NDARMM782KJK_Video1_Samples_ET.mat, Diary, 60, 3260180220, 3377576299, 117396079
/Volumes/methlab_data/HBN/EEG-ET/NDARMM782KJK/NDARMM782KJK_Video3_Samples_ET.mat, Despicable, 60, 3640537245, 3811091894, 170554649
/Volumes/methlab_data/HBN/EEG-ET/NDARMM905VYR/NDARMM905VYR_Video1_Samples_ET.mat, Diary, 60, 3628494508, 3745891442, 117396934
/Volumes/methlab_data/HBN/EEG-ET/NDARMM905VYR/NDARMM905VYR_Video3_Samples_ET.mat, Despicable, 60, 4218597068, 4389138502, 170541434
/Volumes/methlab_data/HBN/EEG-ET/NDARMM951YEH/NDARMM951YEH_Video1_Samples_ET.mat, Diary, 60, 5452217360, 5569606270, 117388910
/Volumes/methlab_data/HBN/EEG-ET/NDARMM951YEH/NDARMM951YEH_Video3_Samples_ET.mat, Despicable, 60, 5029062646, 5199614049, 170551403
/Volumes/methlab_data/HBN/EEG-ET/NDARMN302YAV/NDARMN302YAV_Video1_Samples_ET.mat, Diary, 60, 4864812103, 4864818129, 6026
/Volumes/methlab_data/HBN/EEG-ET/NDARMN302YAV/NDARMN302YAV_Video3_Samples_ET.mat, Despicable, 60, 3687754802, 3858300562, 170545760
/Volumes/methlab_data/HBN/EEG-ET/NDARMN302YAV/NDARMN302YAV_Video4_Samples_ET.mat, Present, 60, 4883688468, 5079607233, 195918765
/Volumes/methlab_data/HBN/EEG-ET/NDARMN376BMF/NDARMN376BMF_Video1_Samples_ET.mat, Diary, 120, 4820490238, 4937886676, 117396438
/Volumes/methlab_data/HBN/EEG-ET/NDARMN376BMF/NDARMN376BMF_Video2_Samples_ET.mat, Fractals, 120, 5924992501, 6087980025, 162987524
/Volumes/methlab_data/HBN/EEG-ET/NDARMN376BMF/NDARMN376BMF_Video3_Samples_ET.mat, Despicable, 120, 6132230619, 6302777366, 170546747
/Volumes/methlab_data/HBN/EEG-ET/NDARMN376BMF/NDARMN376BMF_Video4_Samples_ET.mat, Present, 120, 6350369355, 6553446374, 203077019
/Volumes/methlab_data/HBN/EEG-ET/NDARMN415AXR/NDARMN415AXR_Video-FF_Samples_ET.mat, Fractals, 120, 3322451964, 3485437657, 162985693
/Volumes/methlab_data/HBN/EEG-ET/NDARMN802MG9/NDARMN802MG9_Video-DM_Samples_ET.mat, Despicable, 120, 3290232389, 3460776216, 170543827
/Volumes/methlab_data/HBN/EEG-ET/NDARMN802MG9/NDARMN802MG9_Video-FF_Samples_ET.mat, Fractals, 120, 2782810162, 2945798017, 162987855
/Volumes/methlab_data/HBN/EEG-ET/NDARMN802MG9/NDARMN802MG9_Video-TP_Samples_ET.mat, Present, 120, 3917722979, 4120790454, 203067475
/Volumes/methlab_data/HBN/EEG-ET/NDARMN802MG9/NDARMN802MG9_Video-WK_Samples_ET.mat, Diary, 120, 3142689262, 3260082079, 117392817
/Volumes/methlab_data/HBN/EEG-ET/NDARMP372CG5/NDARMP372CG5_Video-DM_Samples_ET.mat, Despicable, 60, 4875969081, 5046511137, 170542056
/Volumes/methlab_data/HBN/EEG-ET/NDARMP372CG5/NDARMP372CG5_Video-FF_Samples_ET.mat, Fractals, 60, 4439164102, 4602146785, 162982683
/Volumes/methlab_data/HBN/EEG-ET/NDARMP372CG5/NDARMP372CG5_Video-TP_Samples_ET.mat, Present, 60, 5372293322, 5575364462, 203071140
/Volumes/methlab_data/HBN/EEG-ET/NDARMP372CG5/NDARMP372CG5_Video-WK_Samples_ET.mat, Diary, 60, 3782072785, 3899469108, 117396323
/Volumes/methlab_data/HBN/EEG-ET/NDARMP745EAC/NDARMP745EAC_Video1_Samples_ET.mat, Diary, 120, 4234359369, 4351755054, 117395685
/Volumes/methlab_data/HBN/EEG-ET/NDARMP745EAC/NDARMP745EAC_Video2_Samples_ET.mat, Despicable, 120, 5719889622, 5890435874, 170546252
/Volumes/methlab_data/HBN/EEG-ET/NDARMP745EAC/NDARMP745EAC_Video3_Samples_ET.mat, Fractals, 120, 6363904804, 6526891838, 162987034
/Volumes/methlab_data/HBN/EEG-ET/NDARMP745EAC/NDARMP745EAC_Video4_Samples_ET.mat, Present, 120, 7049293015, 7252355292, 203062277
/Volumes/methlab_data/HBN/EEG-ET/NDARMP784KKE/NDARMP784KKE_Video1_Samples_ET.mat, Diary, 60, 2480520825, 2597917755, 117396930
/Volumes/methlab_data/HBN/EEG-ET/NDARMP784KKE/NDARMP784KKE_Video2_Samples_ET.mat, Fractals, 60, 2876757760, 3039750824, 162993064
/Volumes/methlab_data/HBN/EEG-ET/NDARMP784KKE/NDARMP784KKE_Video3_Samples_ET.mat, Despicable, 60, 2019913492, 2190451951, 170538459
/Volumes/methlab_data/HBN/EEG-ET/NDARMP784KKE/NDARMP784KKE_Video4_Samples_ET.mat, Present, 60, 3376541661, 3579605095, 203063434
/Volumes/methlab_data/HBN/EEG-ET/NDARMP977RHZ/NDARMP977RHZ_Video1_Samples_ET.mat, Diary, 60, 2629859114, 2747249346, 117390232
/Volumes/methlab_data/HBN/EEG-ET/NDARMP977RHZ/NDARMP977RHZ_Video2_Samples_ET.mat, Fractals, 60, 3322206763, 3485196294, 162989531
/Volumes/methlab_data/HBN/EEG-ET/NDARMP977RHZ/NDARMP977RHZ_Video3_Samples_ET.mat, Despicable, 60, 3747098886, 3917640791, 170541905
/Volumes/methlab_data/HBN/EEG-ET/NDARMP977RHZ/NDARMP977RHZ_Video4_Samples_ET.mat, Present, 60, 4225876166, 4428933111, 203056945
/Volumes/methlab_data/HBN/EEG-ET/NDARMR039JV5/NDARMR039JV5_Video1_Samples_ET.mat, Diary, 60, 2058514169, 2175905287, 117391118
/Volumes/methlab_data/HBN/EEG-ET/NDARMR039JV5/NDARMR039JV5_Video3_Samples_ET.mat, Despicable, 60, 1589649199, 1760189951, 170540752
/Volumes/methlab_data/HBN/EEG-ET/NDARMR134HUY/NDARMR134HUY_Video-DM_Samples_ET.mat, Despicable, 60, 3174148251, 3344701458, 170553207
/Volumes/methlab_data/HBN/EEG-ET/NDARMR134HUY/NDARMR134HUY_Video-FF_Samples_ET.mat, Fractals, 60, 3807917817, 3970896713, 162978896
/Volumes/methlab_data/HBN/EEG-ET/NDARMR134HUY/NDARMR134HUY_Video-TP_Samples_ET.mat, Present, 60, 4355316501, 4558377634, 203061133
/Volumes/methlab_data/HBN/EEG-ET/NDARMR134HUY/NDARMR134HUY_Video-WK_Samples_ET.mat, Diary, 60, 1953416125, 2070812891, 117396766
/Volumes/methlab_data/HBN/EEG-ET/NDARMR277TT7/NDARMR277TT7_Video1_Samples_ET.mat, Diary, 60, 4521254032, 4638647769, 117393737
/Volumes/methlab_data/HBN/EEG-ET/NDARMR277TT7/NDARMR277TT7_Video3_Samples_ET.mat, Despicable, 60, 5331995291, 5502540472, 170545181
/Volumes/methlab_data/HBN/EEG-ET/NDARMR306ZKG/NDARMR306ZKG_Video1_Samples_ET.mat, Fractals, 120, 2828643107, 2991640355, 162997248
/Volumes/methlab_data/HBN/EEG-ET/NDARMR306ZKG/NDARMR306ZKG_Video2_Samples_ET.mat, Despicable, 120, 3785697481, 3956244443, 170546962
/Volumes/methlab_data/HBN/EEG-ET/NDARMR306ZKG/NDARMR306ZKG_Video3_Samples_ET.mat, Diary, 120, 4272895270, 4390291562, 117396292
/Volumes/methlab_data/HBN/EEG-ET/NDARMR306ZKG/NDARMR306ZKG_Video4_Samples_ET.mat, Present, 120, 4933830763, 5136897496, 203066733
/Volumes/methlab_data/HBN/EEG-ET/NDARMR491LM5/NDARMR491LM5_Video1_Samples_ET.mat, Diary, 60, 2018865641, 2136259204, 117393563
/Volumes/methlab_data/HBN/EEG-ET/NDARMR491LM5/NDARMR491LM5_Video3_Samples_ET.mat, Despicable, 60, 1725671980, 1896216364, 170544384
/Volumes/methlab_data/HBN/EEG-ET/NDARMR570GJ5/NDARMR570GJ5_Video1_Samples_ET.mat, Diary, 120, 3091626743, 3209023484, 117396741
/Volumes/methlab_data/HBN/EEG-ET/NDARMR570GJ5/NDARMR570GJ5_Video2_Samples_ET.mat, Fractals, 120, 4847394500, 5010381452, 162986952
/Volumes/methlab_data/HBN/EEG-ET/NDARMR570GJ5/NDARMR570GJ5_Video3_Samples_ET.mat, Despicable, 120, 6945430995, 7115973444, 170542449
/Volumes/methlab_data/HBN/EEG-ET/NDARMR570GJ5/NDARMR570GJ5_Video4_Samples_ET.mat, Present, 120, 7602611098, 7805677826, 203066728
/Volumes/methlab_data/HBN/EEG-ET/NDARMR631KR5/NDARMR631KR5_Video1_Samples_ET.mat, Diary, 60, 94173679367, 94291072222, 117392855
/Volumes/methlab_data/HBN/EEG-ET/NDARMR631KR5/NDARMR631KR5_Video2_Samples_ET.mat, Fractals, 60, 92766821720, 92929799776, 162978056
/Volumes/methlab_data/HBN/EEG-ET/NDARMR631KR5/NDARMR631KR5_Video3_Samples_ET.mat, Despicable, 60, 93695315851, 93865858202, 170542351
/Volumes/methlab_data/HBN/EEG-ET/NDARMR631KR5/NDARMR631KR5_Video4_Samples_ET.mat, Present, 60, 94708380674, 94911441932, 203061258
/Volumes/methlab_data/HBN/EEG-ET/NDARMR684AH2/NDARMR684AH2_Video1_Samples_ET.mat, Diary, 60, 4682273122, 4799662129, 117389007
/Volumes/methlab_data/HBN/EEG-ET/NDARMR684AH2/NDARMR684AH2_Video2_Samples_ET.mat, Fractals, 60, 3480016105, 3643007369, 162991264
/Volumes/methlab_data/HBN/EEG-ET/NDARMR684AH2/NDARMR684AH2_Video3_Samples_ET.mat, Despicable, 60, 4204052012, 4374592614, 170540602
/Volumes/methlab_data/HBN/EEG-ET/NDARMR684AH2/NDARMR684AH2_Video4_Samples_ET.mat, Present, 60, 5194807479, 5397878066, 203070587
/Volumes/methlab_data/HBN/EEG-ET/NDARMT064WBB/NDARMT064WBB_Video1_Samples_ET.mat, Diary, 60, 912768040, 1030159470, 117391430
/Volumes/methlab_data/HBN/EEG-ET/NDARMT064WBB/NDARMT064WBB_Video3_Samples_ET.mat, Despicable, 60, 78983897, 249537666, 170553769
/Volumes/methlab_data/HBN/EEG-ET/NDARMT271DT6/NDARMT271DT6_Video1_Samples_ET.mat, Diary, 60, 2530272731, 2647663445, 117390714
/Volumes/methlab_data/HBN/EEG-ET/NDARMT271DT6/NDARMT271DT6_Video3_Samples_ET.mat, Despicable, 60, 3740610515, 3911151694, 170541179
/Volumes/methlab_data/HBN/EEG-ET/NDARMT575KF6/NDARMT575KF6_Video-DM_Samples_ET.mat, Despicable, 30, 3714390571, 3884928857, 170538286
/Volumes/methlab_data/HBN/EEG-ET/NDARMT575KF6/NDARMT575KF6_Video-TP_Samples_ET.mat, Present, 30, 4228759346, 4432025904, 203266558
/Volumes/methlab_data/HBN/EEG-ET/NDARMT575KF6/NDARMT575KF6_Video-WK_Samples_ET.mat, Diary, 30, 2670815492, 2788202992, 117387500
/Volumes/methlab_data/HBN/EEG-ET/NDARMT661WCR/NDARMT661WCR_Video1_Samples_ET.mat, Diary, 120, 3199700497, 3317087635, 117387138
/Volumes/methlab_data/HBN/EEG-ET/NDARMT661WCR/NDARMT661WCR_Video2_Samples_ET.mat, Fractals, 120, 4391394310, 4554381307, 162986997
/Volumes/methlab_data/HBN/EEG-ET/NDARMT661WCR/NDARMT661WCR_Video3_Samples_ET.mat, Despicable, 120, 4986810015, 5157357025, 170547010
/Volumes/methlab_data/HBN/EEG-ET/NDARMT661WCR/NDARMT661WCR_Video4_Samples_ET.mat, Present, 120, 5640736327, 5843803092, 203066765
/Volumes/methlab_data/HBN/EEG-ET/NDARMT732GKM/NDARMT732GKM_Video1_Samples_ET.mat, Diary, 120, 5166967394, 5284364705, 117397311
/Volumes/methlab_data/HBN/EEG-ET/NDARMT732GKM/NDARMT732GKM_Video2_Samples_ET.mat, Fractals, 120, 6528669457, 6691655300, 162985843
/Volumes/methlab_data/HBN/EEG-ET/NDARMT732GKM/NDARMT732GKM_Video3_Samples_ET.mat, Despicable, 120, 6982747095, 7153294335, 170547240
/Volumes/methlab_data/HBN/EEG-ET/NDARMT732GKM/NDARMT732GKM_Video4_Samples_ET.mat, Present, 120, 7585061532, 7788129853, 203068321
/Volumes/methlab_data/HBN/EEG-ET/NDARMT784NED/NDARMT784NED_Video1_Samples_ET.mat, Diary, 60, 2472697907, 2590094739, 117396832
/Volumes/methlab_data/HBN/EEG-ET/NDARMT784NED/NDARMT784NED_Video3_Samples_ET.mat, Despicable, 60, 3853393087, 4023932442, 170539355
/Volumes/methlab_data/HBN/EEG-ET/NDARMT882AWE/NDARMT882AWE_Video1_Samples_ET.mat, Diary, 60, 3255674199, 3373069233, 117395034
/Volumes/methlab_data/HBN/EEG-ET/NDARMT882AWE/NDARMT882AWE_Video2_Samples_ET.mat, Fractals, 60, 2271306967, 2434291314, 162984347
/Volumes/methlab_data/HBN/EEG-ET/NDARMT882AWE/NDARMT882AWE_Video3_Samples_ET.mat, Despicable, 60, 2917007701, 3087549332, 170541631
/Volumes/methlab_data/HBN/EEG-ET/NDARMT882AWE/NDARMT882AWE_Video4_Samples_ET.mat, Present, 60, 3680281575, 3883364161, 203082586
/Volumes/methlab_data/HBN/EEG-ET/NDARMT898BME/NDARMT898BME_Video1_Samples_ET.mat, Diary, 60, 2093939712, 2211329611, 117389899
/Volumes/methlab_data/HBN/EEG-ET/NDARMT898BME/NDARMT898BME_Video3_Samples_ET.mat, Despicable, 60, 3494609542, 3665160914, 170551372
/Volumes/methlab_data/HBN/EEG-ET/NDARMT939UCK/NDARMT939UCK_Video-DM_Samples_ET.mat, Despicable, 120, 6373496566, 6544042106, 170545540
/Volumes/methlab_data/HBN/EEG-ET/NDARMT939UCK/NDARMT939UCK_Video-FF_Samples_ET.mat, Fractals, 120, 6624774939, 6787760880, 162985941
/Volumes/methlab_data/HBN/EEG-ET/NDARMT939UCK/NDARMT939UCK_Video-TP_Samples_ET.mat, Present, 120, 7034530823, 7237598043, 203067220
/Volumes/methlab_data/HBN/EEG-ET/NDARMT939UCK/NDARMT939UCK_Video-WK_Samples_ET.mat, Diary, 120, 6828362192, 6945759591, 117397399
/Volumes/methlab_data/HBN/EEG-ET/NDARMU053YEU/NDARMU053YEU_Video1_Samples_ET.mat, Diary, 60, 4030726305, 4148121344, 117395039
/Volumes/methlab_data/HBN/EEG-ET/NDARMU053YEU/NDARMU053YEU_Video3_Samples_ET.mat, Despicable, 60, 3604211631, 3774752276, 170540645
/Volumes/methlab_data/HBN/EEG-ET/NDARMU161LHN/NDARMU161LHN_Video1_Samples_ET.mat, Diary, 120, 3178066403, 3295463425, 117397022
/Volumes/methlab_data/HBN/EEG-ET/NDARMU161LHN/NDARMU161LHN_Video2_Samples_ET.mat, Fractals, 120, 4312889205, 4475876896, 162987691
/Volumes/methlab_data/HBN/EEG-ET/NDARMU161LHN/NDARMU161LHN_Video3_Samples_ET.mat, Despicable, 120, 5059175480, 5229722942, 170547462
/Volumes/methlab_data/HBN/EEG-ET/NDARMU161LHN/NDARMU161LHN_Video4_Samples_ET.mat, Present, 120, 5710012164, 5913089651, 203077487
/Volumes/methlab_data/HBN/EEG-ET/NDARMU269TFY/NDARMU269TFY_Video1_Samples_ET.mat, Diary, 60, 980602149, 1097995291, 117393142
/Volumes/methlab_data/HBN/EEG-ET/NDARMU280FXT/NDARMU280FXT_Video-DM_Samples_ET.mat, Despicable, 30, 3134015767, 3304549227, 170533460
/Volumes/methlab_data/HBN/EEG-ET/NDARMU280FXT/NDARMU280FXT_Video-TP_Samples_ET.mat, Present, 30, 4064032619, 4267303215, 203270596
/Volumes/methlab_data/HBN/EEG-ET/NDARMU280FXT/NDARMU280FXT_Video-WK_Samples_ET.mat, Diary, 30, 3574549930, 3691934836, 117384906
/Volumes/methlab_data/HBN/EEG-ET/NDARMU518TVN/NDARMU518TVN_Video-DM_Samples_ET.mat, Despicable, 60, 2214190032, 2384734585, 170544553
/Volumes/methlab_data/HBN/EEG-ET/NDARMU518TVN/NDARMU518TVN_Video-FF_Samples_ET.mat, Fractals, 60, 1746586615, 1909569811, 162983196
/Volumes/methlab_data/HBN/EEG-ET/NDARMU518TVN/NDARMU518TVN_Video-TP_Samples_ET.mat, Present, 60, 3080732428, 3283801901, 203069473
/Volumes/methlab_data/HBN/EEG-ET/NDARMU518TVN/NDARMU518TVN_Video-WK_Samples_ET.mat, Diary, 60, 2657467273, 2774861264, 117393991
/Volumes/methlab_data/HBN/EEG-ET/NDARMU589LP6/NDARMU589LP6_Video-DM_Samples_ET.mat, Despicable, 60, 4305564684, 4476109301, 170544617
/Volumes/methlab_data/HBN/EEG-ET/NDARMU589LP6/NDARMU589LP6_Video-FF_Samples_ET.mat, Fractals, 60, 3710795196, 3873781453, 162986257
/Volumes/methlab_data/HBN/EEG-ET/NDARMU589LP6/NDARMU589LP6_Video-TP_Samples_ET.mat, Present, 60, 4685091050, 4888204643, 203113593
/Volumes/methlab_data/HBN/EEG-ET/NDARMU589LP6/NDARMU589LP6_Video-WK_Samples_ET.mat, Diary, 60, 4515598183, 4632992204, 117394021
/Volumes/methlab_data/HBN/EEG-ET/NDARMU791UN7/NDARMU791UN7_Video-DM_Samples_ET.mat, Despicable, 120, 5207514107, 5378060316, 170546209
/Volumes/methlab_data/HBN/EEG-ET/NDARMU791UN7/NDARMU791UN7_Video-FF_Samples_ET.mat, Fractals, 120, 5791368854, 5954356574, 162987720
/Volumes/methlab_data/HBN/EEG-ET/NDARMU791UN7/NDARMU791UN7_Video-TP_Samples_ET.mat, Present, 120, 5994718752, 6197785525, 203066773
/Volumes/methlab_data/HBN/EEG-ET/NDARMU791UN7/NDARMU791UN7_Video-WK_Samples_ET.mat, Diary, 120, 5634800426, 5752197805, 117397379
/Volumes/methlab_data/HBN/EEG-ET/NDARMV189NXG/NDARMV189NXG_Video-DM_Samples_ET.mat, Despicable, 60, 7244905907, 7415457738, 170551831
/Volumes/methlab_data/HBN/EEG-ET/NDARMV189NXG/NDARMV189NXG_Video-FF_Samples_ET.mat, Fractals, 60, 6797052714, 6960042163, 162989449
/Volumes/methlab_data/HBN/EEG-ET/NDARMV189NXG/NDARMV189NXG_Video-TP_Samples_ET.mat, Present, 60, 7800007100, 8003078997, 203071897
/Volumes/methlab_data/HBN/EEG-ET/NDARMV189NXG/NDARMV189NXG_Video-WK_Samples_ET.mat, Diary, 60, 6113602563, 6230996731, 117394168
/Volumes/methlab_data/HBN/EEG-ET/NDARMV247HRA/NDARMV247HRA_Video1_Samples_ET.mat, Diary, 60, 2903963982, 3021357912, 117393930
/Volumes/methlab_data/HBN/EEG-ET/NDARMV247HRA/NDARMV247HRA_Video3_Samples_ET.mat, Despicable, 60, 3929339186, 4099884654, 170545468
/Volumes/methlab_data/HBN/EEG-ET/NDARMV410ZFY/NDARMV410ZFY_Video3_Samples_ET.mat, Despicable, 60, 3414359797, 3584904305, 170544508
/Volumes/methlab_data/HBN/EEG-ET/NDARMV575DC1/NDARMV575DC1_Video1_Samples_ET.mat, Diary, 60, 3601199688, 3718594668, 117394980
/Volumes/methlab_data/HBN/EEG-ET/NDARMV575DC1/NDARMV575DC1_Video3_Samples_ET.mat, Despicable, 60, 3164039791, 3334581290, 170541499
/Volumes/methlab_data/HBN/EEG-ET/NDARMV575DC1/NDARMV575DC1_Video4_Samples_ET.mat, Present, 60, 4113173474, 4316237985, 203064511
/Volumes/methlab_data/HBN/EEG-ET/NDARMV822KWR/NDARMV822KWR_Video1_Samples_ET.mat, Despicable, 120, 5259001925, 5429548516, 170546591
/Volumes/methlab_data/HBN/EEG-ET/NDARMV822KWR/NDARMV822KWR_Video2_Samples_ET.mat, Diary, 120, 6593245161, 6710641386, 117396225
/Volumes/methlab_data/HBN/EEG-ET/NDARMV822KWR/NDARMV822KWR_Video3_Samples_ET.mat, Fractals, 120, 7105987471, 7268971292, 162983821
/Volumes/methlab_data/HBN/EEG-ET/NDARMV822KWR/NDARMV822KWR_Video4_Samples_ET.mat, Present, 120, 7760056884, 7963123974, 203067090
/Volumes/methlab_data/HBN/EEG-ET/NDARMV981GZ7/NDARMV981GZ7_Video1_Samples_ET.mat, Diary, 60, 4998598240, 5115990219, 117391979
/Volumes/methlab_data/HBN/EEG-ET/NDARMV981GZ7/NDARMV981GZ7_Video2_Samples_ET.mat, Fractals, 60, 5382813730, 5545797929, 162984199
/Volumes/methlab_data/HBN/EEG-ET/NDARMV981GZ7/NDARMV981GZ7_Video3_Samples_ET.mat, Despicable, 60, 3909526662, 4080069194, 170542532
/Volumes/methlab_data/HBN/EEG-ET/NDARMV981GZ7/NDARMV981GZ7_Video4_Samples_ET.mat, Present, 60, 5866240353, 6069311025, 203070672
/Volumes/methlab_data/HBN/EEG-ET/NDARMW088NNR/NDARMW088NNR_Video1_Samples_ET.mat, Diary, 60, 5034766274, 5152161213, 117394939
/Volumes/methlab_data/HBN/EEG-ET/NDARMW088NNR/NDARMW088NNR_Video2_Samples_ET.mat, Fractals, 60, 5695904233, 5858894369, 162990136
/Volumes/methlab_data/HBN/EEG-ET/NDARMW088NNR/NDARMW088NNR_Video3_Samples_ET.mat, Despicable, 60, 6120730283, 6291271757, 170541474
/Volumes/methlab_data/HBN/EEG-ET/NDARMW088NNR/NDARMW088NNR_Video4_Samples_ET.mat, Present, 60, 6590132810, 6793192250, 203059440
/Volumes/methlab_data/HBN/EEG-ET/NDARMW178UDD/NDARMW178UDD_Video1_Samples_ET.mat, Diary, 60, 5336264958, 5453662024, 117397066
/Volumes/methlab_data/HBN/EEG-ET/NDARMW178UDD/NDARMW178UDD_Video3_Samples_ET.mat, Despicable, 60, 4903388799, 5073931447, 170542648
/Volumes/methlab_data/HBN/EEG-ET/NDARMW252AJW/NDARMW252AJW_Video1_Samples_ET.mat, Diary, 60, 3901205434, 4018601418, 117395984
/Volumes/methlab_data/HBN/EEG-ET/NDARMW252AJW/NDARMW252AJW_Video3_Samples_ET.mat, Despicable, 60, 2748226274, 2918768819, 170542545
/Volumes/methlab_data/HBN/EEG-ET/NDARMW445NBC/NDARMW445NBC_Video-DM_Samples_ET.mat, Despicable, 120, 5626583629, 5797131096, 170547467
/Volumes/methlab_data/HBN/EEG-ET/NDARMW445NBC/NDARMW445NBC_Video-FF_Samples_ET.mat, Fractals, 120, 6012460014, 6175447533, 162987519
/Volumes/methlab_data/HBN/EEG-ET/NDARMW445NBC/NDARMW445NBC_Video-TP_Samples_ET.mat, Present, 120, 6220568435, 6423632274, 203063839
/Volumes/methlab_data/HBN/EEG-ET/NDARMW445NBC/NDARMW445NBC_Video-WK_Samples_ET.mat, Diary, 120, 5850971172, 5968369043, 117397871
/Volumes/methlab_data/HBN/EEG-ET/NDARMW473LL1/NDARMW473LL1_Video-DM_Samples_ET.mat, Despicable, 60, 4151286346, 4321827754, 170541408
/Volumes/methlab_data/HBN/EEG-ET/NDARMW473LL1/NDARMW473LL1_Video-FF_Samples_ET.mat, Fractals, 60, 3528216497, 3691199571, 162983074
/Volumes/methlab_data/HBN/EEG-ET/NDARMW473LL1/NDARMW473LL1_Video-TP_Samples_ET.mat, Present, 60, 4847651935, 5050715308, 203063373
/Volumes/methlab_data/HBN/EEG-ET/NDARMW473LL1/NDARMW473LL1_Video-WK_Samples_ET.mat, Diary, 60, 4409417593, 4526810479, 117392886
/Volumes/methlab_data/HBN/EEG-ET/NDARMW551YA0/NDARMW551YA0_Video-DM_Samples_ET.mat, Despicable, 120, 3503774654, 3674322350, 170547696
/Volumes/methlab_data/HBN/EEG-ET/NDARMW551YA0/NDARMW551YA0_Video-FF_Samples_ET.mat, Fractals, 120, 2648069901, 2811056543, 162986642
/Volumes/methlab_data/HBN/EEG-ET/NDARMW551YA0/NDARMW551YA0_Video-TP_Samples_ET.mat, Present, 120, 4597928369, 4800994954, 203066585
/Volumes/methlab_data/HBN/EEG-ET/NDARMW551YA0/NDARMW551YA0_Video-WK_Samples_ET.mat, Diary, 120, 3968311517, 4085709300, 117397783
/Volumes/methlab_data/HBN/EEG-ET/NDARMW863HW5/NDARMW863HW5_Video-DM_Samples_ET.mat, Despicable, 120, 8049890172, 8220432656, 170542484
/Volumes/methlab_data/HBN/EEG-ET/NDARMW863HW5/NDARMW863HW5_Video-FF_Samples_ET.mat, Fractals, 120, 7615305731, 7778292325, 162986594
/Volumes/methlab_data/HBN/EEG-ET/NDARMW863HW5/NDARMW863HW5_Video-TP_Samples_ET.mat, Present, 120, 8679832715, 8882896855, 203064140
/Volumes/methlab_data/HBN/EEG-ET/NDARMW863HW5/NDARMW863HW5_Video-WK_Samples_ET.mat, Diary, 120, 6991228342, 7108625887, 117397545
/Volumes/methlab_data/HBN/EEG-ET/NDARMX215YPN/NDARMX215YPN_Video-DM_Samples_ET.mat, Despicable, 60, 2955146459, 3125685870, 170539411
/Volumes/methlab_data/HBN/EEG-ET/NDARMX215YPN/NDARMX215YPN_Video-TP_Samples_ET.mat, Present, 60, 3437951261, 3641228786, 203277525
/Volumes/methlab_data/HBN/EEG-ET/NDARMX215YPN/NDARMX215YPN_Video-WK_Samples_ET.mat, Diary, 60, 2081435639, 2198824539, 117388900
/Volumes/methlab_data/HBN/EEG-ET/NDARMX277VHC/NDARMX277VHC_Video-DM_Samples_ET.mat, Despicable, 60, 3925609745, 4096156448, 170546703
/Volumes/methlab_data/HBN/EEG-ET/NDARMX277VHC/NDARMX277VHC_Video-FF_Samples_ET.mat, Fractals, 60, 4362525928, 4525507283, 162981355
/Volumes/methlab_data/HBN/EEG-ET/NDARMX277VHC/NDARMX277VHC_Video-TP_Samples_ET.mat, Present, 60, 4835518624, 5038578335, 203059711
/Volumes/methlab_data/HBN/EEG-ET/NDARMX277VHC/NDARMX277VHC_Video-WK_Samples_ET.mat, Diary, 60, 3243774260, 3361166364, 117392104
/Volumes/methlab_data/HBN/EEG-ET/NDARMX328VWC/NDARMX328VWC_Video-DM_Samples_ET.mat, Despicable, 60, 4210223915, 4380765752, 170541837
/Volumes/methlab_data/HBN/EEG-ET/NDARMX328VWC/NDARMX328VWC_Video-FF_Samples_ET.mat, Fractals, 60, 4636623492, 4799611803, 162988311
/Volumes/methlab_data/HBN/EEG-ET/NDARMX328VWC/NDARMX328VWC_Video-TP_Samples_ET.mat, Present, 60, 4856559048, 5059626718, 203067670
/Volumes/methlab_data/HBN/EEG-ET/NDARMX328VWC/NDARMX328VWC_Video-WK_Samples_ET.mat, Diary, 60, 4471766913, 4589160952, 117394039
/Volumes/methlab_data/HBN/EEG-ET/NDARMX482GWR/NDARMX482GWR_Video-DM_Samples_ET.mat, Despicable, 60, 3204055258, 3374589960, 170534702
/Volumes/methlab_data/HBN/EEG-ET/NDARMX482GWR/NDARMX482GWR_Video-TP_Samples_ET.mat, Present, 60, 4189654694, 4392921545, 203266851
/Volumes/methlab_data/HBN/EEG-ET/NDARMX482GWR/NDARMX482GWR_Video-WK_Samples_ET.mat, Diary, 60, 3802097567, 3919485584, 117388017
/Volumes/methlab_data/HBN/EEG-ET/NDARMX835PGE/NDARMX835PGE_Video-DM_Samples_ET.mat, Despicable, 60, 1545247585, 1715790230, 170542645
/Volumes/methlab_data/HBN/EEG-ET/NDARMX835PGE/NDARMX835PGE_Video-FF_Samples_ET.mat, Fractals, 60, 1817077848, 1980062142, 162984294
/Volumes/methlab_data/HBN/EEG-ET/NDARMX835PGE/NDARMX835PGE_Video-TP_Samples_ET.mat, Present, 60, 2239757788, 2442824428, 203066640
/Volumes/methlab_data/HBN/EEG-ET/NDARMX835PGE/NDARMX835PGE_Video-WK_Samples_ET.mat, Diary, 60, 2049679353, 2167075419, 117396066
/Volumes/methlab_data/HBN/EEG-ET/NDARMY254BGN/NDARMY254BGN_Video1_Samples_ET.mat, Diary, 60, 3974788340, 4092182328, 117393988
/Volumes/methlab_data/HBN/EEG-ET/NDARMY254BGN/NDARMY254BGN_Video2_Samples_ET.mat, Fractals, 60, 4732476775, 4895465000, 162988225
/Volumes/methlab_data/HBN/EEG-ET/NDARMY254BGN/NDARMY254BGN_Video3_Samples_ET.mat, Despicable, 60, 5190015075, 5360557614, 170542539
/Volumes/methlab_data/HBN/EEG-ET/NDARMY254BGN/NDARMY254BGN_Video4_Samples_ET.mat, Present, 60, 5668468184, 5871532685, 203064501
/Volumes/methlab_data/HBN/EEG-ET/NDARMY291ZPH/NDARMY291ZPH_Video-DM_Samples_ET.mat, Despicable, 60, 75113239716, 75283787363, 170547647
/Volumes/methlab_data/HBN/EEG-ET/NDARMY291ZPH/NDARMY291ZPH_Video-FF_Samples_ET.mat, Fractals, 60, 74356313355, 74519301670, 162988315
/Volumes/methlab_data/HBN/EEG-ET/NDARMY291ZPH/NDARMY291ZPH_Video-TP_Samples_ET.mat, Present, 60, 76035424964, 76238494622, 203069658
/Volumes/methlab_data/HBN/EEG-ET/NDARMY291ZPH/NDARMY291ZPH_Video-WK_Samples_ET.mat, Diary, 60, 75592472667, 75709861715, 117389048
/Volumes/methlab_data/HBN/EEG-ET/NDARMY294VNE/NDARMY294VNE_Video-DM_Samples_ET.mat, Despicable, 60, 3339206494, 3509751172, 170544678
/Volumes/methlab_data/HBN/EEG-ET/NDARMY294VNE/NDARMY294VNE_Video-FF_Samples_ET.mat, Fractals, 60, 2737558739, 2900540086, 162981347
/Volumes/methlab_data/HBN/EEG-ET/NDARMY294VNE/NDARMY294VNE_Video-TP_Samples_ET.mat, Present, 60, 4292615130, 4495675852, 203060722
/Volumes/methlab_data/HBN/EEG-ET/NDARMY294VNE/NDARMY294VNE_Video-WK_Samples_ET.mat, Diary, 60, 3826400244, 3943794331, 117394087
/Volumes/methlab_data/HBN/EEG-ET/NDARMY456WML/NDARMY456WML_Video1_Samples_ET.mat, Fractals, 120, 4012968536, 4175954053, 162985517
/Volumes/methlab_data/HBN/EEG-ET/NDARMY456WML/NDARMY456WML_Video2_Samples_ET.mat, Despicable, 120, 5244090561, 5414637602, 170547041
/Volumes/methlab_data/HBN/EEG-ET/NDARMY456WML/NDARMY456WML_Video3_Samples_ET.mat, Diary, 120, 5763727480, 5881124895, 117397415
/Volumes/methlab_data/HBN/EEG-ET/NDARMY456WML/NDARMY456WML_Video4_Samples_ET.mat, Present, 120, 6377065030, 6580131865, 203066835
/Volumes/methlab_data/HBN/EEG-ET/NDARMY533CYM/NDARMY533CYM_Video1_Samples_ET.mat, Diary, 60, 2284493466, 2401894474, 117401008
/Volumes/methlab_data/HBN/EEG-ET/NDARMY533CYM/NDARMY533CYM_Video3_Samples_ET.mat, Despicable, 60, 3693399580, 3863950160, 170550580
/Volumes/methlab_data/HBN/EEG-ET/NDARMY873XG5/NDARMY873XG5_Video-DM_Samples_ET.mat, Despicable, 120, 4163035792, 4333582831, 170547039
/Volumes/methlab_data/HBN/EEG-ET/NDARMY873XG5/NDARMY873XG5_Video-FF_Samples_ET.mat, Fractals, 120, 3370709559, 3533707461, 162997902
/Volumes/methlab_data/HBN/EEG-ET/NDARMY873XG5/NDARMY873XG5_Video-TP_Samples_ET.mat, Present, 120, 5223498868, 5426576581, 203077713
/Volumes/methlab_data/HBN/EEG-ET/NDARMY873XG5/NDARMY873XG5_Video-WK_Samples_ET.mat, Diary, 120, 4618431968, 4735830104, 117398136
/Volumes/methlab_data/HBN/EEG-ET/NDARMY967HNA/NDARMY967HNA_Video1_Samples_ET.mat, Diary, 60, 1973315874, 2090708910, 117393036
/Volumes/methlab_data/HBN/EEG-ET/NDARMY967HNA/NDARMY967HNA_Video3_Samples_ET.mat, Despicable, 60, 3712069704, 3882613285, 170543581
/Volumes/methlab_data/HBN/EEG-ET/NDARMZ119VPH/NDARMZ119VPH_Video-DM_Samples_ET.mat, Despicable, 60, 3924052793, 4094594925, 170542132
/Volumes/methlab_data/HBN/EEG-ET/NDARMZ119VPH/NDARMZ119VPH_Video-FF_Samples_ET.mat, Fractals, 60, 4620789507, 4783786254, 162996747
/Volumes/methlab_data/HBN/EEG-ET/NDARMZ119VPH/NDARMZ119VPH_Video-TP_Samples_ET.mat, Present, 60, 5246701922, 5449773116, 203071194
/Volumes/methlab_data/HBN/EEG-ET/NDARMZ119VPH/NDARMZ119VPH_Video-WK_Samples_ET.mat, Diary, 60, 3082868523, 3200261904, 117393381
/Volumes/methlab_data/HBN/EEG-ET/NDARMZ189EFC/NDARMZ189EFC_Video1_Samples_ET.mat, Diary, 120, 6052486955, 6169874413, 117387458
/Volumes/methlab_data/HBN/EEG-ET/NDARMZ189EFC/NDARMZ189EFC_Video2_Samples_ET.mat, Fractals, 120, 6753613267, 6916600289, 162987022
/Volumes/methlab_data/HBN/EEG-ET/NDARMZ189EFC/NDARMZ189EFC_Video3_Samples_ET.mat, Despicable, 120, 7249010465, 7419557793, 170547328
/Volumes/methlab_data/HBN/EEG-ET/NDARMZ189EFC/NDARMZ189EFC_Video4_Samples_ET.mat, Present, 120, 7941625682, 8144693238, 203067556
/Volumes/methlab_data/HBN/EEG-ET/NDARMZ200GVD/NDARMZ200GVD_Video1_Samples_ET.mat, Diary, 120, 2953879608, 3071265684, 117386076
/Volumes/methlab_data/HBN/EEG-ET/NDARMZ200GVD/NDARMZ200GVD_Video2_Samples_ET.mat, Despicable, 120, 4198266629, 4368814586, 170547957
/Volumes/methlab_data/HBN/EEG-ET/NDARMZ200GVD/NDARMZ200GVD_Video3_Samples_ET.mat, Fractals, 120, 5034281591, 5197265285, 162983694
/Volumes/methlab_data/HBN/EEG-ET/NDARMZ200GVD/NDARMZ200GVD_Video4_Samples_ET.mat, Present, 120, 5809392888, 6012454656, 203061768
/Volumes/methlab_data/HBN/EEG-ET/NDARMZ366UY8/NDARMZ366UY8_Video-DM_Samples_ET.mat, Despicable, 60, 3786557177, 3957095928, 170538751
/Volumes/methlab_data/HBN/EEG-ET/NDARMZ366UY8/NDARMZ366UY8_Video-FF_Samples_ET.mat, Fractals, 60, 4313351131, 4476340555, 162989424
/Volumes/methlab_data/HBN/EEG-ET/NDARMZ366UY8/NDARMZ366UY8_Video-TP_Samples_ET.mat, Present, 60, 4789165016, 4992232786, 203067770
/Volumes/methlab_data/HBN/EEG-ET/NDARMZ366UY8/NDARMZ366UY8_Video-WK_Samples_ET.mat, Diary, 60, 3113510686, 3230898827, 117388141
/Volumes/methlab_data/HBN/EEG-ET/NDARMZ477MNH/NDARMZ477MNH_Video-DM_Samples_ET.mat, Despicable, 120, 6231406514, 6401951470, 170544956
/Volumes/methlab_data/HBN/EEG-ET/NDARMZ477MNH/NDARMZ477MNH_Video-FF_Samples_ET.mat, Fractals, 120, 5498617732, 5661614261, 162996529
/Volumes/methlab_data/HBN/EEG-ET/NDARMZ477MNH/NDARMZ477MNH_Video-TP_Samples_ET.mat, Present, 120, 7275283461, 7478344827, 203061366
/Volumes/methlab_data/HBN/EEG-ET/NDARMZ477MNH/NDARMZ477MNH_Video-WK_Samples_ET.mat, Diary, 120, 6687529380, 6804927042, 117397662
/Volumes/methlab_data/HBN/EEG-ET/NDARMZ518UH1/NDARMZ518UH1_Video1_Samples_ET.mat, Diary, 120, 3531382503, 3648779019, 117396516
/Volumes/methlab_data/HBN/EEG-ET/NDARMZ518UH1/NDARMZ518UH1_Video2_Samples_ET.mat, Fractals, 120, 5018020213, 5181007946, 162987733
/Volumes/methlab_data/HBN/EEG-ET/NDARMZ518UH1/NDARMZ518UH1_Video3_Samples_ET.mat, Despicable, 120, 5626087766, 5796629581, 170541815
/Volumes/methlab_data/HBN/EEG-ET/NDARMZ518UH1/NDARMZ518UH1_Video4_Samples_ET.mat, Present, 120, 6281843118, 6484910631, 203067513
/Volumes/methlab_data/HBN/EEG-ET/NDARMZ687XRR/NDARMZ687XRR_Video1_Samples_ET.mat, Diary, 120, 3155242197, 3272640007, 117397810
/Volumes/methlab_data/HBN/EEG-ET/NDARMZ687XRR/NDARMZ687XRR_Video2_Samples_ET.mat, Fractals, 120, 3997566287, 4160574242, 163007955
/Volumes/methlab_data/HBN/EEG-ET/NDARMZ687XRR/NDARMZ687XRR_Video3_Samples_ET.mat, Despicable, 120, 4452554250, 4623101767, 170547517
/Volumes/methlab_data/HBN/EEG-ET/NDARMZ687XRR/NDARMZ687XRR_Video4_Samples_ET.mat, Present, 120, 5137800353, 5340867474, 203067121
/Volumes/methlab_data/HBN/EEG-ET/NDARMZ790VHM/NDARMZ790VHM_Video-DM_Samples_ET.mat, Despicable, 60, 5379577504, 5550121179, 170543675
/Volumes/methlab_data/HBN/EEG-ET/NDARMZ790VHM/NDARMZ790VHM_Video-FF_Samples_ET.mat, Fractals, 60, 4911164349, 5074147596, 162983247
/Volumes/methlab_data/HBN/EEG-ET/NDARMZ790VHM/NDARMZ790VHM_Video-TP_Samples_ET.mat, Present, 60, 5909591278, 6112660835, 203069557
/Volumes/methlab_data/HBN/EEG-ET/NDARMZ790VHM/NDARMZ790VHM_Video-WK_Samples_ET.mat, Diary, 60, 4221096473, 4338491490, 117395017
/Volumes/methlab_data/HBN/EEG-ET/NDARMZ908DUR/NDARMZ908DUR_Video1_Samples_ET.mat, Diary, 60, 1982354384, 2099750392, 117396008
/Volumes/methlab_data/HBN/EEG-ET/NDARMZ908DUR/NDARMZ908DUR_Video3_Samples_ET.mat, Despicable, 60, 2733250269, 2903789867, 170539598
/Volumes/methlab_data/HBN/EEG-ET/NDARMZ936WYB/NDARMZ936WYB_Video-DM_Samples_ET.mat, Despicable, 30, 4436921697, 4607457292, 170535595
/Volumes/methlab_data/HBN/EEG-ET/NDARMZ936WYB/NDARMZ936WYB_Video-TP_Samples_ET.mat, Present, 30, 5372659273, 5575938999, 203279726
/Volumes/methlab_data/HBN/EEG-ET/NDARMZ936WYB/NDARMZ936WYB_Video-WK_Samples_ET.mat, Diary, 30, 4901935506, 5019323488, 117387982
/Volumes/methlab_data/HBN/EEG-ET/NDARNA004AGP/NDARNA004AGP_Video-DM_Samples_ET.mat, Despicable, 120, 1848869147, 2019417240, 170548093
/Volumes/methlab_data/HBN/EEG-ET/NDARNA004AGP/NDARNA004AGP_Video-FF_Samples_ET.mat, Fractals, 120, 2355062473, 2518053859, 162991386
/Volumes/methlab_data/HBN/EEG-ET/NDARNA004AGP/NDARNA004AGP_Video-TP_Samples_ET.mat, Present, 120, 2633362968, 2836432113, 203069145
/Volumes/methlab_data/HBN/EEG-ET/NDARNA004AGP/NDARNA004AGP_Video-WK_Samples_ET.mat, Diary, 120, 2168611095, 2285998552, 117387457
/Volumes/methlab_data/HBN/EEG-ET/NDARNA055LLN/NDARNA055LLN_Video-DM_Samples_ET.mat, Despicable, 30, 4334697291, 4505233921, 170536630
/Volumes/methlab_data/HBN/EEG-ET/NDARNA055LLN/NDARNA055LLN_Video-TP_Samples_ET.mat, Present, 30, 5202076764, 5405353553, 203276789
/Volumes/methlab_data/HBN/EEG-ET/NDARNA055LLN/NDARNA055LLN_Video-WK_Samples_ET.mat, Diary, 30, 4770807751, 4888189785, 117382034
/Volumes/methlab_data/HBN/EEG-ET/NDARNA335GX2/NDARNA335GX2_Video1_Samples_ET.mat, Despicable, 120, 4792780830, 4873098563, 5043646800
2.508660e+08, 1.705482e+08, /Volumes/methlab_data/HBN/EEG-ET/NDARNA335GX2/NDARNA335GX2_Video2_Samples_ET.mat, Fractals, 120, 6085552472, 6248549111, 162996639
/Volumes/methlab_data/HBN/EEG-ET/NDARNA335GX2/NDARNA335GX2_Video3_Samples_ET.mat, Diary, 120, 6594440131, 6711836744, 117396613
/Volumes/methlab_data/HBN/EEG-ET/NDARNA335GX2/NDARNA335GX2_Video4_Samples_ET.mat, Present, 120, 7201755898, 7404832797, 203076899
/Volumes/methlab_data/HBN/EEG-ET/NDARNA354MGW/NDARNA354MGW_Video-DM_Samples_ET.mat, Despicable, 30, 5360333739, 5530873213, 170539474
/Volumes/methlab_data/HBN/EEG-ET/NDARNA354MGW/NDARNA354MGW_Video-TP_Samples_ET.mat, Present, 30, 5886148119, 6089416709, 203268590
/Volumes/methlab_data/HBN/EEG-ET/NDARNA354MGW/NDARNA354MGW_Video-WK_Samples_ET.mat, Diary, 30, 4151949257, 4269338248, 117388991
/Volumes/methlab_data/HBN/EEG-ET/NDARNA421FL7/NDARNA421FL7_Video-DM_Samples_ET.mat, Despicable, 60, 6073590208, 6244141495, 170551287
/Volumes/methlab_data/HBN/EEG-ET/NDARNA421FL7/NDARNA421FL7_Video-FF_Samples_ET.mat, Fractals, 60, 5604708548, 5767698509, 162989961
/Volumes/methlab_data/HBN/EEG-ET/NDARNA421FL7/NDARNA421FL7_Video-TP_Samples_ET.mat, Present, 60, 6558872452, 6761941668, 203069216
/Volumes/methlab_data/HBN/EEG-ET/NDARNA421FL7/NDARNA421FL7_Video-WK_Samples_ET.mat, Diary, 60, 5037595597, 5154986413, 117390816
/Volumes/methlab_data/HBN/EEG-ET/NDARNA660PPK/NDARNA660PPK_Video-DM_Samples_ET.mat, Despicable, 120, 2855974545, 3026522459, 170547914
/Volumes/methlab_data/HBN/EEG-ET/NDARNA660PPK/NDARNA660PPK_Video-FF_Samples_ET.mat, Fractals, 120, 2646685655, 2809671423, 162985768
/Volumes/methlab_data/HBN/EEG-ET/NDARNA660PPK/NDARNA660PPK_Video-TP_Samples_ET.mat, Present, 120, 3398821468, 3601888865, 203067397
/Volumes/methlab_data/HBN/EEG-ET/NDARNA660PPK/NDARNA660PPK_Video-WK_Samples_ET.mat, Diary, 120, 2284571318, 2401964200, 117392882
/Volumes/methlab_data/HBN/EEG-ET/NDARNA768ZAK/NDARNA768ZAK_Video1_Samples_ET.mat, Fractals, 120, 3950309991, 4113306374, 162996383
/Volumes/methlab_data/HBN/EEG-ET/NDARNA768ZAK/NDARNA768ZAK_Video2_Samples_ET.mat, Despicable, 120, 4864733169, 5035281218, 170548049
/Volumes/methlab_data/HBN/EEG-ET/NDARNA768ZAK/NDARNA768ZAK_Video3_Samples_ET.mat, Diary, 120, 5479251432, 5596647673, 117396241
/Volumes/methlab_data/HBN/EEG-ET/NDARNA768ZAK/NDARNA768ZAK_Video4_Samples_ET.mat, Present, 120, 6174236858, 6377302791, 203065933
/Volumes/methlab_data/HBN/EEG-ET/NDARNA856AY1/NDARNA856AY1_Video1_Samples_ET.mat, Despicable, 120, 632244074, 702513230, 873060179
2.408161e+08, 1.705469e+08, /Volumes/methlab_data/HBN/EEG-ET/NDARNA856AY1/NDARNA856AY1_Video2_Samples_ET.mat, Fractals, 120, 920341153, 1083328302, 162987149
/Volumes/methlab_data/HBN/EEG-ET/NDARNA856AY1/NDARNA856AY1_Video3_Samples_ET.mat, Diary, 120, 1155709875, 1273107496, 117397621
/Volumes/methlab_data/HBN/EEG-ET/NDARNA856AY1/NDARNA856AY1_Video4_Samples_ET.mat, Present, 120, 1317410185, 1520476075, 203065890
/Volumes/methlab_data/HBN/EEG-ET/NDARNB032ZLC/NDARNB032ZLC_Video-DM_Samples_ET.mat, Despicable, 30, 2929979247, 3100526828, 170547581
/Volumes/methlab_data/HBN/EEG-ET/NDARNB032ZLC/NDARNB032ZLC_Video-TP_Samples_ET.mat, Present, 30, 3878652956, 4081930692, 203277736
/Volumes/methlab_data/HBN/EEG-ET/NDARNB032ZLC/NDARNB032ZLC_Video-WK_Samples_ET.mat, Diary, 30, 3405465424, 3522852423, 117386999
/Volumes/methlab_data/HBN/EEG-ET/NDARNB390JL3/NDARNB390JL3_Video-DM_Samples_ET.mat, Despicable, 60, 4521483160, 4692025554, 170542394
/Volumes/methlab_data/HBN/EEG-ET/NDARNB390JL3/NDARNB390JL3_Video-FF_Samples_ET.mat, Fractals, 60, 4066898236, 4229890310, 162992074
/Volumes/methlab_data/HBN/EEG-ET/NDARNB390JL3/NDARNB390JL3_Video-TP_Samples_ET.mat, Present, 60, 5055445081, 5258503448, 203058367
/Volumes/methlab_data/HBN/EEG-ET/NDARNB390JL3/NDARNB390JL3_Video-WK_Samples_ET.mat, Diary, 60, 3496228388, 3613624287, 117395899
/Volumes/methlab_data/HBN/EEG-ET/NDARNB427ARE/NDARNB427ARE_Video-DM_Samples_ET.mat, Despicable, 60, 4820531309, 4991073591, 170542282
/Volumes/methlab_data/HBN/EEG-ET/NDARNB427ARE/NDARNB427ARE_Video-FF_Samples_ET.mat, Fractals, 60, 4401510343, 4564496267, 162985924
/Volumes/methlab_data/HBN/EEG-ET/NDARNB427ARE/NDARNB427ARE_Video-TP_Samples_ET.mat, Present, 60, 5295097768, 5498161199, 203063431
/Volumes/methlab_data/HBN/EEG-ET/NDARNB427ARE/NDARNB427ARE_Video-WK_Samples_ET.mat, Diary, 60, 3788867700, 3906261184, 117393484
/Volumes/methlab_data/HBN/EEG-ET/NDARNB440UE4/NDARNB440UE4_Video1_Samples_ET.mat, Diary, 60, 1942730157, 2060126084, 117395927
/Volumes/methlab_data/HBN/EEG-ET/NDARNB440UE4/NDARNB440UE4_Video3_Samples_ET.mat, Despicable, 60, 2682495642, 2853039111, 170543469
/Volumes/methlab_data/HBN/EEG-ET/NDARNB738TM9/NDARNB738TM9_Video-DM_Samples_ET.mat, Despicable, 30, 405425127, 575961525, 170536398
/Volumes/methlab_data/HBN/EEG-ET/NDARNB738TM9/NDARNB738TM9_Video-TP_Samples_ET.mat, Present, 30, 1448135222, 1651413741, 203278519
/Volumes/methlab_data/HBN/EEG-ET/NDARNB738TM9/NDARNB738TM9_Video-WK_Samples_ET.mat, Diary, 30, 3631579799, 3748968683, 117388884
/Volumes/methlab_data/HBN/EEG-ET/NDARNB824ARJ/NDARNB824ARJ_Video1_Samples_ET.mat, Diary, 60, 2878502484, 2995898416, 117395932
/Volumes/methlab_data/HBN/EEG-ET/NDARNB824ARJ/NDARNB824ARJ_Video3_Samples_ET.mat, Despicable, 60, 1904426502, 2074972006, 170545504
/Volumes/methlab_data/HBN/EEG-ET/NDARNB905CFU/NDARNB905CFU_Video1_Samples_ET.mat, Fractals, 120, 5424061911, 5587047578, 162985667
/Volumes/methlab_data/HBN/EEG-ET/NDARNB905CFU/NDARNB905CFU_Video2_Samples_ET.mat, Diary, 120, 6243255839, 6360652591, 117396752
/Volumes/methlab_data/HBN/EEG-ET/NDARNB905CFU/NDARNB905CFU_Video3_Samples_ET.mat, Despicable, 120, 6787561861, 6958109198, 170547337
/Volumes/methlab_data/HBN/EEG-ET/NDARNB905CFU/NDARNB905CFU_Video4_Samples_ET.mat, Present, 120, 7428989017, 7632055691, 203066674
/Volumes/methlab_data/HBN/EEG-ET/NDARNC130ZLK/NDARNC130ZLK_Video-DM_Samples_ET.mat, Despicable, 60, 6234587461, 6405136096, 170548635
/Volumes/methlab_data/HBN/EEG-ET/NDARNC130ZLK/NDARNC130ZLK_Video-TP_Samples_ET.mat, Present, 60, 6719713573, 6922994364, 203280791
/Volumes/methlab_data/HBN/EEG-ET/NDARNC130ZLK/NDARNC130ZLK_Video-WK_Samples_ET.mat, Diary, 60, 4690434345, 4807825365, 117391020
/Volumes/methlab_data/HBN/EEG-ET/NDARNC287MK5/NDARNC287MK5_Video-DM_Samples_ET.mat, Despicable, 30, 5021944088, 5192479621, 170535533
/Volumes/methlab_data/HBN/EEG-ET/NDARNC287MK5/NDARNC287MK5_Video-TP_Samples_ET.mat, Present, 30, 5497459110, 5700725770, 203266660
/Volumes/methlab_data/HBN/EEG-ET/NDARNC287MK5/NDARNC287MK5_Video-WK_Samples_ET.mat, Diary, 30, 3618741521, 3736125491, 117383970
/Volumes/methlab_data/HBN/EEG-ET/NDARNC374XEL/NDARNC374XEL_Video-DM_Samples_ET.mat, Despicable, 120, 5585845423, 5756386535, 170541112
/Volumes/methlab_data/HBN/EEG-ET/NDARNC374XEL/NDARNC374XEL_Video-FF_Samples_ET.mat, Fractals, 120, 4696020457, 4859007374, 162986917
/Volumes/methlab_data/HBN/EEG-ET/NDARNC374XEL/NDARNC374XEL_Video-TP_Samples_ET.mat, Present, 120, 6588387476, 6791453739, 203066263
/Volumes/methlab_data/HBN/EEG-ET/NDARNC374XEL/NDARNC374XEL_Video-WK_Samples_ET.mat, Diary, 120, 6007070476, 6124468372, 117397896
/Volumes/methlab_data/HBN/EEG-ET/NDARNC489BX5/NDARNC489BX5_Video-DM_Samples_ET.mat, Despicable, 60, 3156988619, 3327538327, 170549708
/Volumes/methlab_data/HBN/EEG-ET/NDARNC489BX5/NDARNC489BX5_Video-TP_Samples_ET.mat, Present, 60, 3761343270, 3964621129, 203277859
/Volumes/methlab_data/HBN/EEG-ET/NDARNC489BX5/NDARNC489BX5_Video-WK_Samples_ET.mat, Diary, 60, 1810290646, 1927678742, 117388096
/Volumes/methlab_data/HBN/EEG-ET/NDARNC922JEK/NDARNC922JEK_Video1_Samples_ET.mat, Despicable, 120, 2769422040, 2939966528, 170544488
/Volumes/methlab_data/HBN/EEG-ET/NDARNC922JEK/NDARNC922JEK_Video2_Samples_ET.mat, Diary, 120, 3308136199, 3425532811, 117396612
/Volumes/methlab_data/HBN/EEG-ET/NDARNC922JEK/NDARNC922JEK_Video3_Samples_ET.mat, Fractals, 120, 3533757381, 3696746832, 162989451
/Volumes/methlab_data/HBN/EEG-ET/NDARNC922JEK/NDARNC922JEK_Video4_Samples_ET.mat, Present, 120, 3748099305, 3951160771, 203061466
/Volumes/methlab_data/HBN/EEG-ET/NDARND085WZK/NDARND085WZK_Video1_Samples_ET.mat, Fractals, 120, 3836213387, 3999199764, 162986377
/Volumes/methlab_data/HBN/EEG-ET/NDARND085WZK/NDARND085WZK_Video2_Samples_ET.mat, Despicable, 120, 5540840600, 5711387023, 170546423
/Volumes/methlab_data/HBN/EEG-ET/NDARND085WZK/NDARND085WZK_Video3_Samples_ET.mat, Diary, 120, 5960067932, 6077465187, 117397255
/Volumes/methlab_data/HBN/EEG-ET/NDARND085WZK/NDARND085WZK_Video4_Samples_ET.mat, Present, 120, 6780210918, 6983288390, 203077472
/Volumes/methlab_data/HBN/EEG-ET/NDARND321KZ4/NDARND321KZ4_Video-DM_Samples_ET.mat, Despicable, 60, 3815000169, 3985541591, 170541422
/Volumes/methlab_data/HBN/EEG-ET/NDARND321KZ4/NDARND321KZ4_Video-FF_Samples_ET.mat, Fractals, 60, 3035898218, 3198878272, 162980054
/Volumes/methlab_data/HBN/EEG-ET/NDARND321KZ4/NDARND321KZ4_Video-TP_Samples_ET.mat, Present, 60, 4737377305, 4940449672, 203072367
/Volumes/methlab_data/HBN/EEG-ET/NDARND321KZ4/NDARND321KZ4_Video-WK_Samples_ET.mat, Diary, 60, 4265424127, 4382817037, 117392910
/Volumes/methlab_data/HBN/EEG-ET/NDARND348HB3/NDARND348HB3_Video1_Samples_ET.mat, Diary, 120, 3215719149, 3333115500, 117396351
/Volumes/methlab_data/HBN/EEG-ET/NDARND348HB3/NDARND348HB3_Video2_Samples_ET.mat, Despicable, 120, 4499979823, 4670527485, 170547662
/Volumes/methlab_data/HBN/EEG-ET/NDARND348HB3/NDARND348HB3_Video3_Samples_ET.mat, Fractals, 120, 5053337133, 5216324497, 162987364
/Volumes/methlab_data/HBN/EEG-ET/NDARND348HB3/NDARND348HB3_Video4_Samples_ET.mat, Present, 120, 5914912473, 6117978562, 203066089
/Volumes/methlab_data/HBN/EEG-ET/NDARND604TNB/NDARND604TNB_Video-DM_Samples_ET.mat, Despicable, 60, 3526864134, 3697405842, 170541708
/Volumes/methlab_data/HBN/EEG-ET/NDARND604TNB/NDARND604TNB_Video-FF_Samples_ET.mat, Fractals, 60, 3058382611, 3221375971, 162993360
/Volumes/methlab_data/HBN/EEG-ET/NDARND604TNB/NDARND604TNB_Video-TP_Samples_ET.mat, Present, 60, 4063484881, 4266557582, 203072701
/Volumes/methlab_data/HBN/EEG-ET/NDARND604TNB/NDARND604TNB_Video-WK_Samples_ET.mat, Diary, 60, 2324618386, 2442011491, 117393105
/Volumes/methlab_data/HBN/EEG-ET/NDARND697FLK/NDARND697FLK_Video1_Samples_ET.mat, Diary, 60, 4759138600, 4876533602, 117395002
/Volumes/methlab_data/HBN/EEG-ET/NDARND697FLK/NDARND697FLK_Video2_Samples_ET.mat, Fractals, 60, 5458733967, 5621726176, 162992209
/Volumes/methlab_data/HBN/EEG-ET/NDARND697FLK/NDARND697FLK_Video3_Samples_ET.mat, Despicable, 60, 5956539762, 6127078314, 170538552
/Volumes/methlab_data/HBN/EEG-ET/NDARND697FLK/NDARND697FLK_Video4_Samples_ET.mat, Present, 60, 6464661819, 6667730313, 203068494
/Volumes/methlab_data/HBN/EEG-ET/NDARND805ZTP/NDARND805ZTP_Video-FF_Samples_ET.mat, Fractals, 30, 3041831035, 3204812254, 162981219
/Volumes/methlab_data/HBN/EEG-ET/NDARND805ZTP/NDARND805ZTP_Video-TP_Samples_ET.mat, Present, 30, 3969358494, 4172421980, 203063486
/Volumes/methlab_data/HBN/EEG-ET/NDARND805ZTP/NDARND805ZTP_Video-WK_Samples_ET.mat, Diary, 30, 2442172288, 2559566263, 117393975
/Volumes/methlab_data/HBN/EEG-ET/NDARNE196LV0/NDARNE196LV0_Video1_Samples_ET.mat, Diary, 60, 1823183459, 1940577317, 117393858
/Volumes/methlab_data/HBN/EEG-ET/NDARNE196LV0/NDARNE196LV0_Video3_Samples_ET.mat, Despicable, 60, 2967722423, 3138268829, 170546406
/Volumes/methlab_data/HBN/EEG-ET/NDARNE196LV0/NDARNE196LV0_Video4_Samples_ET.mat, Present, 60, 297198448, 500258838, 203060390
/Volumes/methlab_data/HBN/EEG-ET/NDARNE758RD6/NDARNE758RD6_Video1_Samples_ET.mat, Diary, 60, 2454911335, 2572302447, 117391112
/Volumes/methlab_data/HBN/EEG-ET/NDARNE758RD6/NDARNE758RD6_Video3_Samples_ET.mat, Despicable, 60, 1755581235, 1926120963, 170539728
/Volumes/methlab_data/HBN/EEG-ET/NDARNE767VAJ/NDARNE767VAJ_Video1_Samples_ET.mat, Diary, 60, 73184270308, 73301665301, 117394993
/Volumes/methlab_data/HBN/EEG-ET/NDARNE767VAJ/NDARNE767VAJ_Video3_Samples_ET.mat, Despicable, 60, 74963505602, 75134050141, 170544539
/Volumes/methlab_data/HBN/EEG-ET/NDARNE800DCT/NDARNE800DCT_Video-DM_Samples_ET.mat, Despicable, 120, 5620251218, 5790799403, 170548185
/Volumes/methlab_data/HBN/EEG-ET/NDARNE800DCT/NDARNE800DCT_Video-FF_Samples_ET.mat, Fractals, 120, 4857836276, 5020834005, 162997729
/Volumes/methlab_data/HBN/EEG-ET/NDARNE800DCT/NDARNE800DCT_Video-TP_Samples_ET.mat, Present, 120, 6615655519, 6818723188, 203067669
/Volumes/methlab_data/HBN/EEG-ET/NDARNE800DCT/NDARNE800DCT_Video-WK_Samples_ET.mat, Diary, 120, 6108669345, 6226065880, 117396535
/Volumes/methlab_data/HBN/EEG-ET/NDARNF766VW2/NDARNF766VW2_Video1_Samples_ET.mat, Diary, 120, 6205147594, 6322545331, 117397737
/Volumes/methlab_data/HBN/EEG-ET/NDARNF766VW2/NDARNF766VW2_Video2_Samples_ET.mat, Fractals, 120, 7985866680, 8148853671, 162986991
/Volumes/methlab_data/HBN/EEG-ET/NDARNF766VW2/NDARNF766VW2_Video3_Samples_ET.mat, Despicable, 120, 8502293469, 8672841035, 170547566
/Volumes/methlab_data/HBN/EEG-ET/NDARNF873FCV/NDARNF873FCV_Video1_Samples_ET.mat, Diary, 120, 5004064969, 5121461510, 117396541
/Volumes/methlab_data/HBN/EEG-ET/NDARNF873FCV/NDARNF873FCV_Video2_Samples_ET.mat, Fractals, 120, 6203737775, 6366734523, 162996748
/Volumes/methlab_data/HBN/EEG-ET/NDARNF873FCV/NDARNF873FCV_Video3_Samples_ET.mat, Despicable, 120, 6658294319, 6828851664, 170557345
/Volumes/methlab_data/HBN/EEG-ET/NDARNF873FCV/NDARNF873FCV_Video4_Samples_ET.mat, Present, 120, 7219340986, 7422408748, 203067762
/Volumes/methlab_data/HBN/EEG-ET/NDARNF954MK3/NDARNF954MK3_Video1_Samples_ET.mat, Diary, 60, 2299047498, 2416434513, 117387015
/Volumes/methlab_data/HBN/EEG-ET/NDARNF954MK3/NDARNF954MK3_Video3_Samples_ET.mat, Despicable, 60, 3634965038, 3805514811, 170549773
/Volumes/methlab_data/HBN/EEG-ET/NDARNF994TPA/NDARNF994TPA_Video1_Samples_ET.mat, Diary, 60, 5129400479, 5246793324, 117392845
/Volumes/methlab_data/HBN/EEG-ET/NDARNF994TPA/NDARNF994TPA_Video3_Samples_ET.mat, Despicable, 60, 5628452576, 5798996954, 170544378
/Volumes/methlab_data/HBN/EEG-ET/NDARNG108PFB/NDARNG108PFB_Video-DM_Samples_ET.mat, Despicable, 120, 4222637543, 4393182731, 170545188
/Volumes/methlab_data/HBN/EEG-ET/NDARNG108PFB/NDARNG108PFB_Video-FF_Samples_ET.mat, Fractals, 120, 4569022795, 4732009959, 162987164
/Volumes/methlab_data/HBN/EEG-ET/NDARNG108PFB/NDARNG108PFB_Video-TP_Samples_ET.mat, Present, 120, 4979820425, 5182887240, 203066815
/Volumes/methlab_data/HBN/EEG-ET/NDARNG108PFB/NDARNG108PFB_Video-WK_Samples_ET.mat, Diary, 120, 4791223447, 4908618919, 117395472
/Volumes/methlab_data/HBN/EEG-ET/NDARNG689AAP/NDARNG689AAP_Video1_Samples_ET.mat, Diary, 60, 1732449750, 1849839771, 117390021
/Volumes/methlab_data/HBN/EEG-ET/NDARNG689AAP/NDARNG689AAP_Video3_Samples_ET.mat, Despicable, 60, 2977985350, 3148528964, 170543614
/Volumes/methlab_data/HBN/EEG-ET/NDARNG968RB9/NDARNG968RB9_Video-DM_Samples_ET.mat, Despicable, 120, 3987400020, 4157947508, 170547488
/Volumes/methlab_data/HBN/EEG-ET/NDARNG968RB9/NDARNG968RB9_Video-FF_Samples_ET.mat, Fractals, 120, 4975862396, 5138850548, 162988152
/Volumes/methlab_data/HBN/EEG-ET/NDARNG968RB9/NDARNG968RB9_Video-TP_Samples_ET.mat, Present, 120, 5175088095, 5378155647, 203067552
/Volumes/methlab_data/HBN/EEG-ET/NDARNG968RB9/NDARNG968RB9_Video-WK_Samples_ET.mat, Diary, 120, 4817713711, 4935111692, 117397981
/Volumes/methlab_data/HBN/EEG-ET/NDARNH110NV6/NDARNH110NV6_Video-DM_Samples_ET.mat, Despicable, 60, 4334276549, 4504818310, 170541761
/Volumes/methlab_data/HBN/EEG-ET/NDARNH110NV6/NDARNH110NV6_Video-FF_Samples_ET.mat, Fractals, 60, 3874100940, 4037094313, 162993373
/Volumes/methlab_data/HBN/EEG-ET/NDARNH110NV6/NDARNH110NV6_Video-TP_Samples_ET.mat, Present, 60, 4834578575, 5037649292, 203070717
/Volumes/methlab_data/HBN/EEG-ET/NDARNH110NV6/NDARNH110NV6_Video-WK_Samples_ET.mat, Diary, 60, 3238814392, 3356208479, 117394087
/Volumes/methlab_data/HBN/EEG-ET/NDARNH147WGN/NDARNH147WGN_Video1_Samples_ET.mat, Diary, 60, 2221079715, 2338469649, 117389934
/Volumes/methlab_data/HBN/EEG-ET/NDARNH147WGN/NDARNH147WGN_Video3_Samples_ET.mat, Despicable, 60, 3374037417, 3544587969, 170550552
/Volumes/methlab_data/HBN/EEG-ET/NDARNH147WGN/NDARNH147WGN_Video4_Samples_ET.mat, Present, 60, 3906350596, 4109420113, 203069517
/Volumes/methlab_data/HBN/EEG-ET/NDARNH170TJU/NDARNH170TJU_Video-DM_Samples_ET.mat, Despicable, 30, 3059395867, 3229942281, 170546414
/Volumes/methlab_data/HBN/EEG-ET/NDARNH170TJU/NDARNH170TJU_Video-TP_Samples_ET.mat, Present, 30, 3947154564, 4150432082, 203277518
/Volumes/methlab_data/HBN/EEG-ET/NDARNH170TJU/NDARNH170TJU_Video-WK_Samples_ET.mat, Diary, 30, 3513118173, 3630506064, 117387891
/Volumes/methlab_data/HBN/EEG-ET/NDARNH200DA6/NDARNH200DA6_Video1_Samples_ET.mat, Diary, 60, 3895478282, 4012873213, 117394931
/Volumes/methlab_data/HBN/EEG-ET/NDARNH200DA6/NDARNH200DA6_Video2_Samples_ET.mat, Fractals, 60, 4679175253, 4842154251, 162978998
/Volumes/methlab_data/HBN/EEG-ET/NDARNH200DA6/NDARNH200DA6_Video3_Samples_ET.mat, Despicable, 60, 5133114542, 5303656890, 170542348
/Volumes/methlab_data/HBN/EEG-ET/NDARNH200DA6/NDARNH200DA6_Video4_Samples_ET.mat, Present, 60, 5645458018, 5848519626, 203061608
/Volumes/methlab_data/HBN/EEG-ET/NDARNH285EWA/NDARNH285EWA_Video-DM_Samples_ET.mat, Despicable, 30, 5401064848, 5571604427, 170539579
/Volumes/methlab_data/HBN/EEG-ET/NDARNH285EWA/NDARNH285EWA_Video-TP_Samples_ET.mat, Present, 30, 6167587761, 6370855508, 203267747
/Volumes/methlab_data/HBN/EEG-ET/NDARNH285EWA/NDARNH285EWA_Video-WK_Samples_ET.mat, Diary, 30, 4209827633, 4327214636, 117387003
/Volumes/methlab_data/HBN/EEG-ET/NDARNH743HW0/NDARNH743HW0_Video-DM_Samples_ET.mat, Despicable, 60, 75490470285, 75661021809, 170551524
/Volumes/methlab_data/HBN/EEG-ET/NDARNH743HW0/NDARNH743HW0_Video-FF_Samples_ET.mat, Fractals, 60, 74987238730, 75150228875, 162990145
/Volumes/methlab_data/HBN/EEG-ET/NDARNH743HW0/NDARNH743HW0_Video-TP_Samples_ET.mat, Present, 60, 76029863438, 76232934963, 203071525
/Volumes/methlab_data/HBN/EEG-ET/NDARNH743HW0/NDARNH743HW0_Video-WK_Samples_ET.mat, Diary, 60, 74173361593, 74290751519, 117389926
/Volumes/methlab_data/HBN/EEG-ET/NDARNH766CU7/NDARNH766CU7_Video-DM_Samples_ET.mat, Despicable, 60, 3505201880, 3675751397, 170549517
/Volumes/methlab_data/HBN/EEG-ET/NDARNH766CU7/NDARNH766CU7_Video-FF_Samples_ET.mat, Fractals, 60, 3070719832, 3233708025, 162988193
/Volumes/methlab_data/HBN/EEG-ET/NDARNH766CU7/NDARNH766CU7_Video-TP_Samples_ET.mat, Present, 60, 3998882707, 4201953243, 203070536
/Volumes/methlab_data/HBN/EEG-ET/NDARNH766CU7/NDARNH766CU7_Video-WK_Samples_ET.mat, Diary, 60, 2558774078, 2676165054, 117390976
/Volumes/methlab_data/HBN/EEG-ET/NDARNJ633HHX/NDARNJ633HHX_Video1_Samples_ET.mat, Despicable, 120, 3360446894, 3530992811, 170545917
/Volumes/methlab_data/HBN/EEG-ET/NDARNJ633HHX/NDARNJ633HHX_Video2_Samples_ET.mat, Fractals, 120, 3643193532, 3806181390, 162987858
/Volumes/methlab_data/HBN/EEG-ET/NDARNJ633HHX/NDARNJ633HHX_Video3_Samples_ET.mat, Diary, 120, 3873663805, 3991060679, 117396874
/Volumes/methlab_data/HBN/EEG-ET/NDARNJ633HHX/NDARNJ633HHX_Video4_Samples_ET.mat, Present, 120, 4068447992, 4271510406, 203062414
/Volumes/methlab_data/HBN/EEG-ET/NDARNJ894VH2/NDARNJ894VH2_Video1_Samples_ET.mat, Diary, 60, 2193825690, 2311221806, 117396116
/Volumes/methlab_data/HBN/EEG-ET/NDARNJ894VH2/NDARNJ894VH2_Video3_Samples_ET.mat, Despicable, 60, 3396031405, 3566573137, 170541732
/Volumes/methlab_data/HBN/EEG-ET/NDARNJ899HW7/NDARNJ899HW7_Video1_Samples_ET.mat, Diary, 60, 2322863447, 2440506640, 117643193
/Volumes/methlab_data/HBN/EEG-ET/NDARNJ899HW7/NDARNJ899HW7_Video2_Samples_ET.mat, Fractals, 60, 2790439031, 2953422271, 162983240
/Volumes/methlab_data/HBN/EEG-ET/NDARNJ899HW7/NDARNJ899HW7_Video3_Samples_ET.mat, Despicable, 60, 3225635703, 3396179302, 170543599
/Volumes/methlab_data/HBN/EEG-ET/NDARNJ899HW7/NDARNJ899HW7_Video4_Samples_ET.mat, Present, 60, 3695420864, 3898485447, 203064583
/Volumes/methlab_data/HBN/EEG-ET/NDARNJ950EFG/NDARNJ950EFG_Video-DM_Samples_ET.mat, Despicable, 30, 5301023686, 5471562453, 170538767
/Volumes/methlab_data/HBN/EEG-ET/NDARNJ950EFG/NDARNJ950EFG_Video-WK_Samples_ET.mat, Diary, 30, 4184993556, 4302383696, 117390140
/Volumes/methlab_data/HBN/EEG-ET/NDARNK005BRN/NDARNK005BRN_Video1_Samples_ET.mat, Fractals, 120, 4199379299, 4362366342, 162987043
/Volumes/methlab_data/HBN/EEG-ET/NDARNK005BRN/NDARNK005BRN_Video2_Samples_ET.mat, Despicable, 120, 5154297381, 5324844974, 170547593
/Volumes/methlab_data/HBN/EEG-ET/NDARNK005BRN/NDARNK005BRN_Video3_Samples_ET.mat, Diary, 120, 5655225620, 5772619736, 117394116
/Volumes/methlab_data/HBN/EEG-ET/NDARNK005BRN/NDARNK005BRN_Video4_Samples_ET.mat, Present, 120, 6264416679, 6467480212, 203063533
/Volumes/methlab_data/HBN/EEG-ET/NDARNK055HVH/NDARNK055HVH_Video1_Samples_ET.mat, Diary, 60, 3262165413, 3379557401, 117391988
/Volumes/methlab_data/HBN/EEG-ET/NDARNK055HVH/NDARNK055HVH_Video3_Samples_ET.mat, Despicable, 60, 4296272159, 4466815726, 170543567
/Volumes/methlab_data/HBN/EEG-ET/NDARNK055HVH/NDARNK055HVH_Video4_Samples_ET.mat, Present, 60, 4761916241, 4964987750, 203071509
/Volumes/methlab_data/HBN/EEG-ET/NDARNK064DXY/NDARNK064DXY_Video-DM_Samples_ET.mat, Despicable, 120, 3320158891, 3490715859, 170556968
/Volumes/methlab_data/HBN/EEG-ET/NDARNK064DXY/NDARNK064DXY_Video-FF_Samples_ET.mat, Fractals, 120, 3582456136, 3745444659, 162988523
/Volumes/methlab_data/HBN/EEG-ET/NDARNK064DXY/NDARNK064DXY_Video-TP_Samples_ET.mat, Present, 120, 4746739188, 4949807063, 203067875
/Volumes/methlab_data/HBN/EEG-ET/NDARNK064DXY/NDARNK064DXY_Video-WK_Samples_ET.mat, Diary, 120, 3909734340, 4027132458, 117398118
/Volumes/methlab_data/HBN/EEG-ET/NDARNK241ZXA/NDARNK241ZXA_Video1_Samples_ET.mat, Diary, 60, 3022667908, 3140065914, 117398006
/Volumes/methlab_data/HBN/EEG-ET/NDARNK241ZXA/NDARNK241ZXA_Video2_Samples_ET.mat, Fractals, 60, 2131198650, 2294180900, 162982250
/Volumes/methlab_data/HBN/EEG-ET/NDARNK241ZXA/NDARNK241ZXA_Video3_Samples_ET.mat, Despicable, 60, 2579651717, 2750196383, 170544666
/Volumes/methlab_data/HBN/EEG-ET/NDARNK241ZXA/NDARNK241ZXA_Video4_Samples_ET.mat, Present, 60, 3451972463, 3655047043, 203074580
/Volumes/methlab_data/HBN/EEG-ET/NDARNK322PHW/NDARNK322PHW_Video1_Samples_ET.mat, Diary, 60, 3425880250, 3543273153, 117392903
/Volumes/methlab_data/HBN/EEG-ET/NDARNK322PHW/NDARNK322PHW_Video2_Samples_ET.mat, Fractals, 60, 2162614000, 2325596134, 162982134
/Volumes/methlab_data/HBN/EEG-ET/NDARNK322PHW/NDARNK322PHW_Video3_Samples_ET.mat, Despicable, 60, 2993014516, 3163564988, 170550472
/Volumes/methlab_data/HBN/EEG-ET/NDARNK322PHW/NDARNK322PHW_Video4_Samples_ET.mat, Present, 60, 3886923861, 4089995319, 203071458
/Volumes/methlab_data/HBN/EEG-ET/NDARNK329VC3/NDARNK329VC3_Video1_Samples_ET.mat, Diary, 60, 5419269215, 5536661165, 117391950
/Volumes/methlab_data/HBN/EEG-ET/NDARNK329VC3/NDARNK329VC3_Video3_Samples_ET.mat, Despicable, 60, 4884057194, 5054597676, 170540482
/Volumes/methlab_data/HBN/EEG-ET/NDARNK740ZVM/NDARNK740ZVM_Video1_Samples_ET.mat, Diary, 60, 3144642443, 3262036410, 117393967
/Volumes/methlab_data/HBN/EEG-ET/NDARNK740ZVM/NDARNK740ZVM_Video2_Samples_ET.mat, Fractals, 60, 3815510495, 3978493689, 162983194
/Volumes/methlab_data/HBN/EEG-ET/NDARNK740ZVM/NDARNK740ZVM_Video3_Samples_ET.mat, Despicable, 60, 4257825065, 4428367623, 170542558
/Volumes/methlab_data/HBN/EEG-ET/NDARNK740ZVM/NDARNK740ZVM_Video4_Samples_ET.mat, Present, 60, 4745267516, 4948329025, 203061509
/Volumes/methlab_data/HBN/EEG-ET/NDARNK768THB/NDARNK768THB_Video1_Samples_ET.mat, Diary, 60, 16560858276, 16678256451, 117398175
/Volumes/methlab_data/HBN/EEG-ET/NDARNK768THB/NDARNK768THB_Video3_Samples_ET.mat, Despicable, 60, 16132345739, 16302885554, 170539815
/Volumes/methlab_data/HBN/EEG-ET/NDARNK810AJA/NDARNK810AJA_Video-DM_Samples_ET.mat, Despicable, 60, 1093255299, 1263793893, 170538594
/Volumes/methlab_data/HBN/EEG-ET/NDARNK810AJA/NDARNK810AJA_Video-FF_Samples_ET.mat, Fractals, 60, 1558900522, 1721888788, 162988266
/Volumes/methlab_data/HBN/EEG-ET/NDARNK810AJA/NDARNK810AJA_Video-TP_Samples_ET.mat, Present, 60, 1797489195, 2000558851, 203069656
/Volumes/methlab_data/HBN/EEG-ET/NDARNK810AJA/NDARNK810AJA_Video-WK_Samples_ET.mat, Diary, 60, 1401086933, 1518476976, 117390043
/Volumes/methlab_data/HBN/EEG-ET/NDARNL599TMZ/NDARNL599TMZ_Video1_Samples_ET.mat, Diary, 60, 2402687021, 2520081532, 117394511
/Volumes/methlab_data/HBN/EEG-ET/NDARNL599TMZ/NDARNL599TMZ_Video3_Samples_ET.mat, Despicable, 60, 3154086489, 3324627849, 170541360
/Volumes/methlab_data/HBN/EEG-ET/NDARNL926VB7/NDARNL926VB7_Video1_Samples_ET.mat, Despicable, 120, 4184607778, 4355164431, 170556653
/Volumes/methlab_data/HBN/EEG-ET/NDARNL926VB7/NDARNL926VB7_Video2_Samples_ET.mat, Diary, 120, 5017690075, 5135080516, 117390441
/Volumes/methlab_data/HBN/EEG-ET/NDARNL926VB7/NDARNL926VB7_Video3_Samples_ET.mat, Fractals, 120, 5178940833, 5341927757, 162986924
/Volumes/methlab_data/HBN/EEG-ET/NDARNL926VB7/NDARNL926VB7_Video4_Samples_ET.mat, Present, 120, 5416209673, 5619276620, 203066947
/Volumes/methlab_data/HBN/EEG-ET/NDARNM147CG2/NDARNM147CG2_Video1_Samples_ET.mat, Fractals, 120, 6167847092, 6330833143, 162986051
/Volumes/methlab_data/HBN/EEG-ET/NDARNM147CG2/NDARNM147CG2_Video2_Samples_ET.mat, Despicable, 120, 6970202633, 7140749555, 170546922
/Volumes/methlab_data/HBN/EEG-ET/NDARNM147CG2/NDARNM147CG2_Video3_Samples_ET.mat, Diary, 120, 7451759142, 7569156858, 117397716
/Volumes/methlab_data/HBN/EEG-ET/NDARNM147CG2/NDARNM147CG2_Video4_Samples_ET.mat, Present, 120, 8109406211, 8312472959, 203066748
/Volumes/methlab_data/HBN/EEG-ET/NDARNM624PDC/NDARNM624PDC_Video1_Samples_ET.mat, Diary, 60, 4629424689, 4746818694, 117394005
/Volumes/methlab_data/HBN/EEG-ET/NDARNM624PDC/NDARNM624PDC_Video3_Samples_ET.mat, Despicable, 60, 4186592607, 4357133196, 170540589
/Volumes/methlab_data/HBN/EEG-ET/NDARNM708YTF/NDARNM708YTF_Video-DM_Samples_ET.mat, Despicable, 60, 5115288604, 5285832686, 170544082
/Volumes/methlab_data/HBN/EEG-ET/NDARNM708YTF/NDARNM708YTF_Video-FF_Samples_ET.mat, Fractals, 60, 4053167851, 4216150539, 162982688
/Volumes/methlab_data/HBN/EEG-ET/NDARNM708YTF/NDARNM708YTF_Video-TP_Samples_ET.mat, Present, 60, 5601905964, 5804966065, 203060101
/Volumes/methlab_data/HBN/EEG-ET/NDARNM708YTF/NDARNM708YTF_Video-WK_Samples_ET.mat, Diary, 60, 4692431521, 4809828863, 117397342
/Volumes/methlab_data/HBN/EEG-ET/NDARNM783ZVV/NDARNM783ZVV_Video1_Samples_ET.mat, Diary, 120, 3259616639, 3377013138, 117396499
/Volumes/methlab_data/HBN/EEG-ET/NDARNM783ZVV/NDARNM783ZVV_Video2_Samples_ET.mat, Fractals, 120, 4328908833, 4491896074, 162987241
/Volumes/methlab_data/HBN/EEG-ET/NDARNM783ZVV/NDARNM783ZVV_Video3_Samples_ET.mat, Despicable, 120, 4825757092, 4996313283, 170556191
/Volumes/methlab_data/HBN/EEG-ET/NDARNM783ZVV/NDARNM783ZVV_Video4_Samples_ET.mat, Present, 120, 5532182015, 5735248602, 203066587
/Volumes/methlab_data/HBN/EEG-ET/NDARNM834MY9/NDARNM834MY9_Video1_Samples_ET.mat, Diary, 60, 5659981569, 5777371557, 117389988
/Volumes/methlab_data/HBN/EEG-ET/NDARNM834MY9/NDARNM834MY9_Video3_Samples_ET.mat, Despicable, 60, 4212892521, 4383440996, 170548475
/Volumes/methlab_data/HBN/EEG-ET/NDARNM838ABN/NDARNM838ABN_Video-DM_Samples_ET.mat, Despicable, 30, 4491301939, 4661848527, 170546588
/Volumes/methlab_data/HBN/EEG-ET/NDARNM838ABN/NDARNM838ABN_Video-TP_Samples_ET.mat, Present, 30, 5437851150, 5641126883, 203275733
/Volumes/methlab_data/HBN/EEG-ET/NDARNM838ABN/NDARNM838ABN_Video-WK_Samples_ET.mat, Diary, 30, 3685543268, 3802932282, 117389014
/Volumes/methlab_data/HBN/EEG-ET/NDARNN042YCH/NDARNN042YCH_Video-DM_Samples_ET.mat, Despicable, 30, 4571965909, 4742513502, 170547593
/Volumes/methlab_data/HBN/EEG-ET/NDARNN042YCH/NDARNN042YCH_Video-TP_Samples_ET.mat, Present, 30, 5081207948, 5284487660, 203279712
/Volumes/methlab_data/HBN/EEG-ET/NDARNN042YCH/NDARNN042YCH_Video-WK_Samples_ET.mat, Diary, 30, 3486334382, 3603724361, 117389979
/Volumes/methlab_data/HBN/EEG-ET/NDARNN142WYB/NDARNN142WYB_Video-DM_Samples_ET.mat, Despicable, 60, 7668374054, 7838919663, 170545609
/Volumes/methlab_data/HBN/EEG-ET/NDARNN142WYB/NDARNN142WYB_Video-FF_Samples_ET.mat, Fractals, 60, 7253239725, 7416232932, 162993207
/Volumes/methlab_data/HBN/EEG-ET/NDARNN142WYB/NDARNN142WYB_Video-TP_Samples_ET.mat, Present, 60, 8140860938, 8343929462, 203068524
/Volumes/methlab_data/HBN/EEG-ET/NDARNN142WYB/NDARNN142WYB_Video-WK_Samples_ET.mat, Diary, 60, 6521124359, 6638520327, 117395968
/Volumes/methlab_data/HBN/EEG-ET/NDARNN164EA6/NDARNN164EA6_Video1_Samples_ET.mat, Diary, 60, 4447791678, 4565181412, 117389734
/Volumes/methlab_data/HBN/EEG-ET/NDARNN164EA6/NDARNN164EA6_Video3_Samples_ET.mat, Despicable, 60, 3754552222, 3925098458, 170546236
/Volumes/methlab_data/HBN/EEG-ET/NDARNN164EA6/NDARNN164EA6_Video4_Samples_ET.mat, Present, 60, 4901851605, 5104915725, 203064120
/Volumes/methlab_data/HBN/EEG-ET/NDARNN218UGY/NDARNN218UGY_Video1_Samples_ET.mat, Diary, 60, 2776183837, 2893580271, 117396434
/Volumes/methlab_data/HBN/EEG-ET/NDARNN218UGY/NDARNN218UGY_Video3_Samples_ET.mat, Despicable, 60, 3713097751, 3883638959, 170541208
/Volumes/methlab_data/HBN/EEG-ET/NDARNN624AMU/NDARNN624AMU_Video-DM_Samples_ET.mat, Despicable, 120, 3723142359, 3893690442, 170548083
/Volumes/methlab_data/HBN/EEG-ET/NDARNN624AMU/NDARNN624AMU_Video-FF_Samples_ET.mat, Fractals, 120, 3028207834, 3191195160, 162987326
/Volumes/methlab_data/HBN/EEG-ET/NDARNN624AMU/NDARNN624AMU_Video-TP_Samples_ET.mat, Present, 120, 4732555054, 4935619066, 203064012
/Volumes/methlab_data/HBN/EEG-ET/NDARNN624AMU/NDARNN624AMU_Video-WK_Samples_ET.mat, Diary, 120, 4234379528, 4351769419, 117389891
/Volumes/methlab_data/HBN/EEG-ET/NDARNP370WGP/NDARNP370WGP_Video1_Samples_ET.mat, Despicable, 120, 1410431559, 1498059959, 1668606777
2.581752e+08, 1.705468e+08, /Volumes/methlab_data/HBN/EEG-ET/NDARNP370WGP/NDARNP370WGP_Video2_Samples_ET.mat, Fractals, 120, 1801247620, 1964230019, 162982399
/Volumes/methlab_data/HBN/EEG-ET/NDARNP370WGP/NDARNP370WGP_Video3_Samples_ET.mat, Diary, 120, 2010735193, 2128133199, 117398006
/Volumes/methlab_data/HBN/EEG-ET/NDARNP370WGP/NDARNP370WGP_Video4_Samples_ET.mat, Present, 120, 2171524416, 2374591526, 203067110
/Volumes/methlab_data/HBN/EEG-ET/NDARNP399JVF/NDARNP399JVF_Video3_Samples_ET.mat, Despicable, 60, 3000946579, 3171492423, 170545844
/Volumes/methlab_data/HBN/EEG-ET/NDARNP423EJQ/NDARNP423EJQ_Video-DM_Samples_ET.mat, Despicable, 60, 3891782561, 4062427239, 170644678
/Volumes/methlab_data/HBN/EEG-ET/NDARNP423EJQ/NDARNP423EJQ_Video-FF_Samples_ET.mat, Fractals, 60, 4682102328, 4845096601, 162994273
/Volumes/methlab_data/HBN/EEG-ET/NDARNP423EJQ/NDARNP423EJQ_Video-TP_Samples_ET.mat, Present, 60, 5157418365, 5360478960, 203060595
/Volumes/methlab_data/HBN/EEG-ET/NDARNP423EJQ/NDARNP423EJQ_Video-WK_Samples_ET.mat, Diary, 60, 4518609741, 4636002769, 117393028
/Volumes/methlab_data/HBN/EEG-ET/NDARNP643KZH/NDARNP643KZH_Video-DM_Samples_ET.mat, Despicable, 120, 3853416843, 4023963573, 170546730
/Volumes/methlab_data/HBN/EEG-ET/NDARNP643KZH/NDARNP643KZH_Video-FF_Samples_ET.mat, Fractals, 120, 3118282718, 3281268952, 162986234
/Volumes/methlab_data/HBN/EEG-ET/NDARNP643KZH/NDARNP643KZH_Video-TP_Samples_ET.mat, Present, 120, 5036159359, 5239225831, 203066472
/Volumes/methlab_data/HBN/EEG-ET/NDARNP643KZH/NDARNP643KZH_Video-WK_Samples_ET.mat, Diary, 120, 4362113711, 4479510849, 117397138
/Volumes/methlab_data/HBN/EEG-ET/NDARNP812WAQ/NDARNP812WAQ_Video-DM_Samples_ET.mat, Despicable, 60, 3031365800, 3201907303, 170541503
/Volumes/methlab_data/HBN/EEG-ET/NDARNP812WAQ/NDARNP812WAQ_Video-FF_Samples_ET.mat, Fractals, 60, 2573979476, 2736973962, 162994486
/Volumes/methlab_data/HBN/EEG-ET/NDARNP812WAQ/NDARNP812WAQ_Video-TP_Samples_ET.mat, Present, 60, 3547407003, 3750467870, 203060867
/Volumes/methlab_data/HBN/EEG-ET/NDARNP812WAQ/NDARNP812WAQ_Video-WK_Samples_ET.mat, Diary, 60, 1908284965, 2025677120, 117392155
/Volumes/methlab_data/HBN/EEG-ET/NDARNP836NUY/NDARNP836NUY_Video-WK_Samples_ET.mat, Diary, 60, 2346814238, 2464203862, 117389624
/Volumes/methlab_data/HBN/EEG-ET/NDARNP921JTV/NDARNP921JTV_Video-DM_Samples_ET.mat, Despicable, 60, 2352559247, 2523102058, 170542811
/Volumes/methlab_data/HBN/EEG-ET/NDARNP921JTV/NDARNP921JTV_Video-FF_Samples_ET.mat, Fractals, 60, 2623738328, 2786722800, 162984472
/Volumes/methlab_data/HBN/EEG-ET/NDARNP921JTV/NDARNP921JTV_Video-TP_Samples_ET.mat, Present, 60, 3021037770, 3224099615, 203061845
/Volumes/methlab_data/HBN/EEG-ET/NDARNP921JTV/NDARNP921JTV_Video-WK_Samples_ET.mat, Diary, 60, 2857683045, 2975077256, 117394211
/Volumes/methlab_data/HBN/EEG-ET/NDARNP939DDQ/NDARNP939DDQ_Video1_Samples_ET.mat, Diary, 60, 2878198745, 2995594880, 117396135
/Volumes/methlab_data/HBN/EEG-ET/NDARNP939DDQ/NDARNP939DDQ_Video3_Samples_ET.mat, Despicable, 60, 3923523819, 4094067588, 170543769
/Volumes/methlab_data/HBN/EEG-ET/NDARNR459MUJ/NDARNR459MUJ_Video1_Samples_ET.mat, Diary, 60, 3999094377, 4116490306, 117395929
/Volumes/methlab_data/HBN/EEG-ET/NDARNR459MUJ/NDARNR459MUJ_Video2_Samples_ET.mat, Fractals, 60, 4914624003, 5077618138, 162994135
/Volumes/methlab_data/HBN/EEG-ET/NDARNR459MUJ/NDARNR459MUJ_Video3_Samples_ET.mat, Despicable, 60, 5363267866, 5533823364, 170555498
/Volumes/methlab_data/HBN/EEG-ET/NDARNR459MUJ/NDARNR459MUJ_Video4_Samples_ET.mat, Present, 60, 5885119453, 6088193901, 203074448
/Volumes/methlab_data/HBN/EEG-ET/NDARNR734JZH/NDARNR734JZH_Video1_Samples_ET.mat, Diary, 60, 2864049798, 2981448789, 117398991
/Volumes/methlab_data/HBN/EEG-ET/NDARNR734JZH/NDARNR734JZH_Video3_Samples_ET.mat, Despicable, 60, 2376776475, 2547314995, 170538520
/Volumes/methlab_data/HBN/EEG-ET/NDARNR734JZH/NDARNR734JZH_Video4_Samples_ET.mat, Present, 60, 3297001740, 3500072274, 203070534
/Volumes/methlab_data/HBN/EEG-ET/NDARNT042GRA/NDARNT042GRA_Video1_Samples_ET.mat, Diary, 60, 1831024980, 1948420252, 117395272
/Volumes/methlab_data/HBN/EEG-ET/NDARNT042GRA/NDARNT042GRA_Video3_Samples_ET.mat, Despicable, 60, 3036297736, 3206845554, 170547818
/Volumes/methlab_data/HBN/EEG-ET/NDARNT043XGH/NDARNT043XGH_Video1_Samples_ET.mat, Diary, 60, 2727378298, 2844771383, 117393085
/Volumes/methlab_data/HBN/EEG-ET/NDARNT043XGH/NDARNT043XGH_Video3_Samples_ET.mat, Despicable, 60, 3863827436, 4003206120, 139378684
/Volumes/methlab_data/HBN/EEG-ET/NDARNT043XGH/NDARNT043XGH_Video4_Samples_ET.mat, Present, 60, 4336885217, 4539945933, 203060716
/Volumes/methlab_data/HBN/EEG-ET/NDARNT113YX7/NDARNT113YX7_Video-DM_Samples_ET.mat, Despicable, 60, 6575611439, 6746163195, 170551756
/Volumes/methlab_data/HBN/EEG-ET/NDARNT113YX7/NDARNT113YX7_Video-FF_Samples_ET.mat, Fractals, 60, 7174369342, 7337362754, 162993412
/Volumes/methlab_data/HBN/EEG-ET/NDARNT113YX7/NDARNT113YX7_Video-TP_Samples_ET.mat, Present, 60, 7707703927, 7910775720, 203071793
/Volumes/methlab_data/HBN/EEG-ET/NDARNT113YX7/NDARNT113YX7_Video-WK_Samples_ET.mat, Diary, 60, 5853085902, 5970481042, 117395140
/Volumes/methlab_data/HBN/EEG-ET/NDARNT151UN1/NDARNT151UN1_Video1_Samples_ET.mat, Diary, 60, 74998176959, 75115575418, 117398459
/Volumes/methlab_data/HBN/EEG-ET/NDARNT151UN1/NDARNT151UN1_Video2_Samples_ET.mat, Fractals, 60, 75623570436, 75786563342, 162992906
/Volumes/methlab_data/HBN/EEG-ET/NDARNT151UN1/NDARNT151UN1_Video3_Samples_ET.mat, Despicable, 60, 76044939939, 76215482176, 170542237
/Volumes/methlab_data/HBN/EEG-ET/NDARNT151UN1/NDARNT151UN1_Video4_Samples_ET.mat, Present, 60, 76570371378, 76773441728, 203070350
/Volumes/methlab_data/HBN/EEG-ET/NDARNT205ZKP/NDARNT205ZKP_Video-DM_Samples_ET.mat, Despicable, 60, 3167434982, 3337972691, 170537709
/Volumes/methlab_data/HBN/EEG-ET/NDARNT205ZKP/NDARNT205ZKP_Video-TP_Samples_ET.mat, Present, 60, 3673820326, 3877088207, 203267881
/Volumes/methlab_data/HBN/EEG-ET/NDARNT205ZKP/NDARNT205ZKP_Video-WK_Samples_ET.mat, Diary, 60, 1844959181, 1962343248, 117384067
/Volumes/methlab_data/HBN/EEG-ET/NDARNT245TP0/NDARNT245TP0_Video1_Samples_ET.mat, Diary, 60, 3755434479, 3872828284, 117393805
/Volumes/methlab_data/HBN/EEG-ET/NDARNT245TP0/NDARNT245TP0_Video2_Samples_ET.mat, Fractals, 60, 4493580038, 4656571003, 162990965
/Volumes/methlab_data/HBN/EEG-ET/NDARNT245TP0/NDARNT245TP0_Video3_Samples_ET.mat, Despicable, 60, 4944615103, 5115164397, 170549294
/Volumes/methlab_data/HBN/EEG-ET/NDARNT245TP0/NDARNT245TP0_Video4_Samples_ET.mat, Present, 60, 5446704197, 5649764436, 203060239
/Volumes/methlab_data/HBN/EEG-ET/NDARNT277FMR/NDARNT277FMR_Video-DM_Samples_ET.mat, Despicable, 30, 6366438032, 6536974437, 170536405
/Volumes/methlab_data/HBN/EEG-ET/NDARNT277FMR/NDARNT277FMR_Video-TP_Samples_ET.mat, Present, 30, 6852852413, 7056128926, 203276513
/Volumes/methlab_data/HBN/EEG-ET/NDARNT277FMR/NDARNT277FMR_Video-WK_Samples_ET.mat, Diary, 30, 5028525569, 5145910454, 117384885
/Volumes/methlab_data/HBN/EEG-ET/NDARNT541VT2/NDARNT541VT2_Video1_Samples_ET.mat, Diary, 60, 5729529227, 5846914971, 117385744
/Volumes/methlab_data/HBN/EEG-ET/NDARNT541VT2/NDARNT541VT2_Video3_Samples_ET.mat, Despicable, 60, 5452954367, 5623504548, 170550181
/Volumes/methlab_data/HBN/EEG-ET/NDARNT572CMD/NDARNT572CMD_Video1_Samples_ET.mat, Diary, 60, 2449201642, 2566594612, 117392970
/Volumes/methlab_data/HBN/EEG-ET/NDARNT572CMD/NDARNT572CMD_Video3_Samples_ET.mat, Despicable, 60, 3823274604, 3993813122, 170538518
/Volumes/methlab_data/HBN/EEG-ET/NDARNT686CZV/NDARNT686CZV_Video-DM_Samples_ET.mat, Despicable, 60, 968506261, 1139054865, 170548604
/Volumes/methlab_data/HBN/EEG-ET/NDARNT686CZV/NDARNT686CZV_Video-FF_Samples_ET.mat, Fractals, 60, 431013250, 594000510, 162987260
/Volumes/methlab_data/HBN/EEG-ET/NDARNT686CZV/NDARNT686CZV_Video-TP_Samples_ET.mat, Present, 60, 1543849014, 1746920621, 203071607
/Volumes/methlab_data/HBN/EEG-ET/NDARNT686CZV/NDARNT686CZV_Video-WK_Samples_ET.mat, Diary, 60, 6792560831, 6909950841, 117390010
/Volumes/methlab_data/HBN/EEG-ET/NDARNT898ZPF/NDARNT898ZPF_Video-DM_Samples_ET.mat, Despicable, 60, 3428413781, 3600222080, 171808299
/Volumes/methlab_data/HBN/EEG-ET/NDARNT898ZPF/NDARNT898ZPF_Video-WK_Samples_ET.mat, Diary, 60, 3085016356, 3202405271, 117388915
/Volumes/methlab_data/HBN/EEG-ET/NDARNT939YMG/NDARNT939YMG_Video1_Samples_ET.mat, Diary, 60, 2022891813, 2140285808, 117393995
/Volumes/methlab_data/HBN/EEG-ET/NDARNT939YMG/NDARNT939YMG_Video3_Samples_ET.mat, Despicable, 60, 3547176473, 3717715067, 170538594
/Volumes/methlab_data/HBN/EEG-ET/NDARNU137XR4/NDARNU137XR4_Video1_Samples_ET.mat, Diary, 60, 1447917066, 1565307378, 117390312
/Volumes/methlab_data/HBN/EEG-ET/NDARNU137XR4/NDARNU137XR4_Video3_Samples_ET.mat, Despicable, 60, 997962650, 1168505712, 170543062
/Volumes/methlab_data/HBN/EEG-ET/NDARNU249EDF/NDARNU249EDF_Video1_Samples_ET.mat, Diary, 60, 2489932830, 2607327864, 117395034
/Volumes/methlab_data/HBN/EEG-ET/NDARNU249EDF/NDARNU249EDF_Video3_Samples_ET.mat, Despicable, 60, 2048269582, 2218825193, 170555611
/Volumes/methlab_data/HBN/EEG-ET/NDARNU282ZYZ/NDARNU282ZYZ_Video1_Samples_ET.mat, Diary, 60, 2066245905, 2183636016, 117390111
/Volumes/methlab_data/HBN/EEG-ET/NDARNU282ZYZ/NDARNU282ZYZ_Video3_Samples_ET.mat, Despicable, 60, 3328567594, 3499107359, 170539765
/Volumes/methlab_data/HBN/EEG-ET/NDARNU411FDE/NDARNU411FDE_Video-DM_Samples_ET.mat, Despicable, 60, 4285457606, 4455995947, 170538341
/Volumes/methlab_data/HBN/EEG-ET/NDARNU411FDE/NDARNU411FDE_Video-TP_Samples_ET.mat, Present, 60, 4922480097, 5125747604, 203267507
/Volumes/methlab_data/HBN/EEG-ET/NDARNU411FDE/NDARNU411FDE_Video-WK_Samples_ET.mat, Diary, 60, 3033552313, 3150942137, 117389824
/Volumes/methlab_data/HBN/EEG-ET/NDARNU497GTX/NDARNU497GTX_Video1_Samples_ET.mat, Diary, 60, 3751324229, 3868719371, 117395142
/Volumes/methlab_data/HBN/EEG-ET/NDARNU497GTX/NDARNU497GTX_Video3_Samples_ET.mat, Despicable, 60, 4684342257, 4854884693, 170542436
/Volumes/methlab_data/HBN/EEG-ET/NDARNU770PM5/NDARNU770PM5_Video1_Samples_ET.mat, Diary, 120, 5264900311, 5382297197, 117396886
/Volumes/methlab_data/HBN/EEG-ET/NDARNU770PM5/NDARNU770PM5_Video2_Samples_ET.mat, Fractals, 120, 6045492942, 6208481758, 162988816
/Volumes/methlab_data/HBN/EEG-ET/NDARNU770PM5/NDARNU770PM5_Video3_Samples_ET.mat, Despicable, 120, 6571681998, 6742229636, 170547638
/Volumes/methlab_data/HBN/EEG-ET/NDARNU770PM5/NDARNU770PM5_Video4_Samples_ET.mat, Present, 120, 7319511594, 7522573846, 203062252
/Volumes/methlab_data/HBN/EEG-ET/NDARNV124WR8/NDARNV124WR8_Video-DM_Samples_ET.mat, Despicable, 120, 4285580950, 4456125021, 170544071
/Volumes/methlab_data/HBN/EEG-ET/NDARNV124WR8/NDARNV124WR8_Video-FF_Samples_ET.mat, Fractals, 120, 3765194095, 3928187690, 162993595
/Volumes/methlab_data/HBN/EEG-ET/NDARNV124WR8/NDARNV124WR8_Video-TP_Samples_ET.mat, Present, 120, 4888109736, 5091181401, 203071665
/Volumes/methlab_data/HBN/EEG-ET/NDARNV124WR8/NDARNV124WR8_Video-WK_Samples_ET.mat, Diary, 120, 3088021242, 3205414042, 117392800
/Volumes/methlab_data/HBN/EEG-ET/NDARNV332JF2/NDARNV332JF2_Video3_Samples_ET.mat, Despicable, 60, 4005643742, 4176189472, 170545730
/Volumes/methlab_data/HBN/EEG-ET/NDARNV375KEK/NDARNV375KEK_Video-DM_Samples_ET.mat, Despicable, 60, 6421361888, 6591913494, 170551606
/Volumes/methlab_data/HBN/EEG-ET/NDARNV375KEK/NDARNV375KEK_Video-FF_Samples_ET.mat, Fractals, 60, 5687590108, 5850577366, 162987258
/Volumes/methlab_data/HBN/EEG-ET/NDARNV375KEK/NDARNV375KEK_Video-TP_Samples_ET.mat, Present, 60, 7425228646, 7628298235, 203069589
/Volumes/methlab_data/HBN/EEG-ET/NDARNV375KEK/NDARNV375KEK_Video-WK_Samples_ET.mat, Diary, 60, 6913936164, 7031327167, 117391003
/Volumes/methlab_data/HBN/EEG-ET/NDARNV399BV4/NDARNV399BV4_Video1_Samples_ET.mat, Fractals, 120, 4952474385, 5115460988, 162986603
/Volumes/methlab_data/HBN/EEG-ET/NDARNV399BV4/NDARNV399BV4_Video2_Samples_ET.mat, Diary, 120, 5917667087, 6035064343, 117397256
/Volumes/methlab_data/HBN/EEG-ET/NDARNV399BV4/NDARNV399BV4_Video3_Samples_ET.mat, Despicable, 120, 6351554319, 6522101764, 170547445
/Volumes/methlab_data/HBN/EEG-ET/NDARNV399BV4/NDARNV399BV4_Video4_Samples_ET.mat, Present, 120, 6996150044, 7199217652, 203067608
/Volumes/methlab_data/HBN/EEG-ET/NDARNV694EMG/NDARNV694EMG_Video-DM_Samples_ET.mat, Despicable, 60, 4151996975, 4322538510, 170541535
/Volumes/methlab_data/HBN/EEG-ET/NDARNV694EMG/NDARNV694EMG_Video-FF_Samples_ET.mat, Fractals, 60, 3718218429, 3881211638, 162993209
/Volumes/methlab_data/HBN/EEG-ET/NDARNV694EMG/NDARNV694EMG_Video-TP_Samples_ET.mat, Present, 60, 4637360937, 4840421452, 203060515
/Volumes/methlab_data/HBN/EEG-ET/NDARNV694EMG/NDARNV694EMG_Video-WK_Samples_ET.mat, Diary, 60, 3024283093, 3141676072, 117392979
/Volumes/methlab_data/HBN/EEG-ET/NDARNV983DET/NDARNV983DET_Video-DM_Samples_ET.mat, Despicable, 60, 4750635792, 4921187338, 170551546
/Volumes/methlab_data/HBN/EEG-ET/NDARNV983DET/NDARNV983DET_Video-FF_Samples_ET.mat, Fractals, 60, 4537610036, 4700595168, 162985132
/Volumes/methlab_data/HBN/EEG-ET/NDARNV983DET/NDARNV983DET_Video-TP_Samples_ET.mat, Present, 60, 4968289855, 5171359671, 203069816
/Volumes/methlab_data/HBN/EEG-ET/NDARNV983DET/NDARNV983DET_Video-WK_Samples_ET.mat, Diary, 60, 3810754187, 3928148856, 117394669
/Volumes/methlab_data/HBN/EEG-ET/NDARNW099DC7/NDARNW099DC7_Video-DM_Samples_ET.mat, Despicable, 60, 2970963049, 3141503451, 170540402
/Volumes/methlab_data/HBN/EEG-ET/NDARNW099DC7/NDARNW099DC7_Video-FF_Samples_ET.mat, Fractals, 60, 2514596888, 2677589971, 162993083
/Volumes/methlab_data/HBN/EEG-ET/NDARNW099DC7/NDARNW099DC7_Video-TP_Samples_ET.mat, Present, 60, 3464275296, 3667347672, 203072376
/Volumes/methlab_data/HBN/EEG-ET/NDARNW099DC7/NDARNW099DC7_Video-WK_Samples_ET.mat, Diary, 60, 1778214052, 1895606952, 117392900
/Volumes/methlab_data/HBN/EEG-ET/NDARNW182PJC/NDARNW182PJC_Video1_Samples_ET.mat, Diary, 60, 2150910985, 2268310169, 117399184
/Volumes/methlab_data/HBN/EEG-ET/NDARNW182PJC/NDARNW182PJC_Video3_Samples_ET.mat, Despicable, 60, 3290634290, 3461178093, 170543803
/Volumes/methlab_data/HBN/EEG-ET/NDARNW218ZBU/NDARNW218ZBU_Video1_Samples_ET.mat, Diary, 60, 1960341651, 2077736781, 117395130
/Volumes/methlab_data/HBN/EEG-ET/NDARNW218ZBU/NDARNW218ZBU_Video3_Samples_ET.mat, Despicable, 60, 4150396168, 4320945922, 170549754
/Volumes/methlab_data/HBN/EEG-ET/NDARNW687HMZ/NDARNW687HMZ_Video1_Samples_ET.mat, Diary, 60, 2081635203, 2199027787, 117392584
/Volumes/methlab_data/HBN/EEG-ET/NDARNW687HMZ/NDARNW687HMZ_Video3_Samples_ET.mat, Despicable, 60, 1711922058, 1882468456, 170546398
/Volumes/methlab_data/HBN/EEG-ET/NDARNW797PD6/NDARNW797PD6_Video1_Samples_ET.mat, Diary, 120, 7435056715, 7552454705, 117397990
/Volumes/methlab_data/HBN/EEG-ET/NDARNW797PD6/NDARNW797PD6_Video2_Samples_ET.mat, Fractals, 120, 8343721593, 8506708987, 162987394
/Volumes/methlab_data/HBN/EEG-ET/NDARNW797PD6/NDARNW797PD6_Video3_Samples_ET.mat, Despicable, 120, 8866998850, 9037546125, 170547275
/Volumes/methlab_data/HBN/EEG-ET/NDARNW945XLL/NDARNW945XLL_Video-DM_Samples_ET.mat, Despicable, 60, 2875681773, 3046224131, 170542358
/Volumes/methlab_data/HBN/EEG-ET/NDARNW945XLL/NDARNW945XLL_Video-FF_Samples_ET.mat, Fractals, 60, 2313025515, 2476010486, 162984971
/Volumes/methlab_data/HBN/EEG-ET/NDARNW945XLL/NDARNW945XLL_Video-TP_Samples_ET.mat, Present, 60, 3737613976, 3940686411, 203072435
/Volumes/methlab_data/HBN/EEG-ET/NDARNW945XLL/NDARNW945XLL_Video-WK_Samples_ET.mat, Diary, 60, 3310426040, 3427820589, 117394549
/Volumes/methlab_data/HBN/EEG-ET/NDARNW983TY8/NDARNW983TY8_Video3_Samples_ET.mat, Despicable, 60, 2627459326, 2798003987, 170544661
/Volumes/methlab_data/HBN/EEG-ET/NDARNX050XBN/NDARNX050XBN_Video-DM_Samples_ET.mat, Despicable, 60, 5250450782, 5420988178, 170537396
/Volumes/methlab_data/HBN/EEG-ET/NDARNX050XBN/NDARNX050XBN_Video-TP_Samples_ET.mat, Present, 60, 6209291312, 6412561751, 203270439
/Volumes/methlab_data/HBN/EEG-ET/NDARNX050XBN/NDARNX050XBN_Video-WK_Samples_ET.mat, Diary, 60, 5740854788, 5858242650, 117387862
/Volumes/methlab_data/HBN/EEG-ET/NDARNX218UY5/NDARNX218UY5_Video1_Samples_ET.mat, Diary, 120, 3116746833, 3234142982, 117396149
/Volumes/methlab_data/HBN/EEG-ET/NDARNX218UY5/NDARNX218UY5_Video2_Samples_ET.mat, Fractals, 120, 4746634619, 4909622281, 162987662
/Volumes/methlab_data/HBN/EEG-ET/NDARNX218UY5/NDARNX218UY5_Video3_Samples_ET.mat, Despicable, 120, 5078183455, 5248724611, 170541156
/Volumes/methlab_data/HBN/EEG-ET/NDARNX218UY5/NDARNX218UY5_Video4_Samples_ET.mat, Present, 120, 5685851377, 5888918023, 203066646
/Volumes/methlab_data/HBN/EEG-ET/NDARNX477HZ4/NDARNX477HZ4_Video-DM_Samples_ET.mat, Despicable, 30, 723260065, 893805092, 170545027
/Volumes/methlab_data/HBN/EEG-ET/NDARNX477HZ4/NDARNX477HZ4_Video-TP_Samples_ET.mat, Present, 30, 1198453213, 1401735591, 203282378
/Volumes/methlab_data/HBN/EEG-ET/NDARNX562GP3/NDARNX562GP3_Video-DM_Samples_ET.mat, Despicable, 30, 4059270608, 4229818247, 170547639
/Volumes/methlab_data/HBN/EEG-ET/NDARNX562GP3/NDARNX562GP3_Video-TP_Samples_ET.mat, Present, 30, 4331949479, 4535226250, 203276771
/Volumes/methlab_data/HBN/EEG-ET/NDARNX562GP3/NDARNX562GP3_Video-WK_Samples_ET.mat, Diary, 30, 2897875188, 3015262228, 117387040
/Volumes/methlab_data/HBN/EEG-ET/NDARNX795LFK/NDARNX795LFK_Video1_Samples_ET.mat, Diary, 60, 3073826523, 3191219451, 117392928
/Volumes/methlab_data/HBN/EEG-ET/NDARNX795LFK/NDARNX795LFK_Video3_Samples_ET.mat, Despicable, 60, 2644161063, 2814700497, 170539434
/Volumes/methlab_data/HBN/EEG-ET/NDARNY023FWG/NDARNY023FWG_Video1_Samples_ET.mat, Despicable, 120, 2577977723, 2748524755, 170547032
/Volumes/methlab_data/HBN/EEG-ET/NDARNY023FWG/NDARNY023FWG_Video2_Samples_ET.mat, Diary, 120, 3673670690, 3791058568, 117387878
/Volumes/methlab_data/HBN/EEG-ET/NDARNY023FWG/NDARNY023FWG_Video3_Samples_ET.mat, Fractals, 120, 4217798244, 4380784910, 162986666
/Volumes/methlab_data/HBN/EEG-ET/NDARNY023FWG/NDARNY023FWG_Video4_Samples_ET.mat, Present, 120, 4881954135, 5085031328, 203077193
/Volumes/methlab_data/HBN/EEG-ET/NDARNY205RK8/NDARNY205RK8_Video-DM_Samples_ET.mat, Despicable, 60, 2798798956, 2969346578, 170547622
/Volumes/methlab_data/HBN/EEG-ET/NDARNY205RK8/NDARNY205RK8_Video-FF_Samples_ET.mat, Fractals, 60, 2592836004, 2755827443, 162991439
/Volumes/methlab_data/HBN/EEG-ET/NDARNY205RK8/NDARNY205RK8_Video-TP_Samples_ET.mat, Present, 60, 3458895147, 3661961958, 203066811
/Volumes/methlab_data/HBN/EEG-ET/NDARNY205RK8/NDARNY205RK8_Video-WK_Samples_ET.mat, Diary, 60, 3041851900, 3159249040, 117397140
/Volumes/methlab_data/HBN/EEG-ET/NDARNY217PLD/NDARNY217PLD_Video1_Samples_ET.mat, Diary, 60, 2526002093, 2643391809, 117389716
/Volumes/methlab_data/HBN/EEG-ET/NDARNY217PLD/NDARNY217PLD_Video3_Samples_ET.mat, Despicable, 60, 2309154485, 2479695542, 170541057
/Volumes/methlab_data/HBN/EEG-ET/NDARNY419GR2/NDARNY419GR2_Video1_Samples_ET.mat, Fractals, 120, 4781377425, 4944373938, 162996513
/Volumes/methlab_data/HBN/EEG-ET/NDARNY419GR2/NDARNY419GR2_Video2_Samples_ET.mat, Despicable, 120, 5504273140, 5674819637, 170546497
/Volumes/methlab_data/HBN/EEG-ET/NDARNY419GR2/NDARNY419GR2_Video3_Samples_ET.mat, Diary, 120, 5991689374, 6109087729, 117398355
/Volumes/methlab_data/HBN/EEG-ET/NDARNY419GR2/NDARNY419GR2_Video4_Samples_ET.mat, Present, 120, 6700495695, 6903563023, 203067328
/Volumes/methlab_data/HBN/EEG-ET/NDARNY875DR2/NDARNY875DR2_Video3_Samples_ET.mat, Despicable, 60, 4925527809, 5096071425, 170543616
/Volumes/methlab_data/HBN/EEG-ET/NDARNY894TH7/NDARNY894TH7_Video-DM_Samples_ET.mat, Despicable, 120, 7583830986, 7754378372, 170547386
/Volumes/methlab_data/HBN/EEG-ET/NDARNY894TH7/NDARNY894TH7_Video-FF_Samples_ET.mat, Fractals, 120, 7084825910, 7247808746, 162982836
/Volumes/methlab_data/HBN/EEG-ET/NDARNY894TH7/NDARNY894TH7_Video-TP_Samples_ET.mat, Present, 120, 8214628472, 8417694939, 203066467
/Volumes/methlab_data/HBN/EEG-ET/NDARNY894TH7/NDARNY894TH7_Video-WK_Samples_ET.mat, Diary, 120, 6416149122, 6533546347, 117397225
/Volumes/methlab_data/HBN/EEG-ET/NDARNY964EA0/NDARNY964EA0_Video1_Samples_ET.mat, Diary, 60, 2033920577, 2151314766, 117394189
/Volumes/methlab_data/HBN/EEG-ET/NDARNZ043VH0/NDARNZ043VH0_Video-DM_Samples_ET.mat, Despicable, 120, 7182292719, 7352849937, 170557218
/Volumes/methlab_data/HBN/EEG-ET/NDARNZ043VH0/NDARNZ043VH0_Video-FF_Samples_ET.mat, Fractals, 120, 6474371017, 6637354915, 162983898
/Volumes/methlab_data/HBN/EEG-ET/NDARNZ043VH0/NDARNZ043VH0_Video-TP_Samples_ET.mat, Present, 120, 8213065948, 8416143412, 203077464
/Volumes/methlab_data/HBN/EEG-ET/NDARNZ043VH0/NDARNZ043VH0_Video-WK_Samples_ET.mat, Diary, 120, 7636770329, 7754167469, 117397140
/Volumes/methlab_data/HBN/EEG-ET/NDARNZ084JVC/NDARNZ084JVC_Video-DM_Samples_ET.mat, Despicable, 60, 8075933871, 8246479117, 170545246
/Volumes/methlab_data/HBN/EEG-ET/NDARNZ084JVC/NDARNZ084JVC_Video-TP_Samples_ET.mat, Present, 60, 8930803512, 9134069812, 203266300
/Volumes/methlab_data/HBN/EEG-ET/NDARNZ084JVC/NDARNZ084JVC_Video-WK_Samples_ET.mat, Diary, 60, 8504970312, 8622357092, 117386780
/Volumes/methlab_data/HBN/EEG-ET/NDARNZ141GNH/NDARNZ141GNH_Video-DM_Samples_ET.mat, Despicable, 120, 2831517138, 3002064858, 170547720
/Volumes/methlab_data/HBN/EEG-ET/NDARNZ141GNH/NDARNZ141GNH_Video-FF_Samples_ET.mat, Fractals, 120, 3383144025, 3546130833, 162986808
/Volumes/methlab_data/HBN/EEG-ET/NDARNZ141GNH/NDARNZ141GNH_Video-TP_Samples_ET.mat, Present, 120, 4198118627, 4401185820, 203067193
/Volumes/methlab_data/HBN/EEG-ET/NDARNZ141GNH/NDARNZ141GNH_Video-WK_Samples_ET.mat, Diary, 120, 3597864394, 3715254874, 117390480
/Volumes/methlab_data/HBN/EEG-ET/NDARNZ433DDH/NDARNZ433DDH_Video-DM_Samples_ET.mat, Despicable, 30, 5045530425, 5216066731, 170536306
/Volumes/methlab_data/HBN/EEG-ET/NDARNZ433DDH/NDARNZ433DDH_Video-TP_Samples_ET.mat, Present, 30, 5539161535, 5742439938, 203278403
/Volumes/methlab_data/HBN/EEG-ET/NDARNZ433DDH/NDARNZ433DDH_Video-WK_Samples_ET.mat, Diary, 30, 3811685285, 3929074131, 117388846
/Volumes/methlab_data/HBN/EEG-ET/NDARNZ610KZY/NDARNZ610KZY_Video1_Samples_ET.mat, Diary, 60, 3590456899, 3707851878, 117394979
/Volumes/methlab_data/HBN/EEG-ET/NDARNZ610KZY/NDARNZ610KZY_Video2_Samples_ET.mat, Fractals, 60, 2475726186, 2638710379, 162984193
/Volumes/methlab_data/HBN/EEG-ET/NDARNZ610KZY/NDARNZ610KZY_Video3_Samples_ET.mat, Despicable, 60, 3148194377, 3318734907, 170540530
/Volumes/methlab_data/HBN/EEG-ET/NDARNZ610KZY/NDARNZ610KZY_Video4_Samples_ET.mat, Present, 60, 4013691973, 4216755494, 203063521
/Volumes/methlab_data/HBN/EEG-ET/NDARNZ615UEU/NDARNZ615UEU_Video1_Samples_ET.mat, Diary, 60, 3491467719, 3608859772, 117392053
/Volumes/methlab_data/HBN/EEG-ET/NDARNZ615UEU/NDARNZ615UEU_Video3_Samples_ET.mat, Despicable, 60, 3068209353, 3238759991, 170550638
/Volumes/methlab_data/HBN/EEG-ET/NDARNZ792HBN/NDARNZ792HBN_Video1_Samples_ET.mat, Diary, 60, 8851123897, 8968513190, 117389293
/Volumes/methlab_data/HBN/EEG-ET/NDARNZ792HBN/NDARNZ792HBN_Video3_Samples_ET.mat, Despicable, 60, 8435783294, 8606323279, 170539985
/Volumes/methlab_data/HBN/EEG-ET/NDARNZ792HBN/NDARNZ792HBN_Video4_Samples_ET.mat, Present, 60, 9309154780, 9512217840, 203063060
/Volumes/methlab_data/HBN/EEG-ET/NDARPA570LBF/NDARPA570LBF_Video1_Samples_ET.mat, Fractals, 120, 5541046646, 5704042006, 162995360
/Volumes/methlab_data/HBN/EEG-ET/NDARPA570LBF/NDARPA570LBF_Video2_Samples_ET.mat, Despicable, 120, 6733497535, 6904045681, 170548146
/Volumes/methlab_data/HBN/EEG-ET/NDARPA570LBF/NDARPA570LBF_Video3_Samples_ET.mat, Diary, 120, 7210884687, 7328278272, 117393585
/Volumes/methlab_data/HBN/EEG-ET/NDARPA570LBF/NDARPA570LBF_Video4_Samples_ET.mat, Present, 120, 7699257171, 7902319681, 203062510
/Volumes/methlab_data/HBN/EEG-ET/NDARPA827UBJ/NDARPA827UBJ_Video1_Samples_ET.mat, Diary, 60, 23318209793, 23435608400, 117398607
/Volumes/methlab_data/HBN/EEG-ET/NDARPA827UBJ/NDARPA827UBJ_Video3_Samples_ET.mat, Despicable, 60, 23095030934, 23265570360, 170539426
/Volumes/methlab_data/HBN/EEG-ET/NDARPB044UXA/NDARPB044UXA_Video1_Samples_ET.mat, Diary, 60, 4374934613, 4492328438, 117393825
/Volumes/methlab_data/HBN/EEG-ET/NDARPB044UXA/NDARPB044UXA_Video2_Samples_ET.mat, Fractals, 60, 5446047336, 5609027363, 162980027
/Volumes/methlab_data/HBN/EEG-ET/NDARPB044UXA/NDARPB044UXA_Video3_Samples_ET.mat, Despicable, 60, 5917802197, 6088340527, 170538330
/Volumes/methlab_data/HBN/EEG-ET/NDARPB044UXA/NDARPB044UXA_Video4_Samples_ET.mat, Present, 60, 6134381024, 6337444316, 203063292
/Volumes/methlab_data/HBN/EEG-ET/NDARPB293EPC/NDARPB293EPC_Video1_Samples_ET.mat, Diary, 60, 3063382066, 3180773064, 117390998
/Volumes/methlab_data/HBN/EEG-ET/NDARPB293EPC/NDARPB293EPC_Video2_Samples_ET.mat, Fractals, 60, 2333416238, 2496408427, 162992189
/Volumes/methlab_data/HBN/EEG-ET/NDARPB293EPC/NDARPB293EPC_Video3_Samples_ET.mat, Despicable, 60, 3437335309, 3607875870, 170540561
/Volumes/methlab_data/HBN/EEG-ET/NDARPB293EPC/NDARPB293EPC_Video4_Samples_ET.mat, Present, 60, 3911778580, 4114848099, 203069519
/Volumes/methlab_data/HBN/EEG-ET/NDARPB619PHV/NDARPB619PHV_Video1_Samples_ET.mat, Diary, 60, 4943251207, 5060643178, 117391971
/Volumes/methlab_data/HBN/EEG-ET/NDARPB619PHV/NDARPB619PHV_Video2_Samples_ET.mat, Fractals, 60, 5141850555, 5304840762, 162990207
/Volumes/methlab_data/HBN/EEG-ET/NDARPB619PHV/NDARPB619PHV_Video3_Samples_ET.mat, Despicable, 60, 4728559501, 4899099023, 170539522
/Volumes/methlab_data/HBN/EEG-ET/NDARPB619PHV/NDARPB619PHV_Video4_Samples_ET.mat, Present, 60, 5450853898, 5653913422, 203059524
/Volumes/methlab_data/HBN/EEG-ET/NDARPB984UTU/NDARPB984UTU_Video1_Samples_ET.mat, Diary, 60, 6144141418, 6261533498, 117392080
/Volumes/methlab_data/HBN/EEG-ET/NDARPB984UTU/NDARPB984UTU_Video3_Samples_ET.mat, Despicable, 60, 5667740305, 5838287996, 170547691
/Volumes/methlab_data/HBN/EEG-ET/NDARPC301UWR/NDARPC301UWR_Video-DM_Samples_ET.mat, Despicable, 60, 6280454398, 6450989029, 170534631
/Volumes/methlab_data/HBN/EEG-ET/NDARPC301UWR/NDARPC301UWR_Video-TP_Samples_ET.mat, Present, 60, 7391702061, 7594967795, 203265734
/Volumes/methlab_data/HBN/EEG-ET/NDARPC301UWR/NDARPC301UWR_Video-WK_Samples_ET.mat, Diary, 60, 5411498069, 5528887064, 117388995
/Volumes/methlab_data/HBN/EEG-ET/NDARPC418NZL/NDARPC418NZL_Video-DM_Samples_ET.mat, Despicable, 30, 4343291002, 4513828937, 170537935
/Volumes/methlab_data/HBN/EEG-ET/NDARPC418NZL/NDARPC418NZL_Video-TP_Samples_ET.mat, Present, 30, 5417283139, 5620549213, 203266074
/Volumes/methlab_data/HBN/EEG-ET/NDARPC418NZL/NDARPC418NZL_Video-WK_Samples_ET.mat, Diary, 30, 3695137661, 3812525882, 117388221
/Volumes/methlab_data/HBN/EEG-ET/NDARPC745LTD/NDARPC745LTD_Video-DM_Samples_ET.mat, Despicable, 60, 5395400259, 5565940611, 170540352
/Volumes/methlab_data/HBN/EEG-ET/NDARPC745LTD/NDARPC745LTD_Video-TP_Samples_ET.mat, Present, 60, 6448167077, 6651446626, 203279549
/Volumes/methlab_data/HBN/EEG-ET/NDARPC745LTD/NDARPC745LTD_Video-WK_Samples_ET.mat, Diary, 60, 5837923602, 5955313352, 117389750
/Volumes/methlab_data/HBN/EEG-ET/NDARPC817XZ5/NDARPC817XZ5_Video1_Samples_ET.mat, Diary, 60, 1889020169, 2006412248, 117392079
/Volumes/methlab_data/HBN/EEG-ET/NDARPC817XZ5/NDARPC817XZ5_Video3_Samples_ET.mat, Despicable, 60, 3222366213, 3392910850, 170544637
/Volumes/methlab_data/HBN/EEG-ET/NDARPC931KR1/NDARPC931KR1_Video-DM_Samples_ET.mat, Despicable, 120, 4194106237, 4364649056, 170542819
/Volumes/methlab_data/HBN/EEG-ET/NDARPC931KR1/NDARPC931KR1_Video-FF_Samples_ET.mat, Fractals, 120, 4502606766, 4665594091, 162987325
/Volumes/methlab_data/HBN/EEG-ET/NDARPC931KR1/NDARPC931KR1_Video-TP_Samples_ET.mat, Present, 120, 5393032786, 5596099345, 203066559
/Volumes/methlab_data/HBN/EEG-ET/NDARPC931KR1/NDARPC931KR1_Video-WK_Samples_ET.mat, Diary, 120, 3922821677, 4040218622, 117396945
/Volumes/methlab_data/HBN/EEG-ET/NDARPD029JVJ/NDARPD029JVJ_Video1_Samples_ET.mat, Diary, 60, 3765385914, 3882778026, 117392112
/Volumes/methlab_data/HBN/EEG-ET/NDARPD029JVJ/NDARPD029JVJ_Video2_Samples_ET.mat, Fractals, 60, 4307394491, 4470388839, 162994348
/Volumes/methlab_data/HBN/EEG-ET/NDARPD029JVJ/NDARPD029JVJ_Video3_Samples_ET.mat, Despicable, 60, 4917775403, 5088328083, 170552680
/Volumes/methlab_data/HBN/EEG-ET/NDARPD029JVJ/NDARPD029JVJ_Video4_Samples_ET.mat, Present, 60, 5478147909, 5681208631, 203060722
/Volumes/methlab_data/HBN/EEG-ET/NDARPD517MDH/NDARPD517MDH_Video1_Samples_ET.mat, Diary, 120, 3375500305, 3492897224, 117396919
/Volumes/methlab_data/HBN/EEG-ET/NDARPD517MDH/NDARPD517MDH_Video2_Samples_ET.mat, Despicable, 120, 5077475956, 5248017608, 170541652
/Volumes/methlab_data/HBN/EEG-ET/NDARPD517MDH/NDARPD517MDH_Video3_Samples_ET.mat, Fractals, 120, 5686413629, 5849401071, 162987442
/Volumes/methlab_data/HBN/EEG-ET/NDARPD517MDH/NDARPD517MDH_Video4_Samples_ET.mat, Present, 120, 6413378321, 6616445998, 203067677
/Volumes/methlab_data/HBN/EEG-ET/NDARPD568LHV/NDARPD568LHV_Video1_Samples_ET.mat, Fractals, 120, 13913826463, 14076811809, 162985346
/Volumes/methlab_data/HBN/EEG-ET/NDARPD568LHV/NDARPD568LHV_Video2_Samples_ET.mat, Diary, 120, 14405155936, 14522545370, 117389434
/Volumes/methlab_data/HBN/EEG-ET/NDARPD568LHV/NDARPD568LHV_Video3_Samples_ET.mat, Despicable, 120, 14945259528, 15115807072, 170547544
/Volumes/methlab_data/HBN/EEG-ET/NDARPD568LHV/NDARPD568LHV_Video4_Samples_ET.mat, Present, 120, 15602977797, 15806043596, 203065799
/Volumes/methlab_data/HBN/EEG-ET/NDARPD572XRC/NDARPD572XRC_Video-DM_Samples_ET.mat, Despicable, 30, 5900163881, 6070701279, 170537398
/Volumes/methlab_data/HBN/EEG-ET/NDARPD572XRC/NDARPD572XRC_Video-TP_Samples_ET.mat, Present, 30, 6395380472, 6598647963, 203267491
/Volumes/methlab_data/HBN/EEG-ET/NDARPD572XRC/NDARPD572XRC_Video-WK_Samples_ET.mat, Diary, 30, 4614897545, 4732285458, 117387913
/Volumes/methlab_data/HBN/EEG-ET/NDARPD891BX3/NDARPD891BX3_Video-DM_Samples_ET.mat, Despicable, 60, 6578436759, 6748979370, 170542611
/Volumes/methlab_data/HBN/EEG-ET/NDARPD891BX3/NDARPD891BX3_Video-FF_Samples_ET.mat, Fractals, 60, 7098758639, 7261741929, 162983290
/Volumes/methlab_data/HBN/EEG-ET/NDARPD891BX3/NDARPD891BX3_Video-TP_Samples_ET.mat, Present, 60, 7714757278, 7917827765, 203070487
/Volumes/methlab_data/HBN/EEG-ET/NDARPD891BX3/NDARPD891BX3_Video-WK_Samples_ET.mat, Diary, 60, 5774293229, 5891699283, 117406054
/Volumes/methlab_data/HBN/EEG-ET/NDARPD977VX2/NDARPD977VX2_Video1_Samples_ET.mat, Diary, 60, 4469405001, 4586800016, 117395015
/Volumes/methlab_data/HBN/EEG-ET/NDARPD977VX2/NDARPD977VX2_Video3_Samples_ET.mat, Despicable, 60, 4033782037, 4204322618, 170540581
/Volumes/methlab_data/HBN/EEG-ET/NDARPE056ACA/NDARPE056ACA_Video1_Samples_ET.mat, Diary, 60, 2451825603, 2569220057, 117394454
/Volumes/methlab_data/HBN/EEG-ET/NDARPE056ACA/NDARPE056ACA_Video3_Samples_ET.mat, Despicable, 60, 2000439772, 2170982052, 170542280
/Volumes/methlab_data/HBN/EEG-ET/NDARPE551CK7/NDARPE551CK7_Video1_Samples_ET.mat, Diary, 60, 4119951881, 4237340814, 117388933
/Volumes/methlab_data/HBN/EEG-ET/NDARPE551CK7/NDARPE551CK7_Video2_Samples_ET.mat, Fractals, 60, 4678035035, 4841022377, 162987342
/Volumes/methlab_data/HBN/EEG-ET/NDARPE551CK7/NDARPE551CK7_Video3_Samples_ET.mat, Despicable, 60, 5099395645, 5269946154, 170550509
/Volumes/methlab_data/HBN/EEG-ET/NDARPE551CK7/NDARPE551CK7_Video4_Samples_ET.mat, Present, 60, 5598010828, 5801077306, 203066478
/Volumes/methlab_data/HBN/EEG-ET/NDARPE623MBW/NDARPE623MBW_Video-DM_Samples_ET.mat, Despicable, 30, 3197643955, 3368181357, 170537402
/Volumes/methlab_data/HBN/EEG-ET/NDARPE623MBW/NDARPE623MBW_Video-TP_Samples_ET.mat, Present, 30, 4101415196, 4304691799, 203276603
/Volumes/methlab_data/HBN/EEG-ET/NDARPE623MBW/NDARPE623MBW_Video-WK_Samples_ET.mat, Diary, 30, 2243671091, 2361060024, 117388933
/Volumes/methlab_data/HBN/EEG-ET/NDARPE830YU0/NDARPE830YU0_Video-DM_Samples_ET.mat, Despicable, 60, 3435172817, 3605714576, 170541759
/Volumes/methlab_data/HBN/EEG-ET/NDARPE830YU0/NDARPE830YU0_Video-FF_Samples_ET.mat, Fractals, 60, 3004905224, 3167897621, 162992397
/Volumes/methlab_data/HBN/EEG-ET/NDARPE830YU0/NDARPE830YU0_Video-TP_Samples_ET.mat, Present, 60, 3921015797, 4124077583, 203061786
/Volumes/methlab_data/HBN/EEG-ET/NDARPE830YU0/NDARPE830YU0_Video-WK_Samples_ET.mat, Diary, 60, 2569609010, 2687004143, 117395133
/Volumes/methlab_data/HBN/EEG-ET/NDARPE838DC5/NDARPE838DC5_Video-DM_Samples_ET.mat, Despicable, 60, 2460818879, 2631356345, 170537466
/Volumes/methlab_data/HBN/EEG-ET/NDARPE838DC5/NDARPE838DC5_Video-TP_Samples_ET.mat, Present, 60, 3419810212, 3623084804, 203274592
/Volumes/methlab_data/HBN/EEG-ET/NDARPE838DC5/NDARPE838DC5_Video-WK_Samples_ET.mat, Diary, 60, 1799340684, 1916735630, 117394946
/Volumes/methlab_data/HBN/EEG-ET/NDARPF042DD2/NDARPF042DD2_Video-WK_Samples_ET.mat, Diary, 60, 2355013856, 2472406878, 117393022
/Volumes/methlab_data/HBN/EEG-ET/NDARPF179GNV/NDARPF179GNV_Video1_Samples_ET.mat, Diary, 60, 4932990760, 5050383767, 117393007
/Volumes/methlab_data/HBN/EEG-ET/NDARPF179GNV/NDARPF179GNV_Video3_Samples_ET.mat, Despicable, 60, 4522734735, 4693275572, 170540837
/Volumes/methlab_data/HBN/EEG-ET/NDARPF319WV2/NDARPF319WV2_Video1_Samples_ET.mat, Fractals, 120, 3609400175, 3772385464, 162985289
/Volumes/methlab_data/HBN/EEG-ET/NDARPF319WV2/NDARPF319WV2_Video2_Samples_ET.mat, Despicable, 120, 4400557803, 4571099239, 170541436
/Volumes/methlab_data/HBN/EEG-ET/NDARPF319WV2/NDARPF319WV2_Video3_Samples_ET.mat, Diary, 120, 4939081516, 5056479215, 117397699
/Volumes/methlab_data/HBN/EEG-ET/NDARPF319WV2/NDARPF319WV2_Video4_Samples_ET.mat, Present, 120, 5620907933, 5823975152, 203067219
/Volumes/methlab_data/HBN/EEG-ET/NDARPF362VH8/NDARPF362VH8_Video-DM_Samples_ET.mat, Despicable, 30, 4643010336, 4813547954, 170537618
/Volumes/methlab_data/HBN/EEG-ET/NDARPF362VH8/NDARPF362VH8_Video-TP_Samples_ET.mat, Present, 30, 5160954971, 5364225422, 203270451
/Volumes/methlab_data/HBN/EEG-ET/NDARPF362VH8/NDARPF362VH8_Video-WK_Samples_ET.mat, Diary, 30, 3557701720, 3675088753, 117387033
/Volumes/methlab_data/HBN/EEG-ET/NDARPF395NV5/NDARPF395NV5_Video-DM_Samples_ET.mat, Despicable, 60, 3752280582, 3922825316, 170544734
/Volumes/methlab_data/HBN/EEG-ET/NDARPF395NV5/NDARPF395NV5_Video-FF_Samples_ET.mat, Fractals, 60, 3312905689, 3475899044, 162993355
/Volumes/methlab_data/HBN/EEG-ET/NDARPF395NV5/NDARPF395NV5_Video-TP_Samples_ET.mat, Present, 60, 4229150028, 4432221754, 203071726
/Volumes/methlab_data/HBN/EEG-ET/NDARPF395NV5/NDARPF395NV5_Video-WK_Samples_ET.mat, Diary, 60, 2747075296, 2864468372, 117393076
/Volumes/methlab_data/HBN/EEG-ET/NDARPF640ZRG/NDARPF640ZRG_Video1_Samples_ET.mat, Fractals, 120, 3485606561, 3648599583, 162993022
/Volumes/methlab_data/HBN/EEG-ET/NDARPF640ZRG/NDARPF640ZRG_Video2_Samples_ET.mat, Despicable, 120, 4226444595, 4396989896, 170545301
/Volumes/methlab_data/HBN/EEG-ET/NDARPF640ZRG/NDARPF640ZRG_Video3_Samples_ET.mat, Diary, 120, 4664749662, 4782146177, 117396515
/Volumes/methlab_data/HBN/EEG-ET/NDARPF640ZRG/NDARPF640ZRG_Video4_Samples_ET.mat, Present, 120, 5253514802, 5456582715, 203067913
/Volumes/methlab_data/HBN/EEG-ET/NDARPF682GDC/NDARPF682GDC_Video-DM_Samples_ET.mat, Despicable, 120, 5482570779, 5653118763, 170547984
/Volumes/methlab_data/HBN/EEG-ET/NDARPF682GDC/NDARPF682GDC_Video-FF_Samples_ET.mat, Fractals, 120, 4800287050, 4963272469, 162985419
/Volumes/methlab_data/HBN/EEG-ET/NDARPF682GDC/NDARPF682GDC_Video-TP_Samples_ET.mat, Present, 120, 6509808726, 6712882284, 203073558
/Volumes/methlab_data/HBN/EEG-ET/NDARPF682GDC/NDARPF682GDC_Video-WK_Samples_ET.mat, Diary, 120, 5823522444, 5940916761, 117394317
/Volumes/methlab_data/HBN/EEG-ET/NDARPF683XWV/NDARPF683XWV_Video-DM_Samples_ET.mat, Despicable, 30, 4228601150, 4399136521, 170535371
/Volumes/methlab_data/HBN/EEG-ET/NDARPF683XWV/NDARPF683XWV_Video-TP_Samples_ET.mat, Present, 30, 5011761731, 5215040181, 203278450
/Volumes/methlab_data/HBN/EEG-ET/NDARPF683XWV/NDARPF683XWV_Video-WK_Samples_ET.mat, Diary, 30, 2730936435, 2848325298, 117388863
/Volumes/methlab_data/HBN/EEG-ET/NDARPF937BDQ/NDARPF937BDQ_Video1_Samples_ET.mat, Diary, 60, 3224752593, 3342147657, 117395064
/Volumes/methlab_data/HBN/EEG-ET/NDARPF937BDQ/NDARPF937BDQ_Video2_Samples_ET.mat, Fractals, 60, 3849878706, 4012868006, 162989300
/Volumes/methlab_data/HBN/EEG-ET/NDARPF937BDQ/NDARPF937BDQ_Video3_Samples_ET.mat, Despicable, 60, 4328005871, 4498552608, 170546737
/Volumes/methlab_data/HBN/EEG-ET/NDARPF937BDQ/NDARPF937BDQ_Video4_Samples_ET.mat, Present, 60, 4808466698, 5011534336, 203067638
/Volumes/methlab_data/HBN/EEG-ET/NDARPF988BBV/NDARPF988BBV_Video-DM_Samples_ET.mat, Despicable, 120, 4548413133, 4718961025, 170547892
/Volumes/methlab_data/HBN/EEG-ET/NDARPF988BBV/NDARPF988BBV_Video-FF_Samples_ET.mat, Fractals, 120, 3695868784, 3858866693, 162997909
/Volumes/methlab_data/HBN/EEG-ET/NDARPF988BBV/NDARPF988BBV_Video-TP_Samples_ET.mat, Present, 120, 5826215941, 6029283367, 203067426
/Volumes/methlab_data/HBN/EEG-ET/NDARPF988BBV/NDARPF988BBV_Video-WK_Samples_ET.mat, Diary, 120, 5093280357, 5210678044, 117397687
/Volumes/methlab_data/HBN/EEG-ET/NDARPG082MTJ/NDARPG082MTJ_Video-DM_Samples_ET.mat, Despicable, 60, 3672598605, 3843135752, 170537147
/Volumes/methlab_data/HBN/EEG-ET/NDARPG082MTJ/NDARPG082MTJ_Video-FF_Samples_ET.mat, Fractals, 60, 3233159197, 3396151069, 162991872
/Volumes/methlab_data/HBN/EEG-ET/NDARPG082MTJ/NDARPG082MTJ_Video-TP_Samples_ET.mat, Present, 60, 3885028499, 4088095854, 203067355
/Volumes/methlab_data/HBN/EEG-ET/NDARPG082MTJ/NDARPG082MTJ_Video-WK_Samples_ET.mat, Diary, 60, 2850555256, 2967947716, 117392460
/Volumes/methlab_data/HBN/EEG-ET/NDARPG134TF1/NDARPG134TF1_Video1_Samples_ET.mat, Diary, 60, 4907739809, 5025137090, 117397281
/Volumes/methlab_data/HBN/EEG-ET/NDARPG134TF1/NDARPG134TF1_Video3_Samples_ET.mat, Despicable, 60, 4459106813, 4629645328, 170538515
/Volumes/methlab_data/HBN/EEG-ET/NDARPG134TF1/NDARPG134TF1_Video4_Samples_ET.mat, Present, 60, 5394332681, 5597401194, 203068513
/Volumes/methlab_data/HBN/EEG-ET/NDARPG847LB8/NDARPG847LB8_Video1_Samples_ET.mat, Diary, 60, 3145126597, 3262518522, 117391925
/Volumes/methlab_data/HBN/EEG-ET/NDARPG847LB8/NDARPG847LB8_Video2_Samples_ET.mat, Fractals, 60, 2071460878, 2234443024, 162982146
/Volumes/methlab_data/HBN/EEG-ET/NDARPG847LB8/NDARPG847LB8_Video3_Samples_ET.mat, Despicable, 60, 2675820130, 2846361852, 170541722
/Volumes/methlab_data/HBN/EEG-ET/NDARPG847LB8/NDARPG847LB8_Video4_Samples_ET.mat, Present, 60, 3563881378, 3766951828, 203070450
/Volumes/methlab_data/HBN/EEG-ET/NDARPG873DJP/NDARPG873DJP_Video-DM_Samples_ET.mat, Despicable, 60, 2136745129, 2307292602, 170547473
/Volumes/methlab_data/HBN/EEG-ET/NDARPG873DJP/NDARPG873DJP_Video-FF_Samples_ET.mat, Fractals, 60, 2354336834, 2517331009, 162994175
/Volumes/methlab_data/HBN/EEG-ET/NDARPG873DJP/NDARPG873DJP_Video-TP_Samples_ET.mat, Present, 60, 2731985696, 2935047194, 203061498
/Volumes/methlab_data/HBN/EEG-ET/NDARPG873DJP/NDARPG873DJP_Video-WK_Samples_ET.mat, Diary, 60, 2565681191, 2683076144, 117394953
/Volumes/methlab_data/HBN/EEG-ET/NDARPG874CMG/NDARPG874CMG_Video-DM_Samples_ET.mat, Despicable, 120, 3287920532, 3458466833, 170546301
/Volumes/methlab_data/HBN/EEG-ET/NDARPG874CMG/NDARPG874CMG_Video-FF_Samples_ET.mat, Fractals, 120, 2546304607, 2709290449, 162985842
/Volumes/methlab_data/HBN/EEG-ET/NDARPG874CMG/NDARPG874CMG_Video-TP_Samples_ET.mat, Present, 120, 4594372942, 4797439200, 203066258
/Volumes/methlab_data/HBN/EEG-ET/NDARPG874CMG/NDARPG874CMG_Video-WK_Samples_ET.mat, Diary, 120, 3821956968, 3939353865, 117396897
/Volumes/methlab_data/HBN/EEG-ET/NDARPH022TRY/NDARPH022TRY_Video-DM_Samples_ET.mat, Despicable, 60, 3568367922, 3738917585, 170549663
/Volumes/methlab_data/HBN/EEG-ET/NDARPH022TRY/NDARPH022TRY_Video-FF_Samples_ET.mat, Fractals, 60, 3029353701, 3192346998, 162993297
/Volumes/methlab_data/HBN/EEG-ET/NDARPH022TRY/NDARPH022TRY_Video-TP_Samples_ET.mat, Present, 60, 4137672563, 4340741210, 203068647
/Volumes/methlab_data/HBN/EEG-ET/NDARPH022TRY/NDARPH022TRY_Video-WK_Samples_ET.mat, Diary, 60, 2217907770, 2335296823, 117389053
/Volumes/methlab_data/HBN/EEG-ET/NDARPH105ZFF/NDARPH105ZFF_Video-DM_Samples_ET.mat, Despicable, 60, 3743326017, 3913861603, 170535586
/Volumes/methlab_data/HBN/EEG-ET/NDARPH105ZFF/NDARPH105ZFF_Video-TP_Samples_ET.mat, Present, 60, 4641846267, 4845112056, 203265789
/Volumes/methlab_data/HBN/EEG-ET/NDARPH105ZFF/NDARPH105ZFF_Video-WK_Samples_ET.mat, Diary, 60, 4217530288, 4334920299, 117390011
/Volumes/methlab_data/HBN/EEG-ET/NDARPH152GU1/NDARPH152GU1_Video1_Samples_ET.mat, Despicable, 120, 2740145454, 2910702721, 170557267
/Volumes/methlab_data/HBN/EEG-ET/NDARPH152GU1/NDARPH152GU1_Video2_Samples_ET.mat, Diary, 120, 3536500822, 3653888938, 117388116
/Volumes/methlab_data/HBN/EEG-ET/NDARPH152GU1/NDARPH152GU1_Video3_Samples_ET.mat, Fractals, 120, 4096577604, 4259565323, 162987719
/Volumes/methlab_data/HBN/EEG-ET/NDARPH152GU1/NDARPH152GU1_Video4_Samples_ET.mat, Present, 120, 4870233772, 5073301049, 203067277
/Volumes/methlab_data/HBN/EEG-ET/NDARPH176EWC/NDARPH176EWC_Video1_Samples_ET.mat, Fractals, 120, 8556734872, 8719722485, 162987613
/Volumes/methlab_data/HBN/EEG-ET/NDARPH176EWC/NDARPH176EWC_Video2_Samples_ET.mat, Despicable, 120, 9467229894, 9637777082, 170547188
/Volumes/methlab_data/HBN/EEG-ET/NDARPH176EWC/NDARPH176EWC_Video3_Samples_ET.mat, Diary, 120, 10049053899, 10166442641, 117388742
/Volumes/methlab_data/HBN/EEG-ET/NDARPH176EWC/NDARPH176EWC_Video4_Samples_ET.mat, Present, 120, 10785693074, 10988760344, 203067270
/Volumes/methlab_data/HBN/EEG-ET/NDARPH513LP3/NDARPH513LP3_Video1_Samples_ET.mat, Fractals, 120, 7821435155, 7984431613, 162996458
/Volumes/methlab_data/HBN/EEG-ET/NDARPH513LP3/NDARPH513LP3_Video2_Samples_ET.mat, Despicable, 120, 8702209590, 8872756703, 170547113
/Volumes/methlab_data/HBN/EEG-ET/NDARPH513LP3/NDARPH513LP3_Video3_Samples_ET.mat, Diary, 120, 9351804810, 9469202678, 117397868
/Volumes/methlab_data/HBN/EEG-ET/NDARPH513LP3/NDARPH513LP3_Video4_Samples_ET.mat, Present, 120, 10097601559, 10300677696, 203076137
/Volumes/methlab_data/HBN/EEG-ET/NDARPH637HAZ/NDARPH637HAZ_Video-DM_Samples_ET.mat, Despicable, 30, 6081566589, 6252105977, 170539388
/Volumes/methlab_data/HBN/EEG-ET/NDARPH637HAZ/NDARPH637HAZ_Video-TP_Samples_ET.mat, Present, 30, 7746228942, 7949498589, 203269647
/Volumes/methlab_data/HBN/EEG-ET/NDARPH637HAZ/NDARPH637HAZ_Video-WK_Samples_ET.mat, Diary, 30, 7239461374, 7356852913, 117391539
/Volumes/methlab_data/HBN/EEG-ET/NDARPH844KP2/NDARPH844KP2_Video1_Samples_ET.mat, Diary, 60, 442744094, 560144323, 117400229
/Volumes/methlab_data/HBN/EEG-ET/NDARPH844KP2/NDARPH844KP2_Video3_Samples_ET.mat, Despicable, 60, 1435650856, 1606211154, 170560298
/Volumes/methlab_data/HBN/EEG-ET/NDARPH923FN7/NDARPH923FN7_Video1_Samples_ET.mat, Despicable, 120, 2861651759, 3032192413, 170540654
/Volumes/methlab_data/HBN/EEG-ET/NDARPH923FN7/NDARPH923FN7_Video2_Samples_ET.mat, Diary, 120, 3650684000, 3768081004, 117397004
/Volumes/methlab_data/HBN/EEG-ET/NDARPH923FN7/NDARPH923FN7_Video3_Samples_ET.mat, Fractals, 120, 3843174756, 4006165012, 162990256
/Volumes/methlab_data/HBN/EEG-ET/NDARPH923FN7/NDARPH923FN7_Video4_Samples_ET.mat, Present, 120, 4458769515, 4661846993, 203077478
/Volumes/methlab_data/HBN/EEG-ET/NDARPJ001BVE/NDARPJ001BVE_Video-DM_Samples_ET.mat, Despicable, 60, 6875102763, 7045652360, 170549597
/Volumes/methlab_data/HBN/EEG-ET/NDARPJ001BVE/NDARPJ001BVE_Video-FF_Samples_ET.mat, Fractals, 60, 6440603570, 6603588829, 162985259
/Volumes/methlab_data/HBN/EEG-ET/NDARPJ001BVE/NDARPJ001BVE_Video-TP_Samples_ET.mat, Present, 60, 7361585718, 7564654316, 203068598
/Volumes/methlab_data/HBN/EEG-ET/NDARPJ001BVE/NDARPJ001BVE_Video-WK_Samples_ET.mat, Diary, 60, 5711716548, 5829116317, 117399769
/Volumes/methlab_data/HBN/EEG-ET/NDARPJ151ERK/NDARPJ151ERK_Video-DM_Samples_ET.mat, Despicable, 120, 3437595907, 3608140154, 170544247
/Volumes/methlab_data/HBN/EEG-ET/NDARPJ151ERK/NDARPJ151ERK_Video-FF_Samples_ET.mat, Fractals, 120, 2571897471, 2734883276, 162985805
/Volumes/methlab_data/HBN/EEG-ET/NDARPJ151ERK/NDARPJ151ERK_Video-TP_Samples_ET.mat, Present, 120, 4420014588, 4623081477, 203066889
/Volumes/methlab_data/HBN/EEG-ET/NDARPJ151ERK/NDARPJ151ERK_Video-WK_Samples_ET.mat, Diary, 120, 3893258139, 4010655153, 117397014
/Volumes/methlab_data/HBN/EEG-ET/NDARPJ502KEH/NDARPJ502KEH_Video-DM_Samples_ET.mat, Despicable, 60, 4368114954, 4538653196, 170538242
/Volumes/methlab_data/HBN/EEG-ET/NDARPJ502KEH/NDARPJ502KEH_Video-TP_Samples_ET.mat, Present, 60, 5032429259, 5235705599, 203276340
/Volumes/methlab_data/HBN/EEG-ET/NDARPJ502KEH/NDARPJ502KEH_Video-WK_Samples_ET.mat, Diary, 60, 4852339294, 4969727080, 117387786
/Volumes/methlab_data/HBN/EEG-ET/NDARPJ691NEU/NDARPJ691NEU_Video-DM_Samples_ET.mat, Despicable, 60, 11766607306, 11937149904, 170542598
/Volumes/methlab_data/HBN/EEG-ET/NDARPJ691NEU/NDARPJ691NEU_Video-FF_Samples_ET.mat, Fractals, 60, 11332204183, 11495187427, 162983244
/Volumes/methlab_data/HBN/EEG-ET/NDARPJ691NEU/NDARPJ691NEU_Video-WK_Samples_ET.mat, Diary, 60, 10353108958, 10470502980, 117394022
/Volumes/methlab_data/HBN/EEG-ET/NDARPJ832WL6/NDARPJ832WL6_Video1_Samples_ET.mat, Diary, 120, 3319612841, 3437009038, 117396197
/Volumes/methlab_data/HBN/EEG-ET/NDARPJ832WL6/NDARPJ832WL6_Video2_Samples_ET.mat, Despicable, 120, 4451254050, 4621801864, 170547814
/Volumes/methlab_data/HBN/EEG-ET/NDARPJ832WL6/NDARPJ832WL6_Video3_Samples_ET.mat, Fractals, 120, 4989491238, 5152478424, 162987186
/Volumes/methlab_data/HBN/EEG-ET/NDARPJ832WL6/NDARPJ832WL6_Video4_Samples_ET.mat, Present, 120, 5707856392, 5910923709, 203067317
/Volumes/methlab_data/HBN/EEG-ET/NDARPJ887HFB/NDARPJ887HFB_Video-WK_Samples_ET.mat, Diary, 120, 4405906445, 4523303667, 117397222
/Volumes/methlab_data/HBN/EEG-ET/NDARPK223WVZ/NDARPK223WVZ_Video-DM_Samples_ET.mat, Despicable, 120, 4223703020, 4394250998, 170547978
/Volumes/methlab_data/HBN/EEG-ET/NDARPK223WVZ/NDARPK223WVZ_Video-FF_Samples_ET.mat, Fractals, 120, 3153512141, 3316497861, 162985720
/Volumes/methlab_data/HBN/EEG-ET/NDARPK223WVZ/NDARPK223WVZ_Video-TP_Samples_ET.mat, Present, 120, 4779420104, 4982487571, 203067467
/Volumes/methlab_data/HBN/EEG-ET/NDARPK223WVZ/NDARPK223WVZ_Video-WK_Samples_ET.mat, Diary, 120, 3767937027, 3885333938, 117396911
/Volumes/methlab_data/HBN/EEG-ET/NDARPK300HMV/NDARPK300HMV_Video1_Samples_ET.mat, Diary, 120, 3291095486, 3408484086, 117388600
/Volumes/methlab_data/HBN/EEG-ET/NDARPK300HMV/NDARPK300HMV_Video2_Samples_ET.mat, Despicable, 120, 4409576566, 4580118437, 170541871
/Volumes/methlab_data/HBN/EEG-ET/NDARPK300HMV/NDARPK300HMV_Video3_Samples_ET.mat, Fractals, 120, 4692658148, 4855644561, 162986413
/Volumes/methlab_data/HBN/EEG-ET/NDARPK300HMV/NDARPK300HMV_Video4_Samples_ET.mat, Present, 120, 5424964809, 5628041773, 203076964
/Volumes/methlab_data/HBN/EEG-ET/NDARPK337CLE/NDARPK337CLE_Video-DM_Samples_ET.mat, Despicable, 30, 3756935024, 3927475621, 170540597
/Volumes/methlab_data/HBN/EEG-ET/NDARPK337CLE/NDARPK337CLE_Video-TP_Samples_ET.mat, Present, 30, 4232770445, 4436050183, 203279738
/Volumes/methlab_data/HBN/EEG-ET/NDARPK337CLE/NDARPK337CLE_Video-WK_Samples_ET.mat, Diary, 30, 2439228403, 2556619439, 117391036
/Volumes/methlab_data/HBN/EEG-ET/NDARPK339NA6/NDARPK339NA6_Video1_Samples_ET.mat, Diary, 60, 1074444427, 1191833459, 117389032
/Volumes/methlab_data/HBN/EEG-ET/NDARPK339NA6/NDARPK339NA6_Video3_Samples_ET.mat, Despicable, 60, 641298218, 811839824, 170541606
/Volumes/methlab_data/HBN/EEG-ET/NDARPK522DVQ/NDARPK522DVQ_Video-DM_Samples_ET.mat, Despicable, 60, 1838413280, 2008953068, 170539788
/Volumes/methlab_data/HBN/EEG-ET/NDARPK522DVQ/NDARPK522DVQ_Video-FF_Samples_ET.mat, Fractals, 60, 1275998298, 1438980650, 162982352
/Volumes/methlab_data/HBN/EEG-ET/NDARPK522DVQ/NDARPK522DVQ_Video-TP_Samples_ET.mat, Present, 60, 2329355703, 2532428413, 203072710
/Volumes/methlab_data/HBN/EEG-ET/NDARPK522DVQ/NDARPK522DVQ_Video-WK_Samples_ET.mat, Diary, 60, 486180468, 603571497, 117391029
/Volumes/methlab_data/HBN/EEG-ET/NDARPK597XH0/NDARPK597XH0_Video-DM_Samples_ET.mat, Despicable, 60, 5778785401, 5949332998, 170547597
/Volumes/methlab_data/HBN/EEG-ET/NDARPK597XH0/NDARPK597XH0_Video-FF_Samples_ET.mat, Fractals, 60, 6301547979, 6464535236, 162987257
/Volumes/methlab_data/HBN/EEG-ET/NDARPK597XH0/NDARPK597XH0_Video-TP_Samples_ET.mat, Present, 60, 6773949011, 6977018571, 203069560
/Volumes/methlab_data/HBN/EEG-ET/NDARPK597XH0/NDARPK597XH0_Video-WK_Samples_ET.mat, Diary, 60, 5045629070, 5163029069, 117399999
/Volumes/methlab_data/HBN/EEG-ET/NDARPL194XDX/NDARPL194XDX_Video1_Samples_ET.mat, Fractals, 120, 5204363536, 5367359844, 162996308
/Volumes/methlab_data/HBN/EEG-ET/NDARPL201YL4/NDARPL201YL4_Video1_Samples_ET.mat, Diary, 60, 168212351346, 168329758369, 117407023
/Volumes/methlab_data/HBN/EEG-ET/NDARPL201YL4/NDARPL201YL4_Video3_Samples_ET.mat, Despicable, 60, 167789175138, 167959715760, 170540622
/Volumes/methlab_data/HBN/EEG-ET/NDARPL201YL4/NDARPL201YL4_Video4_Samples_ET.mat, Present, 60, 168625499432, 168828561027, 203061595
/Volumes/methlab_data/HBN/EEG-ET/NDARPL215MTH/NDARPL215MTH_Video1_Samples_ET.mat, Fractals, 120, 3226834540, 3389832133, 162997593
/Volumes/methlab_data/HBN/EEG-ET/NDARPL215MTH/NDARPL215MTH_Video2_Samples_ET.mat, Despicable, 120, 3983436250, 4153977028, 170540778
/Volumes/methlab_data/HBN/EEG-ET/NDARPL215MTH/NDARPL215MTH_Video3_Samples_ET.mat, Diary, 120, 4575158094, 4692555538, 117397444
/Volumes/methlab_data/HBN/EEG-ET/NDARPL215MTH/NDARPL215MTH_Video4_Samples_ET.mat, Present, 120, 5282905359, 5485972089, 203066730
/Volumes/methlab_data/HBN/EEG-ET/NDARPL306LC6/NDARPL306LC6_Video1_Samples_ET.mat, Diary, 60, 2874656609, 2992054992, 117398383
/Volumes/methlab_data/HBN/EEG-ET/NDARPL306LC6/NDARPL306LC6_Video3_Samples_ET.mat, Despicable, 60, 2443129030, 2613674201, 170545171
/Volumes/methlab_data/HBN/EEG-ET/NDARPL406KX4/NDARPL406KX4_Video-DM_Samples_ET.mat, Despicable, 60, 5303996188, 5474549604, 170553416
/Volumes/methlab_data/HBN/EEG-ET/NDARPL406KX4/NDARPL406KX4_Video-FF_Samples_ET.mat, Fractals, 60, 4842013073, 5004996137, 162983064
/Volumes/methlab_data/HBN/EEG-ET/NDARPL406KX4/NDARPL406KX4_Video-TP_Samples_ET.mat, Present, 60, 5826380978, 6029437299, 203056321
/Volumes/methlab_data/HBN/EEG-ET/NDARPL406KX4/NDARPL406KX4_Video-WK_Samples_ET.mat, Diary, 60, 4250094183, 4367486111, 117391928
/Volumes/methlab_data/HBN/EEG-ET/NDARPL440BX5/NDARPL440BX5_Video-DM_Samples_ET.mat, Despicable, 30, 4981247051, 5151786802, 170539751
/Volumes/methlab_data/HBN/EEG-ET/NDARPL440BX5/NDARPL440BX5_Video-TP_Samples_ET.mat, Present, 30, 5508472306, 5711740240, 203267934
/Volumes/methlab_data/HBN/EEG-ET/NDARPL440BX5/NDARPL440BX5_Video-WK_Samples_ET.mat, Diary, 30, 3921059468, 4038458586, 117399118
/Volumes/methlab_data/HBN/EEG-ET/NDARPL479LHN/NDARPL479LHN_Video-DM_Samples_ET.mat, Despicable, 120, 3565023360, 3735570638, 170547278
/Volumes/methlab_data/HBN/EEG-ET/NDARPL479LHN/NDARPL479LHN_Video-FF_Samples_ET.mat, Fractals, 120, 2743559285, 2906545242, 162985957
/Volumes/methlab_data/HBN/EEG-ET/NDARPL479LHN/NDARPL479LHN_Video-TP_Samples_ET.mat, Present, 120, 4728755899, 4931823042, 203067143
/Volumes/methlab_data/HBN/EEG-ET/NDARPL479LHN/NDARPL479LHN_Video-WK_Samples_ET.mat, Diary, 120, 4118279866, 4235677277, 117397411
/Volumes/methlab_data/HBN/EEG-ET/NDARPL501ZUU/NDARPL501ZUU_Video-DM_Samples_ET.mat, Despicable, 120, 3142907362, 3313453994, 170546632
/Volumes/methlab_data/HBN/EEG-ET/NDARPL501ZUU/NDARPL501ZUU_Video-FF_Samples_ET.mat, Fractals, 120, 2402083619, 2565069257, 162985638
/Volumes/methlab_data/HBN/EEG-ET/NDARPL501ZUU/NDARPL501ZUU_Video-TP_Samples_ET.mat, Present, 120, 4348129841, 4551206517, 203076676
/Volumes/methlab_data/HBN/EEG-ET/NDARPL501ZUU/NDARPL501ZUU_Video-WK_Samples_ET.mat, Diary, 120, 3649543127, 3766941433, 117398306
/Volumes/methlab_data/HBN/EEG-ET/NDARPL596YTD/NDARPL596YTD_Video1_Samples_ET.mat, Diary, 60, 2604440992, 2721834969, 117393977
/Volumes/methlab_data/HBN/EEG-ET/NDARPL596YTD/NDARPL596YTD_Video2_Samples_ET.mat, Fractals, 60, 3193402177, 3356385376, 162983199
/Volumes/methlab_data/HBN/EEG-ET/NDARPL596YTD/NDARPL596YTD_Video3_Samples_ET.mat, Despicable, 60, 3768861824, 3939405450, 170543626
/Volumes/methlab_data/HBN/EEG-ET/NDARPL596YTD/NDARPL596YTD_Video4_Samples_ET.mat, Present, 60, 4237171753, 4440227262, 203055509
/Volumes/methlab_data/HBN/EEG-ET/NDARPL598MVU/NDARPL598MVU_Video-DM_Samples_ET.mat, Despicable, 30, 2409172922, 2579711320, 170538398
/Volumes/methlab_data/HBN/EEG-ET/NDARPL598MVU/NDARPL598MVU_Video-TP_Samples_ET.mat, Present, 30, 3302536766, 3505806439, 203269673
/Volumes/methlab_data/HBN/EEG-ET/NDARPL598MVU/NDARPL598MVU_Video-WK_Samples_ET.mat, Diary, 30, 2226411854, 2343801408, 117389554
/Volumes/methlab_data/HBN/EEG-ET/NDARPL651MD5/NDARPL651MD5_Video-DM_Samples_ET.mat, Despicable, 30, 3946961245, 4117499580, 170538335
/Volumes/methlab_data/HBN/EEG-ET/NDARPL651MD5/NDARPL651MD5_Video-TP_Samples_ET.mat, Present, 30, 4932574386, 5135855015, 203280629
/Volumes/methlab_data/HBN/EEG-ET/NDARPL651MD5/NDARPL651MD5_Video-WK_Samples_ET.mat, Diary, 30, 3005459490, 3122845007, 117385517
/Volumes/methlab_data/HBN/EEG-ET/NDARPL721WTD/NDARPL721WTD_Video1_Samples_ET.mat, Diary, 60, 2882375176, 2999772132, 117396956
/Volumes/methlab_data/HBN/EEG-ET/NDARPM105MKA/NDARPM105MKA_Video1_Samples_ET.mat, Diary, 60, 2407609742, 2525003614, 117393872
/Volumes/methlab_data/HBN/EEG-ET/NDARPM105MKA/NDARPM105MKA_Video3_Samples_ET.mat, Despicable, 60, 1920304918, 2090848266, 170543348
/Volumes/methlab_data/HBN/EEG-ET/NDARPM172XGD/NDARPM172XGD_Video-DM_Samples_ET.mat, Despicable, 30, 2749514480, 2920050899, 170536419
/Volumes/methlab_data/HBN/EEG-ET/NDARPM172XGD/NDARPM172XGD_Video-TP_Samples_ET.mat, Present, 30, 3253548296, 3456813819, 203265523
/Volumes/methlab_data/HBN/EEG-ET/NDARPM172XGD/NDARPM172XGD_Video-WK_Samples_ET.mat, Diary, 30, 2366997472, 2484384353, 117386881
/Volumes/methlab_data/HBN/EEG-ET/NDARPN418ZKT/NDARPN418ZKT_Video1_Samples_ET.mat, Diary, 60, 2121317912, 2238713986, 117396074
/Volumes/methlab_data/HBN/EEG-ET/NDARPN418ZKT/NDARPN418ZKT_Video3_Samples_ET.mat, Despicable, 60, 1637920032, 1808456670, 170536638
/Volumes/methlab_data/HBN/EEG-ET/NDARPN886HH9/NDARPN886HH9_Video-DM_Samples_ET.mat, Despicable, 60, 5358398689, 5528940927, 170542238
/Volumes/methlab_data/HBN/EEG-ET/NDARPN886HH9/NDARPN886HH9_Video-FF_Samples_ET.mat, Fractals, 60, 4650974870, 4813962729, 162987859
/Volumes/methlab_data/HBN/EEG-ET/NDARPN886HH9/NDARPN886HH9_Video-TP_Samples_ET.mat, Present, 60, 6250051424, 6453118807, 203067383
/Volumes/methlab_data/HBN/EEG-ET/NDARPN886HH9/NDARPN886HH9_Video-WK_Samples_ET.mat, Diary, 60, 5807854123, 5925245562, 117391439
/Volumes/methlab_data/HBN/EEG-ET/NDARPP150TNR/NDARPP150TNR_Video-DM_Samples_ET.mat, Despicable, 120, 2254644104, 2425200309, 170556205
/Volumes/methlab_data/HBN/EEG-ET/NDARPP150TNR/NDARPP150TNR_Video-FF_Samples_ET.mat, Fractals, 120, 2471991913, 2634979833, 162987920
/Volumes/methlab_data/HBN/EEG-ET/NDARPP150TNR/NDARPP150TNR_Video-TP_Samples_ET.mat, Present, 120, 3000714714, 3203783406, 203068692
/Volumes/methlab_data/HBN/EEG-ET/NDARPP150TNR/NDARPP150TNR_Video-WK_Samples_ET.mat, Diary, 120, 2820091024, 2937487464, 117396440
/Volumes/methlab_data/HBN/EEG-ET/NDARPP622WV4/NDARPP622WV4_Video1_Samples_ET.mat, Diary, 60, 3511687616, 3629079630, 117392014
/Volumes/methlab_data/HBN/EEG-ET/NDARPP622WV4/NDARPP622WV4_Video2_Samples_ET.mat, Fractals, 60, 3970672241, 4133660535, 162988294
/Volumes/methlab_data/HBN/EEG-ET/NDARPP622WV4/NDARPP622WV4_Video3_Samples_ET.mat, Despicable, 60, 4401175717, 4571726389, 170550672
/Volumes/methlab_data/HBN/EEG-ET/NDARPP622WV4/NDARPP622WV4_Video4_Samples_ET.mat, Present, 60, 4948269688, 5151327295, 203057607
/Volumes/methlab_data/HBN/EEG-ET/NDARPP703NX4/NDARPP703NX4_Video3_Samples_ET.mat, Despicable, 60, 726435958, 766871627, 937420434
2.109845e+08, 1.705488e+08, /Volumes/methlab_data/HBN/EEG-ET/NDARPP726XBF/NDARPP726XBF_Video1_Samples_ET.mat, Diary, 60, 3787900709, 3905296788, 117396079
/Volumes/methlab_data/HBN/EEG-ET/NDARPP726XBF/NDARPP726XBF_Video2_Samples_ET.mat, Fractals, 60, 4711889536, 4874873899, 162984363
/Volumes/methlab_data/HBN/EEG-ET/NDARPP726XBF/NDARPP726XBF_Video3_Samples_ET.mat, Despicable, 60, 5221414073, 5391955808, 170541735
/Volumes/methlab_data/HBN/EEG-ET/NDARPP726XBF/NDARPP726XBF_Video4_Samples_ET.mat, Present, 60, 5736606647, 5939671368, 203064721
/Volumes/methlab_data/HBN/EEG-ET/NDARPR537HF5/NDARPR537HF5_Video-DM_Samples_ET.mat, Despicable, 60, 5299292562, 5469837795, 170545233
/Volumes/methlab_data/HBN/EEG-ET/NDARPR537HF5/NDARPR537HF5_Video-TP_Samples_ET.mat, Present, 60, 6067645234, 6270921549, 203276315
/Volumes/methlab_data/HBN/EEG-ET/NDARPR537HF5/NDARPR537HF5_Video-WK_Samples_ET.mat, Diary, 60, 5508569086, 5625956868, 117387782
/Volumes/methlab_data/HBN/EEG-ET/NDARPR799VX4/NDARPR799VX4_Video-DM_Samples_ET.mat, Despicable, 30, 2904006406, 3074545590, 170539184
/Volumes/methlab_data/HBN/EEG-ET/NDARPR799VX4/NDARPR799VX4_Video-TP_Samples_ET.mat, Present, 30, 3822877873, 4026155097, 203277224
/Volumes/methlab_data/HBN/EEG-ET/NDARPR799VX4/NDARPR799VX4_Video-WK_Samples_ET.mat, Diary, 30, 3336711288, 3454101008, 117389720
/Volumes/methlab_data/HBN/EEG-ET/NDARPT007UXR/NDARPT007UXR_Video1_Samples_ET.mat, Fractals, 120, 7124997401, 7287984123, 162986722
/Volumes/methlab_data/HBN/EEG-ET/NDARPT007UXR/NDARPT007UXR_Video2_Samples_ET.mat, Despicable, 120, 7806442733, 7976990026, 170547293
/Volumes/methlab_data/HBN/EEG-ET/NDARPT007UXR/NDARPT007UXR_Video3_Samples_ET.mat, Diary, 120, 8277489090, 8394879695, 117390605
/Volumes/methlab_data/HBN/EEG-ET/NDARPT007UXR/NDARPT007UXR_Video4_Samples_ET.mat, Present, 120, 8773648733, 8976714847, 203066114
/Volumes/methlab_data/HBN/EEG-ET/NDARPT417LW6/NDARPT417LW6_Video-DM_Samples_ET.mat, Despicable, 30, 2673987255, 2844525982, 170538727
/Volumes/methlab_data/HBN/EEG-ET/NDARPT417LW6/NDARPT417LW6_Video-TP_Samples_ET.mat, Present, 30, 3207081482, 3410361347, 203279865
/Volumes/methlab_data/HBN/EEG-ET/NDARPT417LW6/NDARPT417LW6_Video-WK_Samples_ET.mat, Diary, 30, 1167329110, 1284719187, 117390077
/Volumes/methlab_data/HBN/EEG-ET/NDARPT777FDA/NDARPT777FDA_Video-DM_Samples_ET.mat, Despicable, 60, 3632454806, 3802998669, 170543863
/Volumes/methlab_data/HBN/EEG-ET/NDARPT777FDA/NDARPT777FDA_Video-FF_Samples_ET.mat, Fractals, 60, 3420164605, 3583146937, 162982332
/Volumes/methlab_data/HBN/EEG-ET/NDARPT777FDA/NDARPT777FDA_Video-TP_Samples_ET.mat, Present, 60, 4147250082, 4350319811, 203069729
/Volumes/methlab_data/HBN/EEG-ET/NDARPT777FDA/NDARPT777FDA_Video-WK_Samples_ET.mat, Diary, 60, 3060044756, 3177440845, 117396089
/Volumes/methlab_data/HBN/EEG-ET/NDARPT890YBR/NDARPT890YBR_Video1_Samples_ET.mat, Diary, 60, 3445100803, 3562494080, 117393277
/Volumes/methlab_data/HBN/EEG-ET/NDARPT890YBR/NDARPT890YBR_Video2_Samples_ET.mat, Fractals, 60, 2343473436, 2506459029, 162985593
/Volumes/methlab_data/HBN/EEG-ET/NDARPT890YBR/NDARPT890YBR_Video3_Samples_ET.mat, Despicable, 60, 2985624905, 3156168887, 170543982
/Volumes/methlab_data/HBN/EEG-ET/NDARPT890YBR/NDARPT890YBR_Video4_Samples_ET.mat, Present, 60, 3871308126, 4074380193, 203072067
/Volumes/methlab_data/HBN/EEG-ET/NDARPT972NYX/NDARPT972NYX_Video-DM_Samples_ET.mat, Despicable, 30, 2371618559, 2542153798, 170535239
/Volumes/methlab_data/HBN/EEG-ET/NDARPT972NYX/NDARPT972NYX_Video-TP_Samples_ET.mat, Present, 30, 3042229308, 3245505626, 203276318
/Volumes/methlab_data/HBN/EEG-ET/NDARPT972NYX/NDARPT972NYX_Video-WK_Samples_ET.mat, Diary, 30, 2631304633, 2748691379, 117386746
/Volumes/methlab_data/HBN/EEG-ET/NDARPU329MDJ/NDARPU329MDJ_Video1_Samples_ET.mat, Fractals, 120, 3945122663, 4108118731, 162996068
/Volumes/methlab_data/HBN/EEG-ET/NDARPU329MDJ/NDARPU329MDJ_Video2_Samples_ET.mat, Despicable, 120, 5209959879, 5380504461, 170544582
/Volumes/methlab_data/HBN/EEG-ET/NDARPU329MDJ/NDARPU329MDJ_Video3_Samples_ET.mat, Diary, 120, 5803134566, 5920531965, 117397399
/Volumes/methlab_data/HBN/EEG-ET/NDARPU329MDJ/NDARPU329MDJ_Video4_Samples_ET.mat, Present, 120, 6460477396, 6663544026, 203066630
/Volumes/methlab_data/HBN/EEG-ET/NDARPU897CM5/NDARPU897CM5_Video1_Samples_ET.mat, Diary, 60, 2912314934, 3029706827, 117391893
/Volumes/methlab_data/HBN/EEG-ET/NDARPU897CM5/NDARPU897CM5_Video3_Samples_ET.mat, Despicable, 60, 3304118537, 3474666939, 170548402
/Volumes/methlab_data/HBN/EEG-ET/NDARPU981GWF/NDARPU981GWF_Video-DM_Samples_ET.mat, Despicable, 30, 6882722727, 7053261422, 170538695
/Volumes/methlab_data/HBN/EEG-ET/NDARPU981GWF/NDARPU981GWF_Video-TP_Samples_ET.mat, Present, 30, 7427211011, 7630478875, 203267864
/Volumes/methlab_data/HBN/EEG-ET/NDARPU981GWF/NDARPU981GWF_Video-WK_Samples_ET.mat, Diary, 30, 5637111290, 5754505398, 117394108
/Volumes/methlab_data/HBN/EEG-ET/NDARPV009TYX/NDARPV009TYX_Video1_Samples_ET.mat, Diary, 60, 1858014714, 1975409912, 117395198
/Volumes/methlab_data/HBN/EEG-ET/NDARPV009TYX/NDARPV009TYX_Video2_Samples_ET.mat, Fractals, 60, 2413389267, 2576372973, 162983706
/Volumes/methlab_data/HBN/EEG-ET/NDARPV009TYX/NDARPV009TYX_Video3_Samples_ET.mat, Despicable, 60, 2922151846, 3092694709, 170542863
/Volumes/methlab_data/HBN/EEG-ET/NDARPV009TYX/NDARPV009TYX_Video4_Samples_ET.mat, Present, 60, 3464265019, 3667325958, 203060939
/Volumes/methlab_data/HBN/EEG-ET/NDARPV145KGL/NDARPV145KGL_Video1_Samples_ET.mat, Diary, 120, 3691458060, 3808855231, 117397171
/Volumes/methlab_data/HBN/EEG-ET/NDARPV145KGL/NDARPV145KGL_Video2_Samples_ET.mat, Fractals, 120, 4998518536, 5161516123, 162997587
/Volumes/methlab_data/HBN/EEG-ET/NDARPV145KGL/NDARPV145KGL_Video3_Samples_ET.mat, Despicable, 120, 5625314484, 5795862644, 170548160
/Volumes/methlab_data/HBN/EEG-ET/NDARPV145KGL/NDARPV145KGL_Video4_Samples_ET.mat, Present, 120, 6392540322, 6595607846, 203067524
/Volumes/methlab_data/HBN/EEG-ET/NDARPV249ZRF/NDARPV249ZRF_Video1_Samples_ET.mat, Diary, 60, 5050135636, 5050141643, 6007
/Volumes/methlab_data/HBN/EEG-ET/NDARPV249ZRF/NDARPV249ZRF_Video3_Samples_ET.mat, Despicable, 60, 4435528796, 4606077200, 170548404
/Volumes/methlab_data/HBN/EEG-ET/NDARPV303LAX/NDARPV303LAX_Video1_Samples_ET.mat, Diary, 60, 4109625999, 4227019788, 117393789
/Volumes/methlab_data/HBN/EEG-ET/NDARPV303LAX/NDARPV303LAX_Video3_Samples_ET.mat, Despicable, 60, 3631990152, 3802532434, 170542282
/Volumes/methlab_data/HBN/EEG-ET/NDARPV303LAX/NDARPV303LAX_Video4_Samples_ET.mat, Present, 60, 4573027777, 4776100028, 203072251
/Volumes/methlab_data/HBN/EEG-ET/NDARPV412JEN/NDARPV412JEN_Video-DM_Samples_ET.mat, Despicable, 30, 4011281252, 4181826720, 170545468
/Volumes/methlab_data/HBN/EEG-ET/NDARPV412JEN/NDARPV412JEN_Video-TP_Samples_ET.mat, Present, 30, 4891211742, 5094477313, 203265571
/Volumes/methlab_data/HBN/EEG-ET/NDARPV412JEN/NDARPV412JEN_Video-WK_Samples_ET.mat, Diary, 30, 4461257059, 4578642994, 117385935
/Volumes/methlab_data/HBN/EEG-ET/NDARPV535ZUB/NDARPV535ZUB_Video1_Samples_ET.mat, Fractals, 120, 3560004503, 3722988320, 162983817
/Volumes/methlab_data/HBN/EEG-ET/NDARPV535ZUB/NDARPV535ZUB_Video2_Samples_ET.mat, Despicable, 120, 4498615643, 4669163386, 170547743
/Volumes/methlab_data/HBN/EEG-ET/NDARPV535ZUB/NDARPV535ZUB_Video3_Samples_ET.mat, Diary, 120, 4927817399, 5045204954, 117387555
/Volumes/methlab_data/HBN/EEG-ET/NDARPV535ZUB/NDARPV535ZUB_Video4_Samples_ET.mat, Present, 120, 5448630858, 5651698777, 203067919
/Volumes/methlab_data/HBN/EEG-ET/NDARPV595RWB/NDARPV595RWB_Video-DM_Samples_ET.mat, Despicable, 60, 4450203312, 4620751895, 170548583
/Volumes/methlab_data/HBN/EEG-ET/NDARPV595RWB/NDARPV595RWB_Video-FF_Samples_ET.mat, Fractals, 60, 3878800315, 4041786578, 162986263
/Volumes/methlab_data/HBN/EEG-ET/NDARPV595RWB/NDARPV595RWB_Video-TP_Samples_ET.mat, Present, 60, 5446217495, 5649287072, 203069577
/Volumes/methlab_data/HBN/EEG-ET/NDARPV595RWB/NDARPV595RWB_Video-WK_Samples_ET.mat, Diary, 60, 4993526422, 5110913495, 117387073
/Volumes/methlab_data/HBN/EEG-ET/NDARPW313LAJ/NDARPW313LAJ_Video1_Samples_ET.mat, Diary, 60, 1985085724, 2102480670, 117394946
/Volumes/methlab_data/HBN/EEG-ET/NDARPW482TVE/NDARPW482TVE_Video1_Samples_ET.mat, Diary, 60, 4444833639, 4562227222, 117393583
/Volumes/methlab_data/HBN/EEG-ET/NDARPW482TVE/NDARPW482TVE_Video3_Samples_ET.mat, Despicable, 60, 5714348180, 5884892609, 170544429
/Volumes/methlab_data/HBN/EEG-ET/NDARPW635LN4/NDARPW635LN4_Video1_Samples_ET.mat, Diary, 60, 3565985308, 3683373160, 117387852
/Volumes/methlab_data/HBN/EEG-ET/NDARPW635LN4/NDARPW635LN4_Video3_Samples_ET.mat, Despicable, 60, 3147270883, 3317820228, 170549345
/Volumes/methlab_data/HBN/EEG-ET/NDARPW746FWF/NDARPW746FWF_Video-DM_Samples_ET.mat, Despicable, 30, 4631317703, 4801856027, 170538324
/Volumes/methlab_data/HBN/EEG-ET/NDARPW746FWF/NDARPW746FWF_Video-TP_Samples_ET.mat, Present, 30, 5178875202, 5382139836, 203264634
/Volumes/methlab_data/HBN/EEG-ET/NDARPW746FWF/NDARPW746FWF_Video-WK_Samples_ET.mat, Diary, 30, 3383189814, 3500576334, 117386520
/Volumes/methlab_data/HBN/EEG-ET/NDARPW786GC4/NDARPW786GC4_Video1_Samples_ET.mat, Diary, 60, 3258622588, 3376016620, 117394032
/Volumes/methlab_data/HBN/EEG-ET/NDARPW786GC4/NDARPW786GC4_Video3_Samples_ET.mat, Despicable, 60, 4279600684, 4450140336, 170539652
/Volumes/methlab_data/HBN/EEG-ET/NDARPW915RGD/NDARPW915RGD_Video1_Samples_ET.mat, Diary, 60, 12449443055, 12566833393, 117390338
/Volumes/methlab_data/HBN/EEG-ET/NDARPW915RGD/NDARPW915RGD_Video3_Samples_ET.mat, Despicable, 60, 12237604726, 12408152794, 170548068
/Volumes/methlab_data/HBN/EEG-ET/NDARPW915RGD/NDARPW915RGD_Video4_Samples_ET.mat, Present, 60, 12846627925, 13049690084, 203062159
/Volumes/methlab_data/HBN/EEG-ET/NDARPX155RF3/NDARPX155RF3_Video1_Samples_ET.mat, Diary, 60, 3700006907, 3817404750, 117397843
/Volumes/methlab_data/HBN/EEG-ET/NDARPX155RF3/NDARPX155RF3_Video3_Samples_ET.mat, Despicable, 60, 4182043006, 4352585364, 170542358
/Volumes/methlab_data/HBN/EEG-ET/NDARPX219TW0/NDARPX219TW0_Video1_Samples_ET.mat, Diary, 120, 3387499267, 3504887324, 117388057
/Volumes/methlab_data/HBN/EEG-ET/NDARPX219TW0/NDARPX219TW0_Video2_Samples_ET.mat, Fractals, 120, 5078516890, 5241504326, 162987436
/Volumes/methlab_data/HBN/EEG-ET/NDARPX219TW0/NDARPX219TW0_Video3_Samples_ET.mat, Despicable, 120, 5413376131, 5583932962, 170556831
/Volumes/methlab_data/HBN/EEG-ET/NDARPX219TW0/NDARPX219TW0_Video4_Samples_ET.mat, Present, 120, 6009242252, 6212309172, 203066920
/Volumes/methlab_data/HBN/EEG-ET/NDARPX244EHJ/NDARPX244EHJ_Video1_Samples_ET.mat, Diary, 60, 1646812268, 1764205269, 117393001
/Volumes/methlab_data/HBN/EEG-ET/NDARPX244EHJ/NDARPX244EHJ_Video3_Samples_ET.mat, Despicable, 60, 2907166339, 3077704918, 170538579
/Volumes/methlab_data/HBN/EEG-ET/NDARPX661BF1/NDARPX661BF1_Video-DM_Samples_ET.mat, Despicable, 30, 3663484798, 3834021981, 170537183
/Volumes/methlab_data/HBN/EEG-ET/NDARPX661BF1/NDARPX661BF1_Video-TP_Samples_ET.mat, Present, 30, 4576894385, 4780168633, 203274248
/Volumes/methlab_data/HBN/EEG-ET/NDARPX661BF1/NDARPX661BF1_Video-WK_Samples_ET.mat, Diary, 30, 2802395075, 2919782811, 117387736
/Volumes/methlab_data/HBN/EEG-ET/NDARPX838GCD/NDARPX838GCD_Video1_Samples_ET.mat, Diary, 60, 3297720481, 3415114283, 117393802
/Volumes/methlab_data/HBN/EEG-ET/NDARPX838GCD/NDARPX838GCD_Video2_Samples_ET.mat, Fractals, 60, 3967214625, 4130198570, 162983945
/Volumes/methlab_data/HBN/EEG-ET/NDARPX838GCD/NDARPX838GCD_Video3_Samples_ET.mat, Despicable, 60, 4530473840, 4701018131, 170544291
/Volumes/methlab_data/HBN/EEG-ET/NDARPX838GCD/NDARPX838GCD_Video4_Samples_ET.mat, Present, 60, 4998262718, 5201319947, 203057229
/Volumes/methlab_data/HBN/EEG-ET/NDARPY302MV9/NDARPY302MV9_Video-DM_Samples_ET.mat, Despicable, 30, 3734717167, 3905253922, 170536755
/Volumes/methlab_data/HBN/EEG-ET/NDARPY302MV9/NDARPY302MV9_Video-TP_Samples_ET.mat, Present, 30, 4638238849, 4841514778, 203275929
/Volumes/methlab_data/HBN/EEG-ET/NDARPY302MV9/NDARPY302MV9_Video-WK_Samples_ET.mat, Diary, 30, 4185423428, 4302811386, 117387958
/Volumes/methlab_data/HBN/EEG-ET/NDARPY458LTR/NDARPY458LTR_Video-DM_Samples_ET.mat, Despicable, 60, 3145918910, 3316458257, 170539347
/Volumes/methlab_data/HBN/EEG-ET/NDARPY458LTR/NDARPY458LTR_Video-FF_Samples_ET.mat, Fractals, 60, 2690075262, 2853065303, 162990041
/Volumes/methlab_data/HBN/EEG-ET/NDARPY458LTR/NDARPY458LTR_Video-WK_Samples_ET.mat, Diary, 60, 2241014448, 2358403269, 117388821
/Volumes/methlab_data/HBN/EEG-ET/NDARPY478YM0/NDARPY478YM0_Video-DM_Samples_ET.mat, Despicable, 60, 5412078053, 5582617501, 170539448
/Volumes/methlab_data/HBN/EEG-ET/NDARPY478YM0/NDARPY478YM0_Video-FF_Samples_ET.mat, Fractals, 60, 4598873664, 4761862812, 162989148
/Volumes/methlab_data/HBN/EEG-ET/NDARPY478YM0/NDARPY478YM0_Video-TP_Samples_ET.mat, Present, 60, 6285549954, 6488612560, 203062606
/Volumes/methlab_data/HBN/EEG-ET/NDARPY478YM0/NDARPY478YM0_Video-WK_Samples_ET.mat, Diary, 60, 5851590479, 5968989398, 117398919
/Volumes/methlab_data/HBN/EEG-ET/NDARPZ020AH8/NDARPZ020AH8_Video-DM_Samples_ET.mat, Despicable, 60, 3547098676, 3717643932, 170545256
/Volumes/methlab_data/HBN/EEG-ET/NDARPZ020AH8/NDARPZ020AH8_Video-FF_Samples_ET.mat, Fractals, 60, 2930971348, 3093966269, 162994921
/Volumes/methlab_data/HBN/EEG-ET/NDARPZ020AH8/NDARPZ020AH8_Video-TP_Samples_ET.mat, Present, 60, 4527554211, 4730614385, 203060174
/Volumes/methlab_data/HBN/EEG-ET/NDARPZ344ZGE/NDARPZ344ZGE_Video1_Samples_ET.mat, Diary, 60, 4547577290, 4664976224, 117398934
/Volumes/methlab_data/HBN/EEG-ET/NDARPZ344ZGE/NDARPZ344ZGE_Video2_Samples_ET.mat, Fractals, 60, 3421028631, 3584017774, 162989143
/Volumes/methlab_data/HBN/EEG-ET/NDARPZ344ZGE/NDARPZ344ZGE_Video3_Samples_ET.mat, Despicable, 60, 4106953122, 4277496632, 170543510
/Volumes/methlab_data/HBN/EEG-ET/NDARPZ344ZGE/NDARPZ344ZGE_Video4_Samples_ET.mat, Present, 60, 4980968386, 5184039840, 203071454
/Volumes/methlab_data/HBN/EEG-ET/NDARPZ621ZLE/NDARPZ621ZLE_Video1_Samples_ET.mat, Diary, 60, 4244173352, 4361558343, 117384991
/Volumes/methlab_data/HBN/EEG-ET/NDARPZ621ZLE/NDARPZ621ZLE_Video3_Samples_ET.mat, Despicable, 60, 3779326760, 3949864276, 170537516
/Volumes/methlab_data/HBN/EEG-ET/NDARPZ720WKW/NDARPZ720WKW_Video-DM_Samples_ET.mat, Despicable, 120, 6150034023, 6320576847, 170542824
/Volumes/methlab_data/HBN/EEG-ET/NDARPZ720WKW/NDARPZ720WKW_Video-FF_Samples_ET.mat, Fractals, 120, 5585765789, 5748752667, 162986878
/Volumes/methlab_data/HBN/EEG-ET/NDARPZ720WKW/NDARPZ720WKW_Video-TP_Samples_ET.mat, Present, 120, 6907149206, 7110215828, 203066622
/Volumes/methlab_data/HBN/EEG-ET/NDARPZ720WKW/NDARPZ720WKW_Video-WK_Samples_ET.mat, Diary, 120, 4637221351, 4754609218, 117387867
/Volumes/methlab_data/HBN/EEG-ET/NDARPZ973RK0/NDARPZ973RK0_Video-DM_Samples_ET.mat, Despicable, 60, 5171514202, 5342057755, 170543553
/Volumes/methlab_data/HBN/EEG-ET/NDARPZ973RK0/NDARPZ973RK0_Video-FF_Samples_ET.mat, Fractals, 60, 4751972729, 4914951926, 162979197
/Volumes/methlab_data/HBN/EEG-ET/NDARPZ973RK0/NDARPZ973RK0_Video-TP_Samples_ET.mat, Present, 60, 5643156497, 5846221030, 203064533
/Volumes/methlab_data/HBN/EEG-ET/NDARPZ973RK0/NDARPZ973RK0_Video-WK_Samples_ET.mat, Diary, 60, 4063203023, 4180588994, 117385971
/Volumes/methlab_data/HBN/EEG-ET/NDARRA282PHP/NDARRA282PHP_Video-DM_Samples_ET.mat, Despicable, 30, 2838559392, 3009096022, 170536630
/Volumes/methlab_data/HBN/EEG-ET/NDARRA282PHP/NDARRA282PHP_Video-TP_Samples_ET.mat, Present, 30, 3731199728, 3934465527, 203265799
/Volumes/methlab_data/HBN/EEG-ET/NDARRA282PHP/NDARRA282PHP_Video-WK_Samples_ET.mat, Diary, 30, 3315032407, 3432422444, 117390037
/Volumes/methlab_data/HBN/EEG-ET/NDARRA383KVQ/NDARRA383KVQ_Video-DM_Samples_ET.mat, Despicable, 120, 7789060366, 7959602233, 170541867
/Volumes/methlab_data/HBN/EEG-ET/NDARRA383KVQ/NDARRA383KVQ_Video-FF_Samples_ET.mat, Fractals, 120, 8289767649, 8452754738, 162987089
/Volumes/methlab_data/HBN/EEG-ET/NDARRA383KVQ/NDARRA383KVQ_Video-TP_Samples_ET.mat, Present, 120, 8553036281, 8756103936, 203067655
/Volumes/methlab_data/HBN/EEG-ET/NDARRA383KVQ/NDARRA383KVQ_Video-WK_Samples_ET.mat, Diary, 120, 8066729457, 8184126412, 117396955
/Volumes/methlab_data/HBN/EEG-ET/NDARRA428WB9/NDARRA428WB9_Video-DM_Samples_ET.mat, Despicable, 30, 4110101815, 4280639565, 170537750
/Volumes/methlab_data/HBN/EEG-ET/NDARRA428WB9/NDARRA428WB9_Video-TP_Samples_ET.mat, Present, 30, 4806635945, 5009905882, 203269937
/Volumes/methlab_data/HBN/EEG-ET/NDARRA428WB9/NDARRA428WB9_Video-WK_Samples_ET.mat, Diary, 30, 3925125854, 4042512982, 117387128
/Volumes/methlab_data/HBN/EEG-ET/NDARRA537FWW/NDARRA537FWW_Video1_Samples_ET.mat, Diary, 60, 1978644409, 2096034631, 117390222
/Volumes/methlab_data/HBN/EEG-ET/NDARRA537FWW/NDARRA537FWW_Video3_Samples_ET.mat, Despicable, 60, 1761504295, 1932052300, 170548005
/Volumes/methlab_data/HBN/EEG-ET/NDARRA537FWW/NDARRA537FWW_Video4_Samples_ET.mat, Present, 60, 2377669376, 2580738435, 203069059
/Volumes/methlab_data/HBN/EEG-ET/NDARRA719CPH/NDARRA719CPH_Video1_Samples_ET.mat, Despicable, 120, 9212027995, 9382584649, 170556654
/Volumes/methlab_data/HBN/EEG-ET/NDARRA719CPH/NDARRA719CPH_Video2_Samples_ET.mat, Diary, 120, 10004753713, 10122150062, 117396349
/Volumes/methlab_data/HBN/EEG-ET/NDARRA719CPH/NDARRA719CPH_Video3_Samples_ET.mat, Fractals, 120, 10589888740, 10752877309, 162988569
/Volumes/methlab_data/HBN/EEG-ET/NDARRA767WB7/NDARRA767WB7_Video1_Samples_ET.mat, Diary, 60, 3008314334, 3125708663, 117394329
/Volumes/methlab_data/HBN/EEG-ET/NDARRA767WB7/NDARRA767WB7_Video3_Samples_ET.mat, Despicable, 60, 2782960417, 2953508452, 170548035
/Volumes/methlab_data/HBN/EEG-ET/NDARRA933RLX/NDARRA933RLX_Video1_Samples_ET.mat, Diary, 60, 4652876235, 4770266082, 117389847
/Volumes/methlab_data/HBN/EEG-ET/NDARRA933RLX/NDARRA933RLX_Video3_Samples_ET.mat, Despicable, 60, 5627993259, 5798541640, 170548381
/Volumes/methlab_data/HBN/EEG-ET/NDARRA933RLX/NDARRA933RLX_Video4_Samples_ET.mat, Present, 60, 6109855232, 6312923554, 203068322
/Volumes/methlab_data/HBN/EEG-ET/NDARRA981BCM/NDARRA981BCM_Video-DM_Samples_ET.mat, Despicable, 120, 5465878642, 5636424964, 170546322
/Volumes/methlab_data/HBN/EEG-ET/NDARRA981BCM/NDARRA981BCM_Video-FF_Samples_ET.mat, Fractals, 120, 4192256810, 4355242912, 162986102
/Volumes/methlab_data/HBN/EEG-ET/NDARRA981BCM/NDARRA981BCM_Video-TP_Samples_ET.mat, Present, 120, 6175003633, 6378071513, 203067880
/Volumes/methlab_data/HBN/EEG-ET/NDARRA981BCM/NDARRA981BCM_Video-WK_Samples_ET.mat, Diary, 120, 5063460142, 5180857914, 117397772
/Volumes/methlab_data/HBN/EEG-ET/NDARRB338YZ0/NDARRB338YZ0_Video1_Samples_ET.mat, Fractals, 120, 4894517228, 5057500068, 162982840
/Volumes/methlab_data/HBN/EEG-ET/NDARRB338YZ0/NDARRB338YZ0_Video2_Samples_ET.mat, Despicable, 120, 5743906630, 5914451088, 170544458
/Volumes/methlab_data/HBN/EEG-ET/NDARRB338YZ0/NDARRB338YZ0_Video3_Samples_ET.mat, Diary, 120, 6230599977, 6347996967, 117396990
/Volumes/methlab_data/HBN/EEG-ET/NDARRB338YZ0/NDARRB338YZ0_Video4_Samples_ET.mat, Present, 120, 6807026743, 7010093633, 203066890
/Volumes/methlab_data/HBN/EEG-ET/NDARRB561VCP/NDARRB561VCP_Video-DM_Samples_ET.mat, Despicable, 60, 4655887549, 4826424415, 170536866
/Volumes/methlab_data/HBN/EEG-ET/NDARRB561VCP/NDARRB561VCP_Video-TP_Samples_ET.mat, Present, 60, 5609172145, 5812451213, 203279068
/Volumes/methlab_data/HBN/EEG-ET/NDARRB561VCP/NDARRB561VCP_Video-WK_Samples_ET.mat, Diary, 60, 5155835841, 5273224074, 117388233
/Volumes/methlab_data/HBN/EEG-ET/NDARRB942UWU/NDARRB942UWU_Video1_Samples_ET.mat, Diary, 120, 2506921497, 2624319069, 117397572
/Volumes/methlab_data/HBN/EEG-ET/NDARRB942UWU/NDARRB942UWU_Video2_Samples_ET.mat, Fractals, 120, 3721222322, 3884211109, 162988787
/Volumes/methlab_data/HBN/EEG-ET/NDARRB942UWU/NDARRB942UWU_Video3_Samples_ET.mat, Despicable, 120, 4202763367, 4373304604, 170541237
/Volumes/methlab_data/HBN/EEG-ET/NDARRB942UWU/NDARRB942UWU_Video4_Samples_ET.mat, Present, 120, 4850705430, 5053772514, 203067084
/Volumes/methlab_data/HBN/EEG-ET/NDARRC016UZE/NDARRC016UZE_Video1_Samples_ET.mat, Fractals, 120, 3062185455, 3225171681, 162986226
/Volumes/methlab_data/HBN/EEG-ET/NDARRC016UZE/NDARRC016UZE_Video2_Samples_ET.mat, Despicable, 120, 4403075537, 4573623146, 170547609
/Volumes/methlab_data/HBN/EEG-ET/NDARRC016UZE/NDARRC016UZE_Video3_Samples_ET.mat, Diary, 120, 4888413303, 5005804791, 117391488
/Volumes/methlab_data/HBN/EEG-ET/NDARRC016UZE/NDARRC016UZE_Video4_Samples_ET.mat, Present, 120, 5503193750, 5706259477, 203065727
/Volumes/methlab_data/HBN/EEG-ET/NDARRC190NKB/NDARRC190NKB_Video1_Samples_ET.mat, Diary, 60, 4507960458, 4625357312, 117396854
/Volumes/methlab_data/HBN/EEG-ET/NDARRC190NKB/NDARRC190NKB_Video3_Samples_ET.mat, Despicable, 60, 4072616279, 4243167643, 170551364
/Volumes/methlab_data/HBN/EEG-ET/NDARRC348AFG/NDARRC348AFG_Video-DM_Samples_ET.mat, Despicable, 30, 3927234299, 4097768828, 170534529
/Volumes/methlab_data/HBN/EEG-ET/NDARRC348AFG/NDARRC348AFG_Video-TP_Samples_ET.mat, Present, 30, 4397943915, 4601219588, 203275673
/Volumes/methlab_data/HBN/EEG-ET/NDARRC348AFG/NDARRC348AFG_Video-WK_Samples_ET.mat, Diary, 30, 4176554476, 4293944463, 117389987
/Volumes/methlab_data/HBN/EEG-ET/NDARRC355BM6/NDARRC355BM6_Video1_Samples_ET.mat, Diary, 60, 3384489758, 3501881008, 117391250
/Volumes/methlab_data/HBN/EEG-ET/NDARRC355BM6/NDARRC355BM6_Video3_Samples_ET.mat, Despicable, 60, 3761197933, 3931739904, 170541971
/Volumes/methlab_data/HBN/EEG-ET/NDARRC355BM6/NDARRC355BM6_Video4_Samples_ET.mat, Present, 60, 4231220383, 4434291383, 203071000
/Volumes/methlab_data/HBN/EEG-ET/NDARRC819NLC/NDARRC819NLC_Video1_Samples_ET.mat, Diary, 60, 1865892260, 1983282341, 117390081
/Volumes/methlab_data/HBN/EEG-ET/NDARRC819NLC/NDARRC819NLC_Video3_Samples_ET.mat, Despicable, 60, 1567920396, 1738474121, 170553725
/Volumes/methlab_data/HBN/EEG-ET/NDARRC982ZE9/NDARRC982ZE9_Video1_Samples_ET.mat, Diary, 120, 3045002507, 3162399004, 117396497
/Volumes/methlab_data/HBN/EEG-ET/NDARRC982ZE9/NDARRC982ZE9_Video2_Samples_ET.mat, Fractals, 120, 3824161365, 3987155553, 162994188
/Volumes/methlab_data/HBN/EEG-ET/NDARRC982ZE9/NDARRC982ZE9_Video3_Samples_ET.mat, Despicable, 120, 4340375407, 4510922632, 170547225
/Volumes/methlab_data/HBN/EEG-ET/NDARRC982ZE9/NDARRC982ZE9_Video4_Samples_ET.mat, Present, 120, 5063761281, 5266828516, 203067235
/Volumes/methlab_data/HBN/EEG-ET/NDARRD326KB9/NDARRD326KB9_Video1_Samples_ET.mat, Diary, 60, 4305371179, 4422764310, 117393131
/Volumes/methlab_data/HBN/EEG-ET/NDARRD326KB9/NDARRD326KB9_Video3_Samples_ET.mat, Despicable, 60, 3690440846, 3860994583, 170553737
/Volumes/methlab_data/HBN/EEG-ET/NDARRD720XZK/NDARRD720XZK_Video1_Samples_ET.mat, Diary, 60, 3625677157, 3743072268, 117395111
/Volumes/methlab_data/HBN/EEG-ET/NDARRD720XZK/NDARRD720XZK_Video3_Samples_ET.mat, Despicable, 60, 3169662285, 3340205054, 170542769
/Volumes/methlab_data/HBN/EEG-ET/NDARRE063LG2/NDARRE063LG2_Video-WK_Samples_ET.mat, Diary, 60, 3347875542, 3465265437, 117389895
/Volumes/methlab_data/HBN/EEG-ET/NDARRE333EKT/NDARRE333EKT_Video1_Samples_ET.mat, Diary, 60, 3078825607, 3196219747, 117394140
/Volumes/methlab_data/HBN/EEG-ET/NDARRE333EKT/NDARRE333EKT_Video3_Samples_ET.mat, Despicable, 60, 3977525868, 4148068633, 170542765
/Volumes/methlab_data/HBN/EEG-ET/NDARRE445RHR/NDARRE445RHR_Video1_Samples_ET.mat, Fractals, 120, 8301504334, 8464489240, 162984906
/Volumes/methlab_data/HBN/EEG-ET/NDARRE445RHR/NDARRE445RHR_Video2_Samples_ET.mat, Despicable, 120, 9323956809, 9494502453, 170545644
/Volumes/methlab_data/HBN/EEG-ET/NDARRE445RHR/NDARRE445RHR_Video3_Samples_ET.mat, Diary, 120, 9801613433, 9919010046, 117396613
/Volumes/methlab_data/HBN/EEG-ET/NDARRE445RHR/NDARRE445RHR_Video4_Samples_ET.mat, Present, 120, 10404579366, 10607646762, 203067396
/Volumes/methlab_data/HBN/EEG-ET/NDARRF180JBU/NDARRF180JBU_Video1_Samples_ET.mat, Diary, 120, 2944242927, 3061640586, 117397659
/Volumes/methlab_data/HBN/EEG-ET/NDARRF180JBU/NDARRF180JBU_Video2_Samples_ET.mat, Fractals, 120, 3704767802, 3867755867, 162988065
/Volumes/methlab_data/HBN/EEG-ET/NDARRF180JBU/NDARRF180JBU_Video3_Samples_ET.mat, Despicable, 120, 4183745719, 4354293789, 170548070
/Volumes/methlab_data/HBN/EEG-ET/NDARRF180JBU/NDARRF180JBU_Video4_Samples_ET.mat, Present, 120, 4851612179, 5054680265, 203068086
/Volumes/methlab_data/HBN/EEG-ET/NDARRF415CBE/NDARRF415CBE_Video-DM_Samples_ET.mat, Despicable, 120, 8242503341, 8413050605, 170547264
/Volumes/methlab_data/HBN/EEG-ET/NDARRF415CBE/NDARRF415CBE_Video-FF_Samples_ET.mat, Fractals, 120, 7502529040, 7665525916, 162996876
/Volumes/methlab_data/HBN/EEG-ET/NDARRF415CBE/NDARRF415CBE_Video-TP_Samples_ET.mat, Present, 120, 9568665996, 9771729528, 203063532
/Volumes/methlab_data/HBN/EEG-ET/NDARRF415CBE/NDARRF415CBE_Video-WK_Samples_ET.mat, Diary, 120, 8916021034, 9033417672, 117396638
/Volumes/methlab_data/HBN/EEG-ET/NDARRF525ME3/NDARRF525ME3_Video-DM_Samples_ET.mat, Despicable, 60, 3805742587, 3976292925, 170550338
/Volumes/methlab_data/HBN/EEG-ET/NDARRF525ME3/NDARRF525ME3_Video-TP_Samples_ET.mat, Present, 60, 4510036266, 4713313638, 203277372
/Volumes/methlab_data/HBN/EEG-ET/NDARRF525ME3/NDARRF525ME3_Video-WK_Samples_ET.mat, Diary, 60, 4275718020, 4393104826, 117386806
/Volumes/methlab_data/HBN/EEG-ET/NDARRF897HB5/NDARRF897HB5_Video1_Samples_ET.mat, Diary, 60, 4239028042, 4356420075, 117392033
/Volumes/methlab_data/HBN/EEG-ET/NDARRF897HB5/NDARRF897HB5_Video3_Samples_ET.mat, Despicable, 60, 4839588787, 5010128418, 170539631
/Volumes/methlab_data/HBN/EEG-ET/NDARRG199RU4/NDARRG199RU4_Video1_Samples_ET.mat, Diary, 60, 1993765737, 2111153899, 117388162
/Volumes/methlab_data/HBN/EEG-ET/NDARRG199RU4/NDARRG199RU4_Video3_Samples_ET.mat, Despicable, 60, 3040446145, 3210993950, 170547805
/Volumes/methlab_data/HBN/EEG-ET/NDARRG269ML2/NDARRG269ML2_Video1_Samples_ET.mat, Diary, 60, 3845300390, 3962693236, 117392846
/Volumes/methlab_data/HBN/EEG-ET/NDARRG269ML2/NDARRG269ML2_Video2_Samples_ET.mat, Fractals, 60, 4888013076, 5051005123, 162992047
/Volumes/methlab_data/HBN/EEG-ET/NDARRG269ML2/NDARRG269ML2_Video3_Samples_ET.mat, Despicable, 60, 4389820594, 4560362935, 170542341
/Volumes/methlab_data/HBN/EEG-ET/NDARRG269ML2/NDARRG269ML2_Video4_Samples_ET.mat, Present, 60, 5421414460, 5624484776, 203070316
/Volumes/methlab_data/HBN/EEG-ET/NDARRG415BJM/NDARRG415BJM_Video1_Samples_ET.mat, Diary, 60, 6186116484, 6303506580, 117390096
/Volumes/methlab_data/HBN/EEG-ET/NDARRG415BJM/NDARRG415BJM_Video3_Samples_ET.mat, Despicable, 60, 5723929435, 5894470135, 170540700
/Volumes/methlab_data/HBN/EEG-ET/NDARRG499ZWN/NDARRG499ZWN_Video1_Samples_ET.mat, Diary, 60, 4229293861, 4346682922, 117389061
/Volumes/methlab_data/HBN/EEG-ET/NDARRG499ZWN/NDARRG499ZWN_Video3_Samples_ET.mat, Despicable, 60, 3529488897, 3700040552, 170551655
/Volumes/methlab_data/HBN/EEG-ET/NDARRG536CVP/NDARRG536CVP_Video-DM_Samples_ET.mat, Despicable, 120, 6043830506, 6214376666, 170546160
/Volumes/methlab_data/HBN/EEG-ET/NDARRG536CVP/NDARRG536CVP_Video-FF_Samples_ET.mat, Fractals, 120, 5784910150, 5947908314, 162998164
/Volumes/methlab_data/HBN/EEG-ET/NDARRG536CVP/NDARRG536CVP_Video-TP_Samples_ET.mat, Present, 120, 6292195599, 6495261610, 203066011
/Volumes/methlab_data/HBN/EEG-ET/NDARRG536CVP/NDARRG536CVP_Video-WK_Samples_ET.mat, Diary, 120, 5616232422, 5733619724, 117387302
/Volumes/methlab_data/HBN/EEG-ET/NDARRG735TU5/NDARRG735TU5_Video1_Samples_ET.mat, Diary, 60, 2097261333, 2214661190, 117399857
/Volumes/methlab_data/HBN/EEG-ET/NDARRG735TU5/NDARRG735TU5_Video3_Samples_ET.mat, Despicable, 60, 3533742869, 3704285229, 170542360
/Volumes/methlab_data/HBN/EEG-ET/NDARRH199NCH/NDARRH199NCH_Video-DM_Samples_ET.mat, Despicable, 60, 4223328552, 4393872281, 170543729
/Volumes/methlab_data/HBN/EEG-ET/NDARRH199NCH/NDARRH199NCH_Video-FF_Samples_ET.mat, Fractals, 60, 4671126553, 4834117980, 162991427
/Volumes/methlab_data/HBN/EEG-ET/NDARRH199NCH/NDARRH199NCH_Video-TP_Samples_ET.mat, Present, 60, 5190447219, 5393539037, 203091818
/Volumes/methlab_data/HBN/EEG-ET/NDARRH199NCH/NDARRH199NCH_Video-WK_Samples_ET.mat, Diary, 60, 3539109103, 3656506234, 117397131
/Volumes/methlab_data/HBN/EEG-ET/NDARRH285LR3/NDARRH285LR3_Video-DM_Samples_ET.mat, Despicable, 60, 4006010515, 4176550851, 170540336
/Volumes/methlab_data/HBN/EEG-ET/NDARRH285LR3/NDARRH285LR3_Video-FF_Samples_ET.mat, Fractals, 60, 3256591018, 3419574977, 162983959
/Volumes/methlab_data/HBN/EEG-ET/NDARRH285LR3/NDARRH285LR3_Video-TP_Samples_ET.mat, Present, 60, 4899816849, 5102877077, 203060228
/Volumes/methlab_data/HBN/EEG-ET/NDARRH285LR3/NDARRH285LR3_Video-WK_Samples_ET.mat, Diary, 60, 4459621431, 4577017233, 117395802
/Volumes/methlab_data/HBN/EEG-ET/NDARRH407MEY/NDARRH407MEY_Video1_Samples_ET.mat, Diary, 120, 5727441001, 5844827050, 117386049
/Volumes/methlab_data/HBN/EEG-ET/NDARRH407MEY/NDARRH407MEY_Video2_Samples_ET.mat, Fractals, 120, 5890628662, 6053626353, 162997691
/Volumes/methlab_data/HBN/EEG-ET/NDARRH407MEY/NDARRH407MEY_Video3_Samples_ET.mat, Despicable, 120, 6142007771, 6312554239, 170546468
/Volumes/methlab_data/HBN/EEG-ET/NDARRH407MEY/NDARRH407MEY_Video4_Samples_ET.mat, Present, 120, 6397055728, 6600122394, 203066666
/Volumes/methlab_data/HBN/EEG-ET/NDARRH725XYA/NDARRH725XYA_Video1_Samples_ET.mat, Diary, 60, 1653026175, 1770423615, 117397440
/Volumes/methlab_data/HBN/EEG-ET/NDARRH725XYA/NDARRH725XYA_Video3_Samples_ET.mat, Despicable, 60, 2838956653, 3009503832, 170547179
/Volumes/methlab_data/HBN/EEG-ET/NDARRJ130PV7/NDARRJ130PV7_Video-DM_Samples_ET.mat, Despicable, 120, 4282966894, 4453514773, 170547879
/Volumes/methlab_data/HBN/EEG-ET/NDARRJ130PV7/NDARRJ130PV7_Video-FF_Samples_ET.mat, Fractals, 120, 3804869652, 3967857979, 162988327
/Volumes/methlab_data/HBN/EEG-ET/NDARRJ130PV7/NDARRJ130PV7_Video-TP_Samples_ET.mat, Present, 120, 4958624117, 5161690930, 203066813
/Volumes/methlab_data/HBN/EEG-ET/NDARRJ130PV7/NDARRJ130PV7_Video-WK_Samples_ET.mat, Diary, 120, 3150103273, 3267490625, 117387352
/Volumes/methlab_data/HBN/EEG-ET/NDARRK038CBD/NDARRK038CBD_Video1_Samples_ET.mat, Diary, 60, 5745173863, 5862567853, 117393990
/Volumes/methlab_data/HBN/EEG-ET/NDARRK038CBD/NDARRK038CBD_Video3_Samples_ET.mat, Despicable, 60, 5287260277, 5457803819, 170543542
/Volumes/methlab_data/HBN/EEG-ET/NDARRK038CBD/NDARRK038CBD_Video4_Samples_ET.mat, Present, 60, 6233575980, 6436647543, 203071563
/Volumes/methlab_data/HBN/EEG-ET/NDARRK135YAZ/NDARRK135YAZ_Video-DM_Samples_ET.mat, Despicable, 120, 5098053273, 5268597934, 170544661
/Volumes/methlab_data/HBN/EEG-ET/NDARRK135YAZ/NDARRK135YAZ_Video-FF_Samples_ET.mat, Fractals, 120, 5551432815, 5714422700, 162989885
/Volumes/methlab_data/HBN/EEG-ET/NDARRK135YAZ/NDARRK135YAZ_Video-TP_Samples_ET.mat, Present, 120, 6150808840, 6353876360, 203067520
/Volumes/methlab_data/HBN/EEG-ET/NDARRK135YAZ/NDARRK135YAZ_Video-WK_Samples_ET.mat, Diary, 120, 3908363027, 4025759887, 117396860
/Volumes/methlab_data/HBN/EEG-ET/NDARRK163VY8/NDARRK163VY8_Video-DM_Samples_ET.mat, Despicable, 120, 4082936143, 4253483804, 170547661
/Volumes/methlab_data/HBN/EEG-ET/NDARRK163VY8/NDARRK163VY8_Video-FF_Samples_ET.mat, Fractals, 120, 4553633025, 4716620977, 162987952
/Volumes/methlab_data/HBN/EEG-ET/NDARRK163VY8/NDARRK163VY8_Video-TP_Samples_ET.mat, Present, 120, 5220691278, 5423756888, 203065610
/Volumes/methlab_data/HBN/EEG-ET/NDARRK163VY8/NDARRK163VY8_Video-WK_Samples_ET.mat, Diary, 120, 3205451859, 3322849971, 117398112
/Volumes/methlab_data/HBN/EEG-ET/NDARRK370YFX/NDARRK370YFX_Video1_Samples_ET.mat, Diary, 120, 2292843882, 2410240497, 117396615
/Volumes/methlab_data/HBN/EEG-ET/NDARRK370YFX/NDARRK370YFX_Video2_Samples_ET.mat, Despicable, 120, 3463277103, 3633819738, 170542635
/Volumes/methlab_data/HBN/EEG-ET/NDARRK370YFX/NDARRK370YFX_Video3_Samples_ET.mat, Fractals, 120, 3967523130, 4130510594, 162987464
/Volumes/methlab_data/HBN/EEG-ET/NDARRK370YFX/NDARRK370YFX_Video4_Samples_ET.mat, Present, 120, 4664169489, 4867236878, 203067389
/Volumes/methlab_data/HBN/EEG-ET/NDARRK457MBX/NDARRK457MBX_Video1_Samples_ET.mat, Diary, 60, 866577691, 983967556, 117389865
/Volumes/methlab_data/HBN/EEG-ET/NDARRK457MBX/NDARRK457MBX_Video3_Samples_ET.mat, Despicable, 60, 653198190, 823746512, 170548322
/Volumes/methlab_data/HBN/EEG-ET/NDARRK882CLT/NDARRK882CLT_Video1_Samples_ET.mat, Diary, 60, 3643849798, 3761247135, 117397337
/Volumes/methlab_data/HBN/EEG-ET/NDARRK882CLT/NDARRK882CLT_Video3_Samples_ET.mat, Despicable, 60, 3229459714, 3400005767, 170546053
/Volumes/methlab_data/HBN/EEG-ET/NDARRL030XD8/NDARRL030XD8_Video-DM_Samples_ET.mat, Despicable, 60, 6950779857, 7121319339, 170539482
/Volumes/methlab_data/HBN/EEG-ET/NDARRL030XD8/NDARRL030XD8_Video-TP_Samples_ET.mat, Present, 60, 7447495686, 7650775283, 203279597
/Volumes/methlab_data/HBN/EEG-ET/NDARRL030XD8/NDARRL030XD8_Video-WK_Samples_ET.mat, Diary, 60, 5719303091, 5836692026, 117388935
/Volumes/methlab_data/HBN/EEG-ET/NDARRL315KV3/NDARRL315KV3_Video1_Samples_ET.mat, Diary, 120, 2545595587, 2662987742, 117392155
/Volumes/methlab_data/HBN/EEG-ET/NDARRL315KV3/NDARRL315KV3_Video2_Samples_ET.mat, Fractals, 120, 3614618183, 3777607076, 162988893
/Volumes/methlab_data/HBN/EEG-ET/NDARRL315KV3/NDARRL315KV3_Video3_Samples_ET.mat, Despicable, 120, 4194125488, 4364673751, 170548263
/Volumes/methlab_data/HBN/EEG-ET/NDARRL315KV3/NDARRL315KV3_Video4_Samples_ET.mat, Present, 120, 4937739097, 5140804126, 203065029
/Volumes/methlab_data/HBN/EEG-ET/NDARRL379BET/NDARRL379BET_Video-DM_Samples_ET.mat, Despicable, 60, 3617800535, 3788337124, 170536589
/Volumes/methlab_data/HBN/EEG-ET/NDARRL379BET/NDARRL379BET_Video-TP_Samples_ET.mat, Present, 60, 4528480380, 4731747130, 203266750
/Volumes/methlab_data/HBN/EEG-ET/NDARRL379BET/NDARRL379BET_Video-WK_Samples_ET.mat, Diary, 60, 4098157150, 4215543161, 117386011
/Volumes/methlab_data/HBN/EEG-ET/NDARRL660CME/NDARRL660CME_Video1_Samples_ET.mat, Diary, 60, 2160709649, 2278105720, 117396071
/Volumes/methlab_data/HBN/EEG-ET/NDARRL660CME/NDARRL660CME_Video3_Samples_ET.mat, Despicable, 60, 3070950473, 3241492085, 170541612
/Volumes/methlab_data/HBN/EEG-ET/NDARRL685WB7/NDARRL685WB7_Video1_Samples_ET.mat, Diary, 60, 17324587473, 17441981064, 117393591
/Volumes/methlab_data/HBN/EEG-ET/NDARRL685WB7/NDARRL685WB7_Video3_Samples_ET.mat, Despicable, 60, 16810813467, 16981355867, 170542400
/Volumes/methlab_data/HBN/EEG-ET/NDARRM073JKA/NDARRM073JKA_Video-DM_Samples_ET.mat, Despicable, 60, 2883502826, 3054046398, 170543572
/Volumes/methlab_data/HBN/EEG-ET/NDARRM073JKA/NDARRM073JKA_Video-FF_Samples_ET.mat, Fractals, 60, 2422958411, 2585942572, 162984161
/Volumes/methlab_data/HBN/EEG-ET/NDARRM073JKA/NDARRM073JKA_Video-TP_Samples_ET.mat, Present, 60, 3367535857, 3570597365, 203061508
/Volumes/methlab_data/HBN/EEG-ET/NDARRM073JKA/NDARRM073JKA_Video-WK_Samples_ET.mat, Diary, 60, 1793191364, 1910586329, 117394965
/Volumes/methlab_data/HBN/EEG-ET/NDARRM122UPB/NDARRM122UPB_Video1_Samples_ET.mat, Diary, 120, 4115878002, 4233271533, 117393531
/Volumes/methlab_data/HBN/EEG-ET/NDARRM122UPB/NDARRM122UPB_Video2_Samples_ET.mat, Fractals, 120, 4922829208, 5085816034, 162986826
/Volumes/methlab_data/HBN/EEG-ET/NDARRM122UPB/NDARRM122UPB_Video3_Samples_ET.mat, Despicable, 120, 5425991209, 5596534053, 170542844
/Volumes/methlab_data/HBN/EEG-ET/NDARRM122UPB/NDARRM122UPB_Video4_Samples_ET.mat, Present, 120, 6170049600, 6373115913, 203066313
/Volumes/methlab_data/HBN/EEG-ET/NDARRM347FHQ/NDARRM347FHQ_Video1_Samples_ET.mat, Diary, 120, 3860979696, 3978376076, 117396380
/Volumes/methlab_data/HBN/EEG-ET/NDARRM347FHQ/NDARRM347FHQ_Video2_Samples_ET.mat, Fractals, 120, 4020855043, 4183842190, 162987147
/Volumes/methlab_data/HBN/EEG-ET/NDARRM347FHQ/NDARRM347FHQ_Video3_Samples_ET.mat, Despicable, 120, 4312166395, 4482712787, 170546392
/Volumes/methlab_data/HBN/EEG-ET/NDARRM347FHQ/NDARRM347FHQ_Video4_Samples_ET.mat, Present, 120, 4589514446, 4792580981, 203066535
/Volumes/methlab_data/HBN/EEG-ET/NDARRM467NP2/NDARRM467NP2_Video1_Samples_ET.mat, Diary, 60, 762379222, 879771347, 117392125
/Volumes/methlab_data/HBN/EEG-ET/NDARRM467NP2/NDARRM467NP2_Video3_Samples_ET.mat, Despicable, 60, 549447470, 719989272, 170541802
/Volumes/methlab_data/HBN/EEG-ET/NDARRM586XYL/NDARRM586XYL_Video1_Samples_ET.mat, Fractals, 120, 2907145631, 3070141915, 162996284
/Volumes/methlab_data/HBN/EEG-ET/NDARRM586XYL/NDARRM586XYL_Video2_Samples_ET.mat, Despicable, 120, 3888039360, 4058586333, 170546973
/Volumes/methlab_data/HBN/EEG-ET/NDARRM586XYL/NDARRM586XYL_Video3_Samples_ET.mat, Diary, 120, 4392915292, 4510313356, 117398064
/Volumes/methlab_data/HBN/EEG-ET/NDARRM586XYL/NDARRM586XYL_Video4_Samples_ET.mat, Present, 120, 5031491946, 5234559453, 203067507
/Volumes/methlab_data/HBN/EEG-ET/NDARRM725BRV/NDARRM725BRV_Video-DM_Samples_ET.mat, Despicable, 60, 2936135343, 3106684652, 170549309
/Volumes/methlab_data/HBN/EEG-ET/NDARRM725BRV/NDARRM725BRV_Video-TP_Samples_ET.mat, Present, 60, 3902296719, 4105574077, 203277358
/Volumes/methlab_data/HBN/EEG-ET/NDARRM725BRV/NDARRM725BRV_Video-WK_Samples_ET.mat, Diary, 60, 3456801619, 3574189356, 117387737
/Volumes/methlab_data/HBN/EEG-ET/NDARRM977YKB/NDARRM977YKB_Video-DM_Samples_ET.mat, Despicable, 60, 3149379830, 3319920470, 170540640
/Volumes/methlab_data/HBN/EEG-ET/NDARRM977YKB/NDARRM977YKB_Video-FF_Samples_ET.mat, Fractals, 60, 2548407766, 2711396069, 162988303
/Volumes/methlab_data/HBN/EEG-ET/NDARRM977YKB/NDARRM977YKB_Video-TP_Samples_ET.mat, Present, 60, 3643059016, 3846122626, 203063610
/Volumes/methlab_data/HBN/EEG-ET/NDARRM977YKB/NDARRM977YKB_Video-WK_Samples_ET.mat, Diary, 60, 1786202684, 1903599748, 117397064
/Volumes/methlab_data/HBN/EEG-ET/NDARRN444MJG/NDARRN444MJG_Video1_Samples_ET.mat, Diary, 120, 4219100241, 4336497510, 117397269
/Volumes/methlab_data/HBN/EEG-ET/NDARRN444MJG/NDARRN444MJG_Video2_Samples_ET.mat, Despicable, 120, 6325296649, 6495842460, 170545811
/Volumes/methlab_data/HBN/EEG-ET/NDARRN444MJG/NDARRN444MJG_Video3_Samples_ET.mat, Fractals, 120, 6802351390, 6965338541, 162987151
/Volumes/methlab_data/HBN/EEG-ET/NDARRN444MJG/NDARRN444MJG_Video4_Samples_ET.mat, Present, 120, 7535246923, 7738314103, 203067180
/Volumes/methlab_data/HBN/EEG-ET/NDARRN619WHY/NDARRN619WHY_Video1_Samples_ET.mat, Diary, 60, 3444399429, 3561798519, 117399090
/Volumes/methlab_data/HBN/EEG-ET/NDARRN619WHY/NDARRN619WHY_Video3_Samples_ET.mat, Despicable, 60, 4085970403, 4256513115, 170542712
/Volumes/methlab_data/HBN/EEG-ET/NDARRP008LJ6/NDARRP008LJ6_Video-DM_Samples_ET.mat, Despicable, 60, 4322246457, 4492787027, 170540570
/Volumes/methlab_data/HBN/EEG-ET/NDARRP008LJ6/NDARRP008LJ6_Video-FF_Samples_ET.mat, Fractals, 60, 4751052619, 4914034880, 162982261
/Volumes/methlab_data/HBN/EEG-ET/NDARRP008LJ6/NDARRP008LJ6_Video-TP_Samples_ET.mat, Present, 60, 5298307530, 5501366141, 203058611
/Volumes/methlab_data/HBN/EEG-ET/NDARRP008LJ6/NDARRP008LJ6_Video-WK_Samples_ET.mat, Diary, 60, 3732012178, 3849409169, 117396991
/Volumes/methlab_data/HBN/EEG-ET/NDARRP163YRC/NDARRP163YRC_Video1_Samples_ET.mat, Diary, 120, 2763568418, 2880956604, 117388186
/Volumes/methlab_data/HBN/EEG-ET/NDARRP163YRC/NDARRP163YRC_Video2_Samples_ET.mat, Fractals, 120, 4403936700, 4566924055, 162987355
/Volumes/methlab_data/HBN/EEG-ET/NDARRP163YRC/NDARRP163YRC_Video3_Samples_ET.mat, Despicable, 120, 4838213481, 5008771194, 170557713
/Volumes/methlab_data/HBN/EEG-ET/NDARRP163YRC/NDARRP163YRC_Video4_Samples_ET.mat, Present, 120, 5504501051, 5707565795, 203064744
/Volumes/methlab_data/HBN/EEG-ET/NDARRP384BVX/NDARRP384BVX_Video1_Samples_ET.mat, Fractals, 120, 6029237155, 6192223999, 162986844
/Volumes/methlab_data/HBN/EEG-ET/NDARRP384BVX/NDARRP384BVX_Video2_Samples_ET.mat, Diary, 120, 7578997542, 7696386515, 117388973
/Volumes/methlab_data/HBN/EEG-ET/NDARRP384BVX/NDARRP384BVX_Video3_Samples_ET.mat, Despicable, 120, 8050225361, 8220772760, 170547399
/Volumes/methlab_data/HBN/EEG-ET/NDARRP384BVX/NDARRP384BVX_Video4_Samples_ET.mat, Present, 120, 8817531385, 9020598057, 203066672
/Volumes/methlab_data/HBN/EEG-ET/NDARRP592GHK/NDARRP592GHK_Video1_Samples_ET.mat, Diary, 60, 2045337515, 2162733436, 117395921
/Volumes/methlab_data/HBN/EEG-ET/NDARRP592GHK/NDARRP592GHK_Video3_Samples_ET.mat, Despicable, 60, 3459789034, 3630332454, 170543420
/Volumes/methlab_data/HBN/EEG-ET/NDARRP609JH2/NDARRP609JH2_Video-DM_Samples_ET.mat, Despicable, 30, 2567875580, 2738414366, 170538786
/Volumes/methlab_data/HBN/EEG-ET/NDARRP609JH2/NDARRP609JH2_Video-TP_Samples_ET.mat, Present, 30, 3484098546, 3687374559, 203276013
/Volumes/methlab_data/HBN/EEG-ET/NDARRP609JH2/NDARRP609JH2_Video-WK_Samples_ET.mat, Diary, 30, 2989672328, 3107062543, 117390215
/Volumes/methlab_data/HBN/EEG-ET/NDARRP614EBU/NDARRP614EBU_Video-DM_Samples_ET.mat, Despicable, 120, 3587832187, 3758376358, 170544171
/Volumes/methlab_data/HBN/EEG-ET/NDARRP614EBU/NDARRP614EBU_Video-FF_Samples_ET.mat, Fractals, 120, 3192280016, 3355264827, 162984811
/Volumes/methlab_data/HBN/EEG-ET/NDARRP614EBU/NDARRP614EBU_Video-TP_Samples_ET.mat, Present, 120, 4223571441, 4426633922, 203062481
/Volumes/methlab_data/HBN/EEG-ET/NDARRP614EBU/NDARRP614EBU_Video-WK_Samples_ET.mat, Diary, 120, 2496304510, 2613699058, 117394548
/Volumes/methlab_data/HBN/EEG-ET/NDARRP801AX1/NDARRP801AX1_Video-DM_Samples_ET.mat, Despicable, 60, 2491830230, 2662372967, 170542737
/Volumes/methlab_data/HBN/EEG-ET/NDARRP801AX1/NDARRP801AX1_Video-FF_Samples_ET.mat, Fractals, 60, 1989137512, 2152116867, 162979355
/Volumes/methlab_data/HBN/EEG-ET/NDARRP801AX1/NDARRP801AX1_Video-TP_Samples_ET.mat, Present, 60, 3448752837, 3651780054, 203027217
/Volumes/methlab_data/HBN/EEG-ET/NDARRP801AX1/NDARRP801AX1_Video-WK_Samples_ET.mat, Diary, 60, 2948834634, 3066229719, 117395085
/Volumes/methlab_data/HBN/EEG-ET/NDARRP818DWL/NDARRP818DWL_Video1_Samples_ET.mat, Diary, 60, 3397102418, 3514496415, 117393997
/Volumes/methlab_data/HBN/EEG-ET/NDARRP818DWL/NDARRP818DWL_Video3_Samples_ET.mat, Despicable, 60, 2958618576, 3129159130, 170540554
/Volumes/methlab_data/HBN/EEG-ET/NDARRR464UTB/NDARRR464UTB_Video-DM_Samples_ET.mat, Despicable, 30, 4280884980, 4451422662, 170537682
/Volumes/methlab_data/HBN/EEG-ET/NDARRR464UTB/NDARRR464UTB_Video-TP_Samples_ET.mat, Present, 30, 4755709840, 4958975593, 203265753
/Volumes/methlab_data/HBN/EEG-ET/NDARRR464UTB/NDARRR464UTB_Video-WK_Samples_ET.mat, Diary, 30, 3804331941, 3921718989, 117387048
/Volumes/methlab_data/HBN/EEG-ET/NDARRR595LRJ/NDARRR595LRJ_Video-DM_Samples_ET.mat, Despicable, 60, 12473133735, 12643685351, 170551616
/Volumes/methlab_data/HBN/EEG-ET/NDARRR595LRJ/NDARRR595LRJ_Video-FF_Samples_ET.mat, Fractals, 60, 11466117766, 11629105007, 162987241
/Volumes/methlab_data/HBN/EEG-ET/NDARRR595LRJ/NDARRR595LRJ_Video-TP_Samples_ET.mat, Present, 60, 13395608929, 13598681507, 203072578
/Volumes/methlab_data/HBN/EEG-ET/NDARRR595LRJ/NDARRR595LRJ_Video-WK_Samples_ET.mat, Diary, 60, 12941177644, 13058564640, 117386996
/Volumes/methlab_data/HBN/EEG-ET/NDARRR735VMN/NDARRR735VMN_Video-DM_Samples_ET.mat, Despicable, 60, 3755642455, 3926191120, 170548665
/Volumes/methlab_data/HBN/EEG-ET/NDARRR735VMN/NDARRR735VMN_Video-FF_Samples_ET.mat, Fractals, 60, 2781229303, 2944215619, 162986316
/Volumes/methlab_data/HBN/EEG-ET/NDARRR735VMN/NDARRR735VMN_Video-TP_Samples_ET.mat, Present, 60, 4258497114, 4461564752, 203067638
/Volumes/methlab_data/HBN/EEG-ET/NDARRR735VMN/NDARRR735VMN_Video-WK_Samples_ET.mat, Diary, 60, 3317700716, 3435088761, 117388045
/Volumes/methlab_data/HBN/EEG-ET/NDARRR813CY6/NDARRR813CY6_Video1_Samples_ET.mat, Diary, 60, 3592461663, 3709858135, 117396472
/Volumes/methlab_data/HBN/EEG-ET/NDARRR813CY6/NDARRR813CY6_Video2_Samples_ET.mat, Fractals, 60, 4342250600, 4505235442, 162984842
/Volumes/methlab_data/HBN/EEG-ET/NDARRR813CY6/NDARRR813CY6_Video3_Samples_ET.mat, Despicable, 60, 4811215898, 4981761129, 170545231
/Volumes/methlab_data/HBN/EEG-ET/NDARRR813CY6/NDARRR813CY6_Video4_Samples_ET.mat, Present, 60, 5304701628, 5507767976, 203066348
/Volumes/methlab_data/HBN/EEG-ET/NDARRT038VG1/NDARRT038VG1_Video1_Samples_ET.mat, Diary, 60, 113129509, 230519803, 117390294
/Volumes/methlab_data/HBN/EEG-ET/NDARRT038VG1/NDARRT038VG1_Video3_Samples_ET.mat, Despicable, 60, 848997028, 1019537249, 170540221
/Volumes/methlab_data/HBN/EEG-ET/NDARRU290EZV/NDARRU290EZV_Video1_Samples_ET.mat, Diary, 60, 3291262329, 3408656452, 117394123
/Volumes/methlab_data/HBN/EEG-ET/NDARRU290EZV/NDARRU290EZV_Video2_Samples_ET.mat, Fractals, 60, 2590073902, 2753056306, 162982404
/Volumes/methlab_data/HBN/EEG-ET/NDARRU290EZV/NDARRU290EZV_Video3_Samples_ET.mat, Despicable, 60, 3740476375, 3911023151, 170546776
/Volumes/methlab_data/HBN/EEG-ET/NDARRU290EZV/NDARRU290EZV_Video4_Samples_ET.mat, Present, 60, 4255460954, 4458521744, 203060790
/Volumes/methlab_data/HBN/EEG-ET/NDARRU399NYG/NDARRU399NYG_Video1_Samples_ET.mat, Diary, 60, 6173912974, 6291301733, 117388759
/Volumes/methlab_data/HBN/EEG-ET/NDARRU399NYG/NDARRU399NYG_Video2_Samples_ET.mat, Fractals, 60, 4927511463, 5090495472, 162984009
/Volumes/methlab_data/HBN/EEG-ET/NDARRU399NYG/NDARRU399NYG_Video3_Samples_ET.mat, Despicable, 60, 5671398332, 5841941673, 170543341
/Volumes/methlab_data/HBN/EEG-ET/NDARRU399NYG/NDARRU399NYG_Video4_Samples_ET.mat, Present, 60, 6675825025, 6878895333, 203070308
/Volumes/methlab_data/HBN/EEG-ET/NDARRU499DP2/NDARRU499DP2_Video-DM_Samples_ET.mat, Despicable, 120, 4540141397, 4710684645, 170543248
/Volumes/methlab_data/HBN/EEG-ET/NDARRU499DP2/NDARRU499DP2_Video-FF_Samples_ET.mat, Fractals, 120, 3717043489, 3880027312, 162983823
/Volumes/methlab_data/HBN/EEG-ET/NDARRU499DP2/NDARRU499DP2_Video-TP_Samples_ET.mat, Present, 120, 5751735116, 5954800950, 203065834
/Volumes/methlab_data/HBN/EEG-ET/NDARRU499DP2/NDARRU499DP2_Video-WK_Samples_ET.mat, Diary, 120, 5110698486, 5228095956, 117397470
/Volumes/methlab_data/HBN/EEG-ET/NDARRU729XRU/NDARRU729XRU_Video1_Samples_ET.mat, Diary, 60, 3487284523, 3604674489, 117389966
/Volumes/methlab_data/HBN/EEG-ET/NDARRU729XRU/NDARRU729XRU_Video2_Samples_ET.mat, Fractals, 60, 3913786913, 4076773115, 162986202
/Volumes/methlab_data/HBN/EEG-ET/NDARRU729XRU/NDARRU729XRU_Video3_Samples_ET.mat, Despicable, 60, 2777578020, 2948117539, 170539519
/Volumes/methlab_data/HBN/EEG-ET/NDARRU729XRU/NDARRU729XRU_Video4_Samples_ET.mat, Present, 60, 4404522669, 4607590212, 203067543
/Volumes/methlab_data/HBN/EEG-ET/NDARRU751ATE/NDARRU751ATE_Video-DM_Samples_ET.mat, Despicable, 30, 69878015577, 70048555220, 170539643
/Volumes/methlab_data/HBN/EEG-ET/NDARRU751ATE/NDARRU751ATE_Video-WK_Samples_ET.mat, Diary, 30, 70087433697, 70204821741, 117388044
/Volumes/methlab_data/HBN/EEG-ET/NDARRU820CXW/NDARRU820CXW_Video-DM_Samples_ET.mat, Despicable, 60, 4294324065, 4464875771, 170551706
/Volumes/methlab_data/HBN/EEG-ET/NDARRU820CXW/NDARRU820CXW_Video-TP_Samples_ET.mat, Present, 60, 4763642211, 4966910039, 203267828
/Volumes/methlab_data/HBN/EEG-ET/NDARRU820CXW/NDARRU820CXW_Video-WK_Samples_ET.mat, Diary, 60, 3309023840, 3426409921, 117386081
/Volumes/methlab_data/HBN/EEG-ET/NDARRU979UBW/NDARRU979UBW_Video1_Samples_ET.mat, Diary, 120, 7654190836, 7771586404, 117395568
/Volumes/methlab_data/HBN/EEG-ET/NDARRU979UBW/NDARRU979UBW_Video2_Samples_ET.mat, Fractals, 120, 8909452116, 9072450154, 162998038
/Volumes/methlab_data/HBN/EEG-ET/NDARRU979UBW/NDARRU979UBW_Video3_Samples_ET.mat, Despicable, 120, 9361900669, 9532447921, 170547252
/Volumes/methlab_data/HBN/EEG-ET/NDARRU979UBW/NDARRU979UBW_Video4_Samples_ET.mat, Present, 120, 10050806958, 10253874840, 203067882
/Volumes/methlab_data/HBN/EEG-ET/NDARRV002MA8/NDARRV002MA8_Video-DM_Samples_ET.mat, Despicable, 60, 5065801926, 5236346521, 170544595
/Volumes/methlab_data/HBN/EEG-ET/NDARRV002MA8/NDARRV002MA8_Video-FF_Samples_ET.mat, Fractals, 60, 5704611562, 5867603817, 162992255
/Volumes/methlab_data/HBN/EEG-ET/NDARRV002MA8/NDARRV002MA8_Video-TP_Samples_ET.mat, Present, 60, 6228960267, 6432023856, 203063589
/Volumes/methlab_data/HBN/EEG-ET/NDARRV002MA8/NDARRV002MA8_Video-WK_Samples_ET.mat, Diary, 60, 4209703656, 4327097687, 117394031
/Volumes/methlab_data/HBN/EEG-ET/NDARRV097NU1/NDARRV097NU1_Video-DM_Samples_ET.mat, Despicable, 120, 4507664799, 4678210652, 170545853
/Volumes/methlab_data/HBN/EEG-ET/NDARRV097NU1/NDARRV097NU1_Video-FF_Samples_ET.mat, Fractals, 120, 4060396367, 4223383597, 162987230
/Volumes/methlab_data/HBN/EEG-ET/NDARRV097NU1/NDARRV097NU1_Video-TP_Samples_ET.mat, Present, 120, 5157951001, 5361013874, 203062873
/Volumes/methlab_data/HBN/EEG-ET/NDARRV097NU1/NDARRV097NU1_Video-WK_Samples_ET.mat, Diary, 120, 3127130384, 3244518212, 117387828
/Volumes/methlab_data/HBN/EEG-ET/NDARRV217VTA/NDARRV217VTA_Video-DM_Samples_ET.mat, Despicable, 60, 5787078711, 5957619143, 170540432
/Volumes/methlab_data/HBN/EEG-ET/NDARRV217VTA/NDARRV217VTA_Video-TP_Samples_ET.mat, Present, 60, 6258633613, 6461914133, 203280520
/Volumes/methlab_data/HBN/EEG-ET/NDARRV217VTA/NDARRV217VTA_Video-WK_Samples_ET.mat, Diary, 60, 5280086843, 5397470758, 117383915
/Volumes/methlab_data/HBN/EEG-ET/NDARRV480PU1/NDARRV480PU1_Video1_Samples_ET.mat, Diary, 60, 4987814119, 5105205965, 117391846
/Volumes/methlab_data/HBN/EEG-ET/NDARRV480PU1/NDARRV480PU1_Video3_Samples_ET.mat, Despicable, 60, 319072036, 489618427, 170546391
/Volumes/methlab_data/HBN/EEG-ET/NDARRV505ND6/NDARRV505ND6_Video1_Samples_ET.mat, Fractals, 120, 2953389367, 3116376607, 162987240
/Volumes/methlab_data/HBN/EEG-ET/NDARRV505ND6/NDARRV505ND6_Video2_Samples_ET.mat, Despicable, 120, 3812734760, 3983281003, 170546243
/Volumes/methlab_data/HBN/EEG-ET/NDARRV505ND6/NDARRV505ND6_Video3_Samples_ET.mat, Diary, 120, 4289900659, 4407298286, 117397627
/Volumes/methlab_data/HBN/EEG-ET/NDARRV505ND6/NDARRV505ND6_Video4_Samples_ET.mat, Present, 120, 4930747317, 5133814896, 203067579
/Volumes/methlab_data/HBN/EEG-ET/NDARRV638MJV/NDARRV638MJV_Video1_Samples_ET.mat, Diary, 60, 2785278609, 2902673624, 117395015
/Volumes/methlab_data/HBN/EEG-ET/NDARRV638MJV/NDARRV638MJV_Video3_Samples_ET.mat, Despicable, 60, 3907404239, 4077947866, 170543627
/Volumes/methlab_data/HBN/EEG-ET/NDARRV837BZQ/NDARRV837BZQ_Video1_Samples_ET.mat, Despicable, 120, 2111827301, 2176581169, 2347128833
2.353015e+08, 1.705477e+08, /Volumes/methlab_data/HBN/EEG-ET/NDARRV837BZQ/NDARRV837BZQ_Video2_Samples_ET.mat, Fractals, 120, 2426249044, 2589236703, 162987659
/Volumes/methlab_data/HBN/EEG-ET/NDARRV837BZQ/NDARRV837BZQ_Video3_Samples_ET.mat, Diary, 120, 2702076684, 2819476093, 117399409
/Volumes/methlab_data/HBN/EEG-ET/NDARRV877ERG/NDARRV877ERG_Video-DM_Samples_ET.mat, Despicable, 60, 4668483664, 4839021203, 170537539
/Volumes/methlab_data/HBN/EEG-ET/NDARRV877ERG/NDARRV877ERG_Video-FF_Samples_ET.mat, Fractals, 60, 5101930970, 5264915152, 162984182
/Volumes/methlab_data/HBN/EEG-ET/NDARRV877ERG/NDARRV877ERG_Video-TP_Samples_ET.mat, Present, 60, 5668306192, 5871365704, 203059512
/Volumes/methlab_data/HBN/EEG-ET/NDARRV877ERG/NDARRV877ERG_Video-WK_Samples_ET.mat, Diary, 60, 4095858033, 4213329062, 117471029
/Volumes/methlab_data/HBN/EEG-ET/NDARRV941EAC/NDARRV941EAC_Video1_Samples_ET.mat, Diary, 60, 3264880647, 3382271620, 117390973
/Volumes/methlab_data/HBN/EEG-ET/NDARRV941EAC/NDARRV941EAC_Video3_Samples_ET.mat, Despicable, 60, 3646351211, 3816897756, 170546545
/Volumes/methlab_data/HBN/EEG-ET/NDARRV941EAC/NDARRV941EAC_Video4_Samples_ET.mat, Present, 60, 4133615546, 4336672068, 203056522
/Volumes/methlab_data/HBN/EEG-ET/NDARRW100AU0/NDARRW100AU0_Video1_Samples_ET.mat, Diary, 60, 4436856813, 4554250781, 117393968
/Volumes/methlab_data/HBN/EEG-ET/NDARRW100AU0/NDARRW100AU0_Video3_Samples_ET.mat, Despicable, 60, 3804480255, 3975020421, 170540166
/Volumes/methlab_data/HBN/EEG-ET/NDARRW141HUT/NDARRW141HUT_Video-DM_Samples_ET.mat, Despicable, 60, 2602397729, 2772948171, 170550442
/Volumes/methlab_data/HBN/EEG-ET/NDARRW141HUT/NDARRW141HUT_Video-FF_Samples_ET.mat, Fractals, 60, 1773871859, 1936861957, 162990098
/Volumes/methlab_data/HBN/EEG-ET/NDARRW141HUT/NDARRW141HUT_Video-TP_Samples_ET.mat, Present, 60, 3474864636, 3677931003, 203066367
/Volumes/methlab_data/HBN/EEG-ET/NDARRW141HUT/NDARRW141HUT_Video-WK_Samples_ET.mat, Diary, 60, 3044241657, 3161638546, 117396889
/Volumes/methlab_data/HBN/EEG-ET/NDARRW475MPT/NDARRW475MPT_Video-DM_Samples_ET.mat, Despicable, 30, 2224791521, 2395329108, 170537587
/Volumes/methlab_data/HBN/EEG-ET/NDARRW475MPT/NDARRW475MPT_Video-TP_Samples_ET.mat, Present, 30, 3260647876, 3463925799, 203277923
/Volumes/methlab_data/HBN/EEG-ET/NDARRW475MPT/NDARRW475MPT_Video-WK_Samples_ET.mat, Diary, 30, 1790793169, 1908181892, 117388723
/Volumes/methlab_data/HBN/EEG-ET/NDARRW481GFE/NDARRW481GFE_Video-DM_Samples_ET.mat, Despicable, 30, 3161118047, 3331655239, 170537192
/Volumes/methlab_data/HBN/EEG-ET/NDARRW481GFE/NDARRW481GFE_Video-TP_Samples_ET.mat, Present, 30, 3711210646, 3914477877, 203267231
/Volumes/methlab_data/HBN/EEG-ET/NDARRW481GFE/NDARRW481GFE_Video-WK_Samples_ET.mat, Diary, 30, 2158350508, 2275737219, 117386711
/Volumes/methlab_data/HBN/EEG-ET/NDARRW536ZM2/NDARRW536ZM2_Video-DM_Samples_ET.mat, Despicable, 60, 3891284965, 4061819250, 170534285
/Volumes/methlab_data/HBN/EEG-ET/NDARRW536ZM2/NDARRW536ZM2_Video-TP_Samples_ET.mat, Present, 60, 4366697237, 4569965606, 203268369
/Volumes/methlab_data/HBN/EEG-ET/NDARRW536ZM2/NDARRW536ZM2_Video-WK_Samples_ET.mat, Diary, 60, 2768088866, 2885475665, 117386799
/Volumes/methlab_data/HBN/EEG-ET/NDARRW680PHD/NDARRW680PHD_Video1_Samples_ET.mat, Diary, 60, 3120706226, 3238100249, 117394023
/Volumes/methlab_data/HBN/EEG-ET/NDARRW680PHD/NDARRW680PHD_Video2_Samples_ET.mat, Fractals, 60, 4830855766, 4993849037, 162993271
/Volumes/methlab_data/HBN/EEG-ET/NDARRW680PHD/NDARRW680PHD_Video3_Samples_ET.mat, Despicable, 60, 5394497387, 5565041053, 170543666
/Volumes/methlab_data/HBN/EEG-ET/NDARRW680PHD/NDARRW680PHD_Video4_Samples_ET.mat, Present, 60, 5973419851, 6176489479, 203069628
/Volumes/methlab_data/HBN/EEG-ET/NDARRW940BL6/NDARRW940BL6_Video1_Samples_ET.mat, Diary, 60, 6951483007, 7068873961, 117390954
/Volumes/methlab_data/HBN/EEG-ET/NDARRW940BL6/NDARRW940BL6_Video3_Samples_ET.mat, Despicable, 60, 6473746587, 6644299077, 170552490
/Volumes/methlab_data/HBN/EEG-ET/NDARRW951BYF/NDARRW951BYF_Video1_Samples_ET.mat, Diary, 120, 4283712246, 4401108245, 117395999
/Volumes/methlab_data/HBN/EEG-ET/NDARRW951BYF/NDARRW951BYF_Video2_Samples_ET.mat, Fractals, 120, 5028557060, 5191541957, 162984897
/Volumes/methlab_data/HBN/EEG-ET/NDARRW951BYF/NDARRW951BYF_Video3_Samples_ET.mat, Despicable, 120, 5532294032, 5702841222, 170547190
/Volumes/methlab_data/HBN/EEG-ET/NDARRW951BYF/NDARRW951BYF_Video4_Samples_ET.mat, Present, 120, 6183621867, 6386688729, 203066862
/Volumes/methlab_data/HBN/EEG-ET/NDARRW974PEF/NDARRW974PEF_Video1_Samples_ET.mat, Diary, 60, 1860628942, 1978016955, 117388013
/Volumes/methlab_data/HBN/EEG-ET/NDARRW974PEF/NDARRW974PEF_Video2_Samples_ET.mat, Fractals, 60, 2017208650, 2180199923, 162991273
/Volumes/methlab_data/HBN/EEG-ET/NDARRW974PEF/NDARRW974PEF_Video3_Samples_ET.mat, Despicable, 60, 1632056342, 1802594946, 170538604
/Volumes/methlab_data/HBN/EEG-ET/NDARRW974PEF/NDARRW974PEF_Video4_Samples_ET.mat, Present, 60, 2231381169, 2434442669, 203061500
/Volumes/methlab_data/HBN/EEG-ET/NDARRX084UML/NDARRX084UML_Video-DM_Samples_ET.mat, Despicable, 60, 6162039854, 6332577458, 170537604
/Volumes/methlab_data/HBN/EEG-ET/NDARRX084UML/NDARRX084UML_Video-TP_Samples_ET.mat, Present, 60, 7109050398, 7312318132, 203267734
/Volumes/methlab_data/HBN/EEG-ET/NDARRX084UML/NDARRX084UML_Video-WK_Samples_ET.mat, Diary, 60, 6586735120, 6704125141, 117390021
/Volumes/methlab_data/HBN/EEG-ET/NDARRX138MLG/NDARRX138MLG_Video-DM_Samples_ET.mat, Despicable, 30, 3760984160, 3931519793, 170535633
/Volumes/methlab_data/HBN/EEG-ET/NDARRX138MLG/NDARRX138MLG_Video-TP_Samples_ET.mat, Present, 30, 4233773558, 4437047342, 203273784
/Volumes/methlab_data/HBN/EEG-ET/NDARRX138MLG/NDARRX138MLG_Video-WK_Samples_ET.mat, Diary, 30, 2552425387, 2669814432, 117389045
/Volumes/methlab_data/HBN/EEG-ET/NDARRX443NVT/NDARRX443NVT_Video1_Samples_ET.mat, Diary, 120, 2827438405, 2944845690, 117407285
/Volumes/methlab_data/HBN/EEG-ET/NDARRX443NVT/NDARRX443NVT_Video2_Samples_ET.mat, Fractals, 120, 3469234070, 3632221420, 162987350
/Volumes/methlab_data/HBN/EEG-ET/NDARRX443NVT/NDARRX443NVT_Video3_Samples_ET.mat, Despicable, 120, 3974031505, 4144578477, 170546972
/Volumes/methlab_data/HBN/EEG-ET/NDARRX443NVT/NDARRX443NVT_Video4_Samples_ET.mat, Present, 120, 4646436834, 4849504401, 203067567
/Volumes/methlab_data/HBN/EEG-ET/NDARRX552PP2/NDARRX552PP2_Video-DM_Samples_ET.mat, Despicable, 60, 3399175697, 3569716162, 170540465
/Volumes/methlab_data/HBN/EEG-ET/NDARRX552PP2/NDARRX552PP2_Video-FF_Samples_ET.mat, Fractals, 60, 2955234136, 3118223303, 162989167
/Volumes/methlab_data/HBN/EEG-ET/NDARRX552PP2/NDARRX552PP2_Video-TP_Samples_ET.mat, Present, 60, 3904267430, 4107337902, 203070472
/Volumes/methlab_data/HBN/EEG-ET/NDARRX552PP2/NDARRX552PP2_Video-WK_Samples_ET.mat, Diary, 60, 2397471202, 2514864133, 117392931
/Volumes/methlab_data/HBN/EEG-ET/NDARRX819BZ0/NDARRX819BZ0_Video1_Samples_ET.mat, Diary, 60, 15780143931, 15897539891, 117395960
/Volumes/methlab_data/HBN/EEG-ET/NDARRX819BZ0/NDARRX819BZ0_Video3_Samples_ET.mat, Despicable, 60, 15111074126, 15281619652, 170545526
/Volumes/methlab_data/HBN/EEG-ET/NDARRX897XV1/NDARRX897XV1_Video1_Samples_ET.mat, Diary, 120, 3195331139, 3312727303, 117396164
/Volumes/methlab_data/HBN/EEG-ET/NDARRX897XV1/NDARRX897XV1_Video2_Samples_ET.mat, Fractals, 120, 3805425989, 3968412750, 162986761
/Volumes/methlab_data/HBN/EEG-ET/NDARRX897XV1/NDARRX897XV1_Video3_Samples_ET.mat, Despicable, 120, 4289193213, 4459740570, 170547357
/Volumes/methlab_data/HBN/EEG-ET/NDARRX897XV1/NDARRX897XV1_Video4_Samples_ET.mat, Present, 120, 4853770402, 5056833985, 203063583
/Volumes/methlab_data/HBN/EEG-ET/NDARRY097FUT/NDARRY097FUT_Video1_Samples_ET.mat, Diary, 60, 5606818200, 5724212710, 117394510
/Volumes/methlab_data/HBN/EEG-ET/NDARRY097FUT/NDARRY097FUT_Video3_Samples_ET.mat, Despicable, 60, 5148660412, 5319216711, 170556299
/Volumes/methlab_data/HBN/EEG-ET/NDARRY097FUT/NDARRY097FUT_Video4_Samples_ET.mat, Present, 60, 6027913651, 6230977065, 203063414
/Volumes/methlab_data/HBN/EEG-ET/NDARRY112RAK/NDARRY112RAK_Video1_Samples_ET.mat, Diary, 60, 2329335055, 2446727962, 117392907
/Volumes/methlab_data/HBN/EEG-ET/NDARRY112RAK/NDARRY112RAK_Video3_Samples_ET.mat, Despicable, 60, 3772190111, 3942731484, 170541373
/Volumes/methlab_data/HBN/EEG-ET/NDARRY215CXQ/NDARRY215CXQ_Video1_Samples_ET.mat, Diary, 60, 3867734799, 3985134352, 117399553
/Volumes/methlab_data/HBN/EEG-ET/NDARRY215CXQ/NDARRY215CXQ_Video3_Samples_ET.mat, Despicable, 60, 3440436839, 3610990186, 170553347
/Volumes/methlab_data/HBN/EEG-ET/NDARRY215CXQ/NDARRY215CXQ_Video4_Samples_ET.mat, Present, 60, 4324422668, 4527495146, 203072478
/Volumes/methlab_data/HBN/EEG-ET/NDARRY268AF2/NDARRY268AF2_Video1_Samples_ET.mat, Diary, 60, 6793439736, 6910831144, 117391408
/Volumes/methlab_data/HBN/EEG-ET/NDARRY268AF2/NDARRY268AF2_Video3_Samples_ET.mat, Despicable, 60, 6368779214, 6539323339, 170544125
/Volumes/methlab_data/HBN/EEG-ET/NDARRY268AF2/NDARRY268AF2_Video4_Samples_ET.mat, Present, 60, 7162849076, 7365908235, 203059159
/Volumes/methlab_data/HBN/EEG-ET/NDARRY538NE1/NDARRY538NE1_Video1_Samples_ET.mat, Diary, 60, 3277770992, 3395167107, 117396115
/Volumes/methlab_data/HBN/EEG-ET/NDARRY538NE1/NDARRY538NE1_Video2_Samples_ET.mat, Fractals, 60, 2145559510, 2308550775, 162991265
/Volumes/methlab_data/HBN/EEG-ET/NDARRY538NE1/NDARRY538NE1_Video3_Samples_ET.mat, Despicable, 60, 2796015397, 2966559990, 170544593
/Volumes/methlab_data/HBN/EEG-ET/NDARRY538NE1/NDARRY538NE1_Video4_Samples_ET.mat, Present, 60, 3705418337, 3908488936, 203070599
/Volumes/methlab_data/HBN/EEG-ET/NDARRY714GEY/NDARRY714GEY_Video-DM_Samples_ET.mat, Despicable, 60, 3560872834, 3731411299, 170538465
/Volumes/methlab_data/HBN/EEG-ET/NDARRY714GEY/NDARRY714GEY_Video-FF_Samples_ET.mat, Fractals, 60, 4078729598, 4241711719, 162982121
/Volumes/methlab_data/HBN/EEG-ET/NDARRY714GEY/NDARRY714GEY_Video-TP_Samples_ET.mat, Present, 60, 4454297839, 4657368300, 203070461
/Volumes/methlab_data/HBN/EEG-ET/NDARRY714GEY/NDARRY714GEY_Video-WK_Samples_ET.mat, Diary, 60, 4286863588, 4404256498, 117392910
/Volumes/methlab_data/HBN/EEG-ET/NDARRY715CY4/NDARRY715CY4_Video1_Samples_ET.mat, Despicable, 120, 2378516346, 2524985815, 2695541861
3.170255e+08, 1.705560e+08, /Volumes/methlab_data/HBN/EEG-ET/NDARRY715CY4/NDARRY715CY4_Video2_Samples_ET.mat, Fractals, 120, 2823122410, 2986109617, 162987207
/Volumes/methlab_data/HBN/EEG-ET/NDARRY715CY4/NDARRY715CY4_Video3_Samples_ET.mat, Diary, 120, 3162391026, 3279788019, 117396993
/Volumes/methlab_data/HBN/EEG-ET/NDARRY715CY4/NDARRY715CY4_Video4_Samples_ET.mat, Present, 120, 3340689236, 3543756428, 203067192
/Volumes/methlab_data/HBN/EEG-ET/NDARRY768ZH3/NDARRY768ZH3_Video1_Samples_ET.mat, Diary, 120, 4574471291, 4691867745, 117396454
/Volumes/methlab_data/HBN/EEG-ET/NDARRY768ZH3/NDARRY768ZH3_Video2_Samples_ET.mat, Fractals, 120, 5696982793, 5859976180, 162993387
/Volumes/methlab_data/HBN/EEG-ET/NDARRY768ZH3/NDARRY768ZH3_Video3_Samples_ET.mat, Despicable, 120, 6216442625, 6386989414, 170546789
/Volumes/methlab_data/HBN/EEG-ET/NDARRY768ZH3/NDARRY768ZH3_Video4_Samples_ET.mat, Present, 120, 6860198284, 7063276488, 203078204
/Volumes/methlab_data/HBN/EEG-ET/NDARRY785GLM/NDARRY785GLM_Video1_Samples_ET.mat, Diary, 60, 1759304384, 1876691682, 117387298
/Volumes/methlab_data/HBN/EEG-ET/NDARRY785GLM/NDARRY785GLM_Video3_Samples_ET.mat, Despicable, 60, 1516339063, 1686882041, 170542978
/Volumes/methlab_data/HBN/EEG-ET/NDARRY785GLM/NDARRY785GLM_Video4_Samples_ET.mat, Present, 60, 2152185074, 2355248170, 203063096
/Volumes/methlab_data/HBN/EEG-ET/NDARRY792KY1/NDARRY792KY1_Video-DM_Samples_ET.mat, Despicable, 30, 2723176838, 2893714578, 170537740
/Volumes/methlab_data/HBN/EEG-ET/NDARRY792KY1/NDARRY792KY1_Video-TP_Samples_ET.mat, Present, 30, 3815857411, 4019125353, 203267942
/Volumes/methlab_data/HBN/EEG-ET/NDARRY792KY1/NDARRY792KY1_Video-WK_Samples_ET.mat, Diary, 30, 3322700272, 3440089405, 117389133
/Volumes/methlab_data/HBN/EEG-ET/NDARRY807MXC/NDARRY807MXC_Video-DM_Samples_ET.mat, Despicable, 120, 4657130651, 4827677002, 170546351
/Volumes/methlab_data/HBN/EEG-ET/NDARRY807MXC/NDARRY807MXC_Video-FF_Samples_ET.mat, Fractals, 120, 5197282682, 5360265181, 162982499
/Volumes/methlab_data/HBN/EEG-ET/NDARRY807MXC/NDARRY807MXC_Video-TP_Samples_ET.mat, Present, 120, 5812642950, 6015710086, 203067136
/Volumes/methlab_data/HBN/EEG-ET/NDARRY807MXC/NDARRY807MXC_Video-WK_Samples_ET.mat, Diary, 120, 3793866032, 3911262283, 117396251
/Volumes/methlab_data/HBN/EEG-ET/NDARRY885YL9/NDARRY885YL9_Video-DM_Samples_ET.mat, Despicable, 60, 5762848896, 5933386424, 170537528
/Volumes/methlab_data/HBN/EEG-ET/NDARRY885YL9/NDARRY885YL9_Video-TP_Samples_ET.mat, Present, 60, 6607219569, 6810498217, 203278648
/Volumes/methlab_data/HBN/EEG-ET/NDARRY885YL9/NDARRY885YL9_Video-WK_Samples_ET.mat, Diary, 60, 6195403604, 6312790531, 117386927
/Volumes/methlab_data/HBN/EEG-ET/NDARRZ199KNG/NDARRZ199KNG_Video1_Samples_ET.mat, Diary, 60, 2519296495, 2636690379, 117393884
/Volumes/methlab_data/HBN/EEG-ET/NDARRZ199KNG/NDARRZ199KNG_Video3_Samples_ET.mat, Despicable, 60, 2089671032, 2260211491, 170540459
/Volumes/methlab_data/HBN/EEG-ET/NDARRZ356HET/NDARRZ356HET_Video-DM_Samples_ET.mat, Despicable, 120, 7613566258, 7784109594, 170543336
/Volumes/methlab_data/HBN/EEG-ET/NDARRZ356HET/NDARRZ356HET_Video-FF_Samples_ET.mat, Fractals, 120, 6671183404, 6834172554, 162989150
/Volumes/methlab_data/HBN/EEG-ET/NDARRZ356HET/NDARRZ356HET_Video-TP_Samples_ET.mat, Present, 120, 8156331962, 8359397620, 203065658
/Volumes/methlab_data/HBN/EEG-ET/NDARRZ356HET/NDARRZ356HET_Video-WK_Samples_ET.mat, Diary, 120, 7243815505, 7361213706, 117398201
/Volumes/methlab_data/HBN/EEG-ET/NDARRZ606EDP/NDARRZ606EDP_Video1_Samples_ET.mat, Diary, 60, 4784862637, 4902258681, 117396044
/Volumes/methlab_data/HBN/EEG-ET/NDARRZ606EDP/NDARRZ606EDP_Video2_Samples_ET.mat, Fractals, 60, 4372166156, 4535159295, 162993139
/Volumes/methlab_data/HBN/EEG-ET/NDARRZ606EDP/NDARRZ606EDP_Video3_Samples_ET.mat, Despicable, 60, 3491770355, 3662309815, 170539460
/Volumes/methlab_data/HBN/EEG-ET/NDARRZ606EDP/NDARRZ606EDP_Video4_Samples_ET.mat, Present, 60, 5194097673, 5397162149, 203064476
/Volumes/methlab_data/HBN/EEG-ET/NDARRZ653HKY/NDARRZ653HKY_Video1_Samples_ET.mat, Diary, 60, 3435345747, 3552732988, 117387241
/Volumes/methlab_data/HBN/EEG-ET/NDARRZ927VC3/NDARRZ927VC3_Video1_Samples_ET.mat, Diary, 60, 2702252966, 2819650202, 117397236
/Volumes/methlab_data/HBN/EEG-ET/NDARRZ927VC3/NDARRZ927VC3_Video2_Samples_ET.mat, Fractals, 60, 2032225131, 2195217711, 162992580
/Volumes/methlab_data/HBN/EEG-ET/NDARRZ927VC3/NDARRZ927VC3_Video3_Samples_ET.mat, Despicable, 60, 3169366029, 3339912894, 170546865
/Volumes/methlab_data/HBN/EEG-ET/NDARRZ927VC3/NDARRZ927VC3_Video4_Samples_ET.mat, Present, 60, 3672491578, 3875557509, 203065931
/Volumes/methlab_data/HBN/EEG-ET/NDARRZ940HX6/NDARRZ940HX6_Video-DM_Samples_ET.mat, Despicable, 60, 4590093732, 4760638070, 170544338
/Volumes/methlab_data/HBN/EEG-ET/NDARRZ940HX6/NDARRZ940HX6_Video-FF_Samples_ET.mat, Fractals, 60, 5770706569, 5933700539, 162993970
/Volumes/methlab_data/HBN/EEG-ET/NDARRZ940HX6/NDARRZ940HX6_Video-TP_Samples_ET.mat, Present, 60, 6388062753, 6591120217, 203057464
/Volumes/methlab_data/HBN/EEG-ET/NDARRZ940HX6/NDARRZ940HX6_Video-WK_Samples_ET.mat, Diary, 60, 5360489766, 5477882293, 117392527
/Volumes/methlab_data/HBN/EEG-ET/NDARRZ979FZ4/NDARRZ979FZ4_Video1_Samples_ET.mat, Diary, 60, 2511235652, 2628630044, 117394392
/Volumes/methlab_data/HBN/EEG-ET/NDARRZ979FZ4/NDARRZ979FZ4_Video3_Samples_ET.mat, Despicable, 60, 1962013510, 2132556646, 170543136
/Volumes/methlab_data/HBN/EEG-ET/NDARRZ993EL4/NDARRZ993EL4_Video-DM_Samples_ET.mat, Despicable, 60, 3151671865, 3322210246, 170538381
/Volumes/methlab_data/HBN/EEG-ET/NDARRZ993EL4/NDARRZ993EL4_Video-TP_Samples_ET.mat, Present, 60, 4706695059, 4909960505, 203265446
/Volumes/methlab_data/HBN/EEG-ET/NDARRZ993EL4/NDARRZ993EL4_Video-WK_Samples_ET.mat, Diary, 60, 4299899029, 4417285903, 117386874
/Volumes/methlab_data/HBN/EEG-ET/NDARTA080YCE/NDARTA080YCE_Video-DM_Samples_ET.mat, Despicable, 60, 5048382545, 5218916142, 170533597
/Volumes/methlab_data/HBN/EEG-ET/NDARTA080YCE/NDARTA080YCE_Video-FF_Samples_ET.mat, Fractals, 60, 4579371946, 4742363195, 162991249
/Volumes/methlab_data/HBN/EEG-ET/NDARTA080YCE/NDARTA080YCE_Video-TP_Samples_ET.mat, Present, 60, 5581868709, 5784939309, 203070600
/Volumes/methlab_data/HBN/EEG-ET/NDARTA080YCE/NDARTA080YCE_Video-WK_Samples_ET.mat, Diary, 60, 3960228200, 4077617208, 117389008
/Volumes/methlab_data/HBN/EEG-ET/NDARTA808DEQ/NDARTA808DEQ_Video1_Samples_ET.mat, Diary, 60, 4781291561, 4898686511, 117394950
/Volumes/methlab_data/HBN/EEG-ET/NDARTA808DEQ/NDARTA808DEQ_Video3_Samples_ET.mat, Despicable, 60, 4350964441, 4521506959, 170542518
/Volumes/methlab_data/HBN/EEG-ET/NDARTA819MF0/NDARTA819MF0_Video1_Samples_ET.mat, Diary, 60, 2241551088, 2358944114, 117393026
/Volumes/methlab_data/HBN/EEG-ET/NDARTA819MF0/NDARTA819MF0_Video2_Samples_ET.mat, Fractals, 60, 2961037763, 3124030029, 162992266
/Volumes/methlab_data/HBN/EEG-ET/NDARTA819MF0/NDARTA819MF0_Video3_Samples_ET.mat, Despicable, 60, 3399639859, 3570193622, 170553763
/Volumes/methlab_data/HBN/EEG-ET/NDARTA819MF0/NDARTA819MF0_Video4_Samples_ET.mat, Present, 60, 3933893579, 4136966173, 203072594
/Volumes/methlab_data/HBN/EEG-ET/NDARTA920XFC/NDARTA920XFC_Video-DM_Samples_ET.mat, Despicable, 30, 2417498405, 2588037578, 170539173
/Volumes/methlab_data/HBN/EEG-ET/NDARTA920XFC/NDARTA920XFC_Video-TP_Samples_ET.mat, Present, 30, 3328655681, 3531925096, 203269415
/Volumes/methlab_data/HBN/EEG-ET/NDARTA920XFC/NDARTA920XFC_Video-WK_Samples_ET.mat, Diary, 30, 2896669801, 3014056218, 117386417
/Volumes/methlab_data/HBN/EEG-ET/NDARTB003FDD/NDARTB003FDD_Video-DM_Samples_ET.mat, Despicable, 30, 4743004207, 4913539906, 170535699
/Volumes/methlab_data/HBN/EEG-ET/NDARTB003FDD/NDARTB003FDD_Video-TP_Samples_ET.mat, Present, 30, 5284647488, 5487917346, 203269858
/Volumes/methlab_data/HBN/EEG-ET/NDARTB003FDD/NDARTB003FDD_Video-WK_Samples_ET.mat, Diary, 30, 3246287086, 3363676185, 117389099
/Volumes/methlab_data/HBN/EEG-ET/NDARTB219AJV/NDARTB219AJV_Video1_Samples_ET.mat, Diary, 60, 2165704798, 2283093183, 117388385
/Volumes/methlab_data/HBN/EEG-ET/NDARTB219AJV/NDARTB219AJV_Video3_Samples_ET.mat, Despicable, 60, 1769628403, 1940169580, 170541177
/Volumes/methlab_data/HBN/EEG-ET/NDARTB552HP0/NDARTB552HP0_Video1_Samples_ET.mat, Diary, 60, 2048618633, 2166009667, 117391034
/Volumes/methlab_data/HBN/EEG-ET/NDARTB552HP0/NDARTB552HP0_Video3_Samples_ET.mat, Despicable, 60, 1501896108, 1672434718, 170538610
/Volumes/methlab_data/HBN/EEG-ET/NDARTB755MF5/NDARTB755MF5_Video1_Samples_ET.mat, Diary, 60, 9747823764, 9865219713, 117395949
/Volumes/methlab_data/HBN/EEG-ET/NDARTB755MF5/NDARTB755MF5_Video2_Samples_ET.mat, Fractals, 60, 8484733672, 8647722813, 162989141
/Volumes/methlab_data/HBN/EEG-ET/NDARTB755MF5/NDARTB755MF5_Video3_Samples_ET.mat, Despicable, 60, 9261637378, 9432176842, 170539464
/Volumes/methlab_data/HBN/EEG-ET/NDARTB755MF5/NDARTB755MF5_Video4_Samples_ET.mat, Present, 60, 10173882684, 10376953143, 203070459
/Volumes/methlab_data/HBN/EEG-ET/NDARTB883GUN/NDARTB883GUN_Video1_Samples_ET.mat, Diary, 60, 3258778434, 3376178385, 117399951
/Volumes/methlab_data/HBN/EEG-ET/NDARTB883GUN/NDARTB883GUN_Video3_Samples_ET.mat, Despicable, 60, 2834193356, 3004733920, 170540564
/Volumes/methlab_data/HBN/EEG-ET/NDARTC227AXA/NDARTC227AXA_Video1_Samples_ET.mat, Diary, 60, 5419177457, 5536572173, 117394716
/Volumes/methlab_data/HBN/EEG-ET/NDARTC227AXA/NDARTC227AXA_Video3_Samples_ET.mat, Despicable, 60, 4967305057, 5137846373, 170541316
/Volumes/methlab_data/HBN/EEG-ET/NDARTC227AXA/NDARTC227AXA_Video4_Samples_ET.mat, Present, 60, 5868190838, 6071260951, 203070113
/Volumes/methlab_data/HBN/EEG-ET/NDARTC527WPZ/NDARTC527WPZ_Video-DM_Samples_ET.mat, Despicable, 60, 4241237240, 4411783805, 170546565
/Volumes/methlab_data/HBN/EEG-ET/NDARTC527WPZ/NDARTC527WPZ_Video-FF_Samples_ET.mat, Fractals, 60, 4894127381, 5057117545, 162990164
/Volumes/methlab_data/HBN/EEG-ET/NDARTC527WPZ/NDARTC527WPZ_Video-TP_Samples_ET.mat, Present, 60, 5753811563, 5956882011, 203070448
/Volumes/methlab_data/HBN/EEG-ET/NDARTC527WPZ/NDARTC527WPZ_Video-WK_Samples_ET.mat, Diary, 60, 5320878784, 5438270717, 117391933
/Volumes/methlab_data/HBN/EEG-ET/NDARTC652JK4/NDARTC652JK4_Video3_Samples_ET.mat, Despicable, 60, 5009441320, 5232956587, 5403499351
3.940580e+08, 1.705428e+08, /Volumes/methlab_data/HBN/EEG-ET/NDARTC707KPU/NDARTC707KPU_Video1_Samples_ET.mat, Despicable, 120, 2304233335, 2474779829, 170546494
/Volumes/methlab_data/HBN/EEG-ET/NDARTC707KPU/NDARTC707KPU_Video2_Samples_ET.mat, Diary, 120, 2857999655, 2975394626, 117394971
/Volumes/methlab_data/HBN/EEG-ET/NDARTC707KPU/NDARTC707KPU_Video3_Samples_ET.mat, Fractals, 120, 3083388664, 3246384503, 162995839
/Volumes/methlab_data/HBN/EEG-ET/NDARTC707KPU/NDARTC707KPU_Video4_Samples_ET.mat, Present, 120, 3703490221, 3906551453, 203061232
/Volumes/methlab_data/HBN/EEG-ET/NDARTC710UM1/NDARTC710UM1_Video1_Samples_ET.mat, Diary, 60, 4590748948, 4708141946, 117392998
/Volumes/methlab_data/HBN/EEG-ET/NDARTC710UM1/NDARTC710UM1_Video2_Samples_ET.mat, Fractals, 60, 5350220888, 5513214146, 162993258
/Volumes/methlab_data/HBN/EEG-ET/NDARTC710UM1/NDARTC710UM1_Video3_Samples_ET.mat, Despicable, 60, 5833184346, 6003727943, 170543597
/Volumes/methlab_data/HBN/EEG-ET/NDARTC710UM1/NDARTC710UM1_Video4_Samples_ET.mat, Present, 60, 6303849114, 6506912681, 203063567
/Volumes/methlab_data/HBN/EEG-ET/NDARTC794GZ5/NDARTC794GZ5_Video1_Samples_ET.mat, Despicable, 120, 2048558274, 2219103997, 170545723
/Volumes/methlab_data/HBN/EEG-ET/NDARTC794GZ5/NDARTC794GZ5_Video2_Samples_ET.mat, Fractals, 120, 2388641062, 2551624728, 162983666
/Volumes/methlab_data/HBN/EEG-ET/NDARTC794GZ5/NDARTC794GZ5_Video3_Samples_ET.mat, Diary, 120, 2742193475, 2859590482, 117397007
/Volumes/methlab_data/HBN/EEG-ET/NDARTC794GZ5/NDARTC794GZ5_Video4_Samples_ET.mat, Present, 120, 2964671733, 3167739044, 203067311
/Volumes/methlab_data/HBN/EEG-ET/NDARTC795CR3/NDARTC795CR3_Video-DM_Samples_ET.mat, Despicable, 60, 3121548193, 3292091473, 170543280
/Volumes/methlab_data/HBN/EEG-ET/NDARTC795CR3/NDARTC795CR3_Video-FF_Samples_ET.mat, Fractals, 60, 2651674954, 2814659916, 162984962
/Volumes/methlab_data/HBN/EEG-ET/NDARTC795CR3/NDARTC795CR3_Video-WK_Samples_ET.mat, Diary, 60, 2213302924, 2330695707, 117392783
/Volumes/methlab_data/HBN/EEG-ET/NDARTC802PGL/NDARTC802PGL_Video1_Samples_ET.mat, Diary, 60, 4705534900, 4822924678, 117389778
/Volumes/methlab_data/HBN/EEG-ET/NDARTC802PGL/NDARTC802PGL_Video3_Samples_ET.mat, Despicable, 60, 5076005069, 5246555316, 170550247
/Volumes/methlab_data/HBN/EEG-ET/NDARTC865YNZ/NDARTC865YNZ_Video1_Samples_ET.mat, Diary, 60, 1977399769, 2094787800, 117388031
/Volumes/methlab_data/HBN/EEG-ET/NDARTC865YNZ/NDARTC865YNZ_Video2_Samples_ET.mat, Fractals, 60, 2145032284, 2308019548, 162987264
/Volumes/methlab_data/HBN/EEG-ET/NDARTC865YNZ/NDARTC865YNZ_Video3_Samples_ET.mat, Despicable, 60, 1748845201, 1919387775, 170542574
/Volumes/methlab_data/HBN/EEG-ET/NDARTC865YNZ/NDARTC865YNZ_Video4_Samples_ET.mat, Present, 60, 2708585849, 2911653329, 203067480
/Volumes/methlab_data/HBN/EEG-ET/NDARTD468TUH/NDARTD468TUH_Video1_Samples_ET.mat, Despicable, 120, 1590912632, 1761458137, 170545505
/Volumes/methlab_data/HBN/EEG-ET/NDARTD468TUH/NDARTD468TUH_Video2_Samples_ET.mat, Diary, 120, 1882922068, 2000309823, 117387755
/Volumes/methlab_data/HBN/EEG-ET/NDARTD468TUH/NDARTD468TUH_Video3_Samples_ET.mat, Fractals, 120, 2101517640, 2264513991, 162996351
/Volumes/methlab_data/HBN/EEG-ET/NDARTD468TUH/NDARTD468TUH_Video4_Samples_ET.mat, Present, 120, 2389145141, 2592212465, 203067324
/Volumes/methlab_data/HBN/EEG-ET/NDARTD624AF9/NDARTD624AF9_Video-DM_Samples_ET.mat, Despicable, 60, 8503517457, 8674058741, 170541284
/Volumes/methlab_data/HBN/EEG-ET/NDARTD624AF9/NDARTD624AF9_Video-FF_Samples_ET.mat, Fractals, 60, 8073290665, 8236272520, 162981855
/Volumes/methlab_data/HBN/EEG-ET/NDARTD624AF9/NDARTD624AF9_Video-TP_Samples_ET.mat, Present, 60, 9023250855, 9226320199, 203069344
/Volumes/methlab_data/HBN/EEG-ET/NDARTD624AF9/NDARTD624AF9_Video-WK_Samples_ET.mat, Diary, 60, 7290187094, 7407580537, 117393443
/Volumes/methlab_data/HBN/EEG-ET/NDARTE115TAE/NDARTE115TAE_Video-DM_Samples_ET.mat, Despicable, 60, 4727896138, 4898432421, 170536283
/Volumes/methlab_data/HBN/EEG-ET/NDARTE115TAE/NDARTE115TAE_Video-TP_Samples_ET.mat, Present, 60, 5255649329, 5458927686, 203278357
/Volumes/methlab_data/HBN/EEG-ET/NDARTE115TAE/NDARTE115TAE_Video-WK_Samples_ET.mat, Diary, 60, 3121352184, 3238739981, 117387797
/Volumes/methlab_data/HBN/EEG-ET/NDARTE159EC4/NDARTE159EC4_Video-DM_Samples_ET.mat, Despicable, 120, 3731535480, 3902082236, 170546756
/Volumes/methlab_data/HBN/EEG-ET/NDARTE159EC4/NDARTE159EC4_Video-FF_Samples_ET.mat, Fractals, 120, 3081979953, 3244976595, 162996642
/Volumes/methlab_data/HBN/EEG-ET/NDARTE159EC4/NDARTE159EC4_Video-TP_Samples_ET.mat, Present, 120, 4676477984, 4879543004, 203065020
/Volumes/methlab_data/HBN/EEG-ET/NDARTE159EC4/NDARTE159EC4_Video-WK_Samples_ET.mat, Diary, 120, 4135002175, 4252400736, 117398561
/Volumes/methlab_data/HBN/EEG-ET/NDARTE424BUF/NDARTE424BUF_Video1_Samples_ET.mat, Diary, 60, 5154941830, 5272337794, 117395964
/Volumes/methlab_data/HBN/EEG-ET/NDARTE424BUF/NDARTE424BUF_Video3_Samples_ET.mat, Despicable, 60, 4707757128, 4878307711, 170550583
/Volumes/methlab_data/HBN/EEG-ET/NDARTE432ZRH/NDARTE432ZRH_Video-DM_Samples_ET.mat, Despicable, 60, 3546964986, 3717514666, 170549680
/Volumes/methlab_data/HBN/EEG-ET/NDARTE432ZRH/NDARTE432ZRH_Video-FF_Samples_ET.mat, Fractals, 60, 2644633467, 2807619807, 162986340
/Volumes/methlab_data/HBN/EEG-ET/NDARTE432ZRH/NDARTE432ZRH_Video-TP_Samples_ET.mat, Present, 60, 4586144312, 4789214034, 203069722
/Volumes/methlab_data/HBN/EEG-ET/NDARTE432ZRH/NDARTE432ZRH_Video-WK_Samples_ET.mat, Diary, 60, 4084429300, 4201818389, 117389089
/Volumes/methlab_data/HBN/EEG-ET/NDARTE553VC1/NDARTE553VC1_Video-DM_Samples_ET.mat, Despicable, 60, 4923618396, 5094155161, 170536765
/Volumes/methlab_data/HBN/EEG-ET/NDARTE553VC1/NDARTE553VC1_Video-TP_Samples_ET.mat, Present, 60, 5425682501, 5628950269, 203267768
/Volumes/methlab_data/HBN/EEG-ET/NDARTE553VC1/NDARTE553VC1_Video-WK_Samples_ET.mat, Diary, 60, 3823327191, 3940716233, 117389042
/Volumes/methlab_data/HBN/EEG-ET/NDARTE773XJ5/NDARTE773XJ5_Video1_Samples_ET.mat, Fractals, 120, 3135940351, 3298927445, 162987094
/Volumes/methlab_data/HBN/EEG-ET/NDARTE773XJ5/NDARTE773XJ5_Video2_Samples_ET.mat, Despicable, 120, 4378796607, 4549339923, 170543316
/Volumes/methlab_data/HBN/EEG-ET/NDARTE773XJ5/NDARTE773XJ5_Video3_Samples_ET.mat, Diary, 120, 4937310462, 5054707964, 117397502
/Volumes/methlab_data/HBN/EEG-ET/NDARTE773XJ5/NDARTE773XJ5_Video4_Samples_ET.mat, Present, 120, 5542716562, 5745784449, 203067887
/Volumes/methlab_data/HBN/EEG-ET/NDARTE785ZMJ/NDARTE785ZMJ_Video1_Samples_ET.mat, Diary, 60, 3986916167, 4104308313, 117392146
/Volumes/methlab_data/HBN/EEG-ET/NDARTE785ZMJ/NDARTE785ZMJ_Video3_Samples_ET.mat, Despicable, 60, 3507510561, 3678052383, 170541822
/Volumes/methlab_data/HBN/EEG-ET/NDARTF079JGU/NDARTF079JGU_Video-DM_Samples_ET.mat, Despicable, 60, 2820889683, 2991427113, 170537430
/Volumes/methlab_data/HBN/EEG-ET/NDARTF079JGU/NDARTF079JGU_Video-TP_Samples_ET.mat, Present, 60, 3747870071, 3951134583, 203264512
/Volumes/methlab_data/HBN/EEG-ET/NDARTF079JGU/NDARTF079JGU_Video-WK_Samples_ET.mat, Diary, 60, 3272683622, 3390085526, 117401904
/Volumes/methlab_data/HBN/EEG-ET/NDARTF133LLM/NDARTF133LLM_Video1_Samples_ET.mat, Diary, 60, 2598189382, 2715585590, 117396208
/Volumes/methlab_data/HBN/EEG-ET/NDARTF133LLM/NDARTF133LLM_Video3_Samples_ET.mat, Despicable, 60, 2986468528, 3157010430, 170541902
/Volumes/methlab_data/HBN/EEG-ET/NDARTF150VPJ/NDARTF150VPJ_Video-DM_Samples_ET.mat, Despicable, 60, 6547127418, 6717668159, 170540741
/Volumes/methlab_data/HBN/EEG-ET/NDARTF150VPJ/NDARTF150VPJ_Video-FF_Samples_ET.mat, Fractals, 60, 6086503428, 6249483509, 162980081
/Volumes/methlab_data/HBN/EEG-ET/NDARTF150VPJ/NDARTF150VPJ_Video-TP_Samples_ET.mat, Present, 60, 7035672316, 7238741939, 203069623
/Volumes/methlab_data/HBN/EEG-ET/NDARTF150VPJ/NDARTF150VPJ_Video-WK_Samples_ET.mat, Diary, 60, 5205217867, 5322612493, 117394626
/Volumes/methlab_data/HBN/EEG-ET/NDARTF566PYH/NDARTF566PYH_Video1_Samples_ET.mat, Diary, 60, 16671980696, 16789373607, 117392911
/Volumes/methlab_data/HBN/EEG-ET/NDARTF566PYH/NDARTF566PYH_Video3_Samples_ET.mat, Despicable, 60, 17693455807, 17863996191, 170540384
/Volumes/methlab_data/HBN/EEG-ET/NDARTF776EYR/NDARTF776EYR_Video-DM_Samples_ET.mat, Despicable, 120, 7771539452, 7942085914, 170546462
/Volumes/methlab_data/HBN/EEG-ET/NDARTF776EYR/NDARTF776EYR_Video-FF_Samples_ET.mat, Fractals, 120, 6907375455, 7070361080, 162985625
/Volumes/methlab_data/HBN/EEG-ET/NDARTF776EYR/NDARTF776EYR_Video-TP_Samples_ET.mat, Present, 120, 8951802283, 9154870805, 203068522
/Volumes/methlab_data/HBN/EEG-ET/NDARTF776EYR/NDARTF776EYR_Video-WK_Samples_ET.mat, Diary, 120, 8246405818, 8363804231, 117398413
/Volumes/methlab_data/HBN/EEG-ET/NDARTF781TM8/NDARTF781TM8_Video1_Samples_ET.mat, Diary, 120, 2920103903, 3037499690, 117395787
/Volumes/methlab_data/HBN/EEG-ET/NDARTF781TM8/NDARTF781TM8_Video2_Samples_ET.mat, Fractals, 120, 3629825507, 3792816682, 162991175
/Volumes/methlab_data/HBN/EEG-ET/NDARTF781TM8/NDARTF781TM8_Video3_Samples_ET.mat, Despicable, 120, 4144941642, 4315494120, 170552478
/Volumes/methlab_data/HBN/EEG-ET/NDARTF781TM8/NDARTF781TM8_Video4_Samples_ET.mat, Present, 120, 5041172697, 5244239731, 203067034
/Volumes/methlab_data/HBN/EEG-ET/NDARTF833WXB/NDARTF833WXB_Video1_Samples_ET.mat, Diary, 60, 4204455857, 4321844801, 117388944
/Volumes/methlab_data/HBN/EEG-ET/NDARTF833WXB/NDARTF833WXB_Video3_Samples_ET.mat, Despicable, 60, 5942949757, 6113497230, 170547473
/Volumes/methlab_data/HBN/EEG-ET/NDARTG035JK8/NDARTG035JK8_Video1_Samples_ET.mat, Diary, 60, 1053553674, 1170960144, 117406470
/Volumes/methlab_data/HBN/EEG-ET/NDARTG035JK8/NDARTG035JK8_Video3_Samples_ET.mat, Despicable, 60, 625960815, 796511032, 170550217
/Volumes/methlab_data/HBN/EEG-ET/NDARTG464MWG/NDARTG464MWG_Video1_Samples_ET.mat, Diary, 60, 4867146283, 4984540267, 117393984
/Volumes/methlab_data/HBN/EEG-ET/NDARTG464MWG/NDARTG464MWG_Video3_Samples_ET.mat, Despicable, 60, 4416878900, 4587422497, 170543597
/Volumes/methlab_data/HBN/EEG-ET/NDARTG679NKQ/NDARTG679NKQ_Video1_Samples_ET.mat, Diary, 120, 3478305391, 3595702029, 117396638
/Volumes/methlab_data/HBN/EEG-ET/NDARTG679NKQ/NDARTG679NKQ_Video2_Samples_ET.mat, Despicable, 120, 4016491930, 4187038956, 170547026
/Volumes/methlab_data/HBN/EEG-ET/NDARTG679NKQ/NDARTG679NKQ_Video3_Samples_ET.mat, Fractals, 120, 4459568723, 4622556546, 162987823
/Volumes/methlab_data/HBN/EEG-ET/NDARTG679NKQ/NDARTG679NKQ_Video4_Samples_ET.mat, Present, 120, 5190484543, 5393552476, 203067933
/Volumes/methlab_data/HBN/EEG-ET/NDARTG681ZDV/NDARTG681ZDV_Video-DM_Samples_ET.mat, Despicable, 120, 4365937323, 4536484450, 170547127
/Volumes/methlab_data/HBN/EEG-ET/NDARTG681ZDV/NDARTG681ZDV_Video-FF_Samples_ET.mat, Fractals, 120, 3950028205, 4113011396, 162983191
/Volumes/methlab_data/HBN/EEG-ET/NDARTG681ZDV/NDARTG681ZDV_Video-TP_Samples_ET.mat, Present, 120, 5014423171, 5217490612, 203067441
/Volumes/methlab_data/HBN/EEG-ET/NDARTG681ZDV/NDARTG681ZDV_Video-WK_Samples_ET.mat, Diary, 120, 3290143781, 3407532090, 117388309
/Volumes/methlab_data/HBN/EEG-ET/NDARTG810FRE/NDARTG810FRE_Video1_Samples_ET.mat, Diary, 60, 2050653891, 2168048711, 117394820
/Volumes/methlab_data/HBN/EEG-ET/NDARTG810FRE/NDARTG810FRE_Video3_Samples_ET.mat, Despicable, 60, 1394105878, 1564658184, 170552306
/Volumes/methlab_data/HBN/EEG-ET/NDARTG937LDA/NDARTG937LDA_Video-DM_Samples_ET.mat, Despicable, 60, 3000576148, 3171128711, 170552563
/Volumes/methlab_data/HBN/EEG-ET/NDARTG937LDA/NDARTG937LDA_Video-FF_Samples_ET.mat, Fractals, 60, 2553593291, 2716576481, 162983190
/Volumes/methlab_data/HBN/EEG-ET/NDARTG937LDA/NDARTG937LDA_Video-TP_Samples_ET.mat, Present, 60, 3483999746, 3687072273, 203072527
/Volumes/methlab_data/HBN/EEG-ET/NDARTG937LDA/NDARTG937LDA_Video-WK_Samples_ET.mat, Diary, 60, 1776453136, 1893845193, 117392057
/Volumes/methlab_data/HBN/EEG-ET/NDARTH433TE0/NDARTH433TE0_Video1_Samples_ET.mat, Diary, 60, 6292556140, 6409947271, 117391131
/Volumes/methlab_data/HBN/EEG-ET/NDARTH433TE0/NDARTH433TE0_Video2_Samples_ET.mat, Fractals, 60, 6044402688, 6207383953, 162981265
/Volumes/methlab_data/HBN/EEG-ET/NDARTH433TE0/NDARTH433TE0_Video3_Samples_ET.mat, Despicable, 60, 5822722966, 5993264572, 170541606
/Volumes/methlab_data/HBN/EEG-ET/NDARTH433TE0/NDARTH433TE0_Video4_Samples_ET.mat, Present, 60, 6543736735, 6746796308, 203059573
/Volumes/methlab_data/HBN/EEG-ET/NDARTH473LF8/NDARTH473LF8_Video1_Samples_ET.mat, Diary, 60, 23036696877, 23154090799, 117393922
/Volumes/methlab_data/HBN/EEG-ET/NDARTH473LF8/NDARTH473LF8_Video3_Samples_ET.mat, Despicable, 60, 22609481142, 22780026629, 170545487
/Volumes/methlab_data/HBN/EEG-ET/NDARTH529YKZ/NDARTH529YKZ_Video-DM_Samples_ET.mat, Despicable, 60, 4548795403, 4719350831, 170555428
/Volumes/methlab_data/HBN/EEG-ET/NDARTH529YKZ/NDARTH529YKZ_Video-FF_Samples_ET.mat, Fractals, 60, 3779154097, 3942148156, 162994059
/Volumes/methlab_data/HBN/EEG-ET/NDARTH529YKZ/NDARTH529YKZ_Video-TP_Samples_ET.mat, Present, 60, 5747297462, 5950359842, 203062380
/Volumes/methlab_data/HBN/EEG-ET/NDARTH529YKZ/NDARTH529YKZ_Video-WK_Samples_ET.mat, Diary, 60, 5267926060, 5385315938, 117389878
/Volumes/methlab_data/HBN/EEG-ET/NDARTH610GMK/NDARTH610GMK_Video1_Samples_ET.mat, Diary, 60, 1566135013, 1683529794, 117394781
/Volumes/methlab_data/HBN/EEG-ET/NDARTH610GMK/NDARTH610GMK_Video3_Samples_ET.mat, Despicable, 60, 2744797562, 2915346921, 170549359
/Volumes/methlab_data/HBN/EEG-ET/NDARTH930FNK/NDARTH930FNK_Video1_Samples_ET.mat, Fractals, 120, 2883428747, 3046415482, 162986735
/Volumes/methlab_data/HBN/EEG-ET/NDARTH930FNK/NDARTH930FNK_Video2_Samples_ET.mat, Diary, 120, 4177870002, 4295267874, 117397872
/Volumes/methlab_data/HBN/EEG-ET/NDARTH930FNK/NDARTH930FNK_Video3_Samples_ET.mat, Despicable, 120, 5000176279, 5170723730, 170547451
/Volumes/methlab_data/HBN/EEG-ET/NDARTH930FNK/NDARTH930FNK_Video4_Samples_ET.mat, Present, 120, 5789262095, 5992330476, 203068381
/Volumes/methlab_data/HBN/EEG-ET/NDARTJ032FJ2/NDARTJ032FJ2_Video1_Samples_ET.mat, Diary, 60, 5313026827, 5430416047, 117389220
/Volumes/methlab_data/HBN/EEG-ET/NDARTJ032FJ2/NDARTJ032FJ2_Video3_Samples_ET.mat, Despicable, 60, 4836166901, 5006720796, 170553895
/Volumes/methlab_data/HBN/EEG-ET/NDARTJ418GP0/NDARTJ418GP0_Video1_Samples_ET.mat, Diary, 60, 3950629367, 4068022217, 117392850
/Volumes/methlab_data/HBN/EEG-ET/NDARTJ418GP0/NDARTJ418GP0_Video3_Samples_ET.mat, Despicable, 60, 5282624201, 5453172538, 170548337
/Volumes/methlab_data/HBN/EEG-ET/NDARTJ862ENU/NDARTJ862ENU_Video-DM_Samples_ET.mat, Despicable, 60, 5334861656, 5505400207, 170538551
/Volumes/methlab_data/HBN/EEG-ET/NDARTJ862ENU/NDARTJ862ENU_Video-TP_Samples_ET.mat, Present, 60, 6262322036, 6465588695, 203266659
/Volumes/methlab_data/HBN/EEG-ET/NDARTJ862ENU/NDARTJ862ENU_Video-WK_Samples_ET.mat, Diary, 60, 5840806171, 5958194149, 117387978
/Volumes/methlab_data/HBN/EEG-ET/NDARTK056HL3/NDARTK056HL3_Video-DM_Samples_ET.mat, Despicable, 60, 6860634436, 7031171778, 170537342
/Volumes/methlab_data/HBN/EEG-ET/NDARTK056HL3/NDARTK056HL3_Video-FF_Samples_ET.mat, Fractals, 60, 6154868475, 6317860491, 162992016
/Volumes/methlab_data/HBN/EEG-ET/NDARTK056HL3/NDARTK056HL3_Video-TP_Samples_ET.mat, Present, 60, 7812970395, 8016035701, 203065306
/Volumes/methlab_data/HBN/EEG-ET/NDARTK056HL3/NDARTK056HL3_Video-WK_Samples_ET.mat, Diary, 60, 7301294351, 7418682199, 117387848
/Volumes/methlab_data/HBN/EEG-ET/NDARTK185PBH/NDARTK185PBH_Video1_Samples_ET.mat, Diary, 60, 2103828198, 2221220217, 117392019
/Volumes/methlab_data/HBN/EEG-ET/NDARTK185PBH/NDARTK185PBH_Video3_Samples_ET.mat, Despicable, 60, 3303796149, 3474340695, 170544546
/Volumes/methlab_data/HBN/EEG-ET/NDARTK524HRR/NDARTK524HRR_Video-DM_Samples_ET.mat, Despicable, 30, 4503587155, 4674123737, 170536582
/Volumes/methlab_data/HBN/EEG-ET/NDARTK524HRR/NDARTK524HRR_Video-TP_Samples_ET.mat, Present, 30, 5070030618, 5273296355, 203265737
/Volumes/methlab_data/HBN/EEG-ET/NDARTK524HRR/NDARTK524HRR_Video-WK_Samples_ET.mat, Diary, 30, 3153924937, 3271311948, 117387011
/Volumes/methlab_data/HBN/EEG-ET/NDARTK657DV6/NDARTK657DV6_Video1_Samples_ET.mat, Diary, 60, 5243374617, 5360762314, 117387697
/Volumes/methlab_data/HBN/EEG-ET/NDARTK657DV6/NDARTK657DV6_Video3_Samples_ET.mat, Despicable, 60, 5697607589, 5868157806, 170550217
/Volumes/methlab_data/HBN/EEG-ET/NDARTK667PGK/NDARTK667PGK_Video-DM_Samples_ET.mat, Despicable, 30, 6477472321, 6648012800, 170540479
/Volumes/methlab_data/HBN/EEG-ET/NDARTK667PGK/NDARTK667PGK_Video-TP_Samples_ET.mat, Present, 30, 6949417656, 7152684234, 203266578
/Volumes/methlab_data/HBN/EEG-ET/NDARTK667PGK/NDARTK667PGK_Video-WK_Samples_ET.mat, Diary, 30, 5273094686, 5390483621, 117388935
/Volumes/methlab_data/HBN/EEG-ET/NDARTK691PJJ/NDARTK691PJJ_Video1_Samples_ET.mat, Diary, 60, 618802363, 736187532, 117385169
/Volumes/methlab_data/HBN/EEG-ET/NDARTK834FT9/NDARTK834FT9_Video1_Samples_ET.mat, Diary, 60, 2796229193, 2913626651, 117397458
/Volumes/methlab_data/HBN/EEG-ET/NDARTK878GZK/NDARTK878GZK_Video1_Samples_ET.mat, Diary, 60, 4299870207, 4417256154, 117385947
/Volumes/methlab_data/HBN/EEG-ET/NDARTK878GZK/NDARTK878GZK_Video3_Samples_ET.mat, Despicable, 60, 4084787218, 4255325742, 170538524
/Volumes/methlab_data/HBN/EEG-ET/NDARTK933KL9/NDARTK933KL9_Video1_Samples_ET.mat, Diary, 60, 2811770322, 2929162808, 117392486
/Volumes/methlab_data/HBN/EEG-ET/NDARTK933KL9/NDARTK933KL9_Video3_Samples_ET.mat, Despicable, 60, 2378583995, 2549135004, 170551009
/Volumes/methlab_data/HBN/EEG-ET/NDARTK950DY5/NDARTK950DY5_Video1_Samples_ET.mat, Diary, 60, 3816129623, 3933521590, 117391967
/Volumes/methlab_data/HBN/EEG-ET/NDARTK950DY5/NDARTK950DY5_Video3_Samples_ET.mat, Despicable, 60, 3596707558, 3767248094, 170540536
/Volumes/methlab_data/HBN/EEG-ET/NDARTL084LYM/NDARTL084LYM_Video-DM_Samples_ET.mat, Despicable, 60, 4694938064, 4865479691, 170541627
/Volumes/methlab_data/HBN/EEG-ET/NDARTL084LYM/NDARTL084LYM_Video-FF_Samples_ET.mat, Fractals, 60, 4482865059, 4645847344, 162982285
/Volumes/methlab_data/HBN/EEG-ET/NDARTL084LYM/NDARTL084LYM_Video-TP_Samples_ET.mat, Present, 60, 5290078864, 5493152503, 203073639
/Volumes/methlab_data/HBN/EEG-ET/NDARTL084LYM/NDARTL084LYM_Video-WK_Samples_ET.mat, Diary, 60, 4098509206, 4215904262, 117395056
/Volumes/methlab_data/HBN/EEG-ET/NDARTL336THT/NDARTL336THT_Video1_Samples_ET.mat, Diary, 60, 3291124386, 3408520385, 117395999
/Volumes/methlab_data/HBN/EEG-ET/NDARTL336THT/NDARTL336THT_Video3_Samples_ET.mat, Despicable, 60, 3767338043, 3937881633, 170543590
/Volumes/methlab_data/HBN/EEG-ET/NDARTL667CCG/NDARTL667CCG_Video-DM_Samples_ET.mat, Despicable, 60, 9238018300, 9408560764, 170542464
/Volumes/methlab_data/HBN/EEG-ET/NDARTL667CCG/NDARTL667CCG_Video-FF_Samples_ET.mat, Fractals, 60, 9668832435, 9831823517, 162991082
/Volumes/methlab_data/HBN/EEG-ET/NDARTL667CCG/NDARTL667CCG_Video-TP_Samples_ET.mat, Present, 60, 10163515643, 10366578004, 203062361
/Volumes/methlab_data/HBN/EEG-ET/NDARTL667CCG/NDARTL667CCG_Video-WK_Samples_ET.mat, Diary, 60, 8443925729, 8561321622, 117395893
/Volumes/methlab_data/HBN/EEG-ET/NDARTL878RZ2/NDARTL878RZ2_Video-DM_Samples_ET.mat, Despicable, 60, 5769938968, 5940478564, 170539596
/Volumes/methlab_data/HBN/EEG-ET/NDARTL878RZ2/NDARTL878RZ2_Video-TP_Samples_ET.mat, Present, 60, 6242092812, 6445360519, 203267707
/Volumes/methlab_data/HBN/EEG-ET/NDARTL878RZ2/NDARTL878RZ2_Video-WK_Samples_ET.mat, Diary, 60, 5270564912, 5387948944, 117384032
/Volumes/methlab_data/HBN/EEG-ET/NDARTM562NEW/NDARTM562NEW_Video1_Samples_ET.mat, Diary, 60, 4312836776, 4430239806, 117403030
/Volumes/methlab_data/HBN/EEG-ET/NDARTM562NEW/NDARTM562NEW_Video3_Samples_ET.mat, Despicable, 60, 3892892868, 4063442479, 170549611
/Volumes/methlab_data/HBN/EEG-ET/NDARTM562NEW/NDARTM562NEW_Video4_Samples_ET.mat, Present, 60, 4720300865, 4923370440, 203069575
/Volumes/methlab_data/HBN/EEG-ET/NDARTM712HBD/NDARTM712HBD_Video-DM_Samples_ET.mat, Despicable, 30, 2159192591, 2329729108, 170536517
/Volumes/methlab_data/HBN/EEG-ET/NDARTM712HBD/NDARTM712HBD_Video-TP_Samples_ET.mat, Present, 30, 2920455534, 3123732201, 203276667
/Volumes/methlab_data/HBN/EEG-ET/NDARTM712HBD/NDARTM712HBD_Video-WK_Samples_ET.mat, Diary, 30, 2764076026, 2881464999, 117388973
/Volumes/methlab_data/HBN/EEG-ET/NDARTN158LRF/NDARTN158LRF_Video1_Samples_ET.mat, Diary, 60, 5222902054, 5340294943, 117392889
/Volumes/methlab_data/HBN/EEG-ET/NDARTN158LRF/NDARTN158LRF_Video3_Samples_ET.mat, Despicable, 60, 4713882700, 4884421133, 170538433
/Volumes/methlab_data/HBN/EEG-ET/NDARTN173MXV/NDARTN173MXV_Video1_Samples_ET.mat, Diary, 120, 5988186572, 6105583935, 117397363
/Volumes/methlab_data/HBN/EEG-ET/NDARTN173MXV/NDARTN173MXV_Video2_Samples_ET.mat, Despicable, 120, 7416188263, 7586744775, 170556512
/Volumes/methlab_data/HBN/EEG-ET/NDARTN173MXV/NDARTN173MXV_Video3_Samples_ET.mat, Fractals, 120, 7862754176, 8025742237, 162988061
/Volumes/methlab_data/HBN/EEG-ET/NDARTN173MXV/NDARTN173MXV_Video4_Samples_ET.mat, Present, 120, 8488631110, 8691699543, 203068433
/Volumes/methlab_data/HBN/EEG-ET/NDARTN400TB1/NDARTN400TB1_Video1_Samples_ET.mat, Diary, 60, 3832425848, 3949824243, 117398395
/Volumes/methlab_data/HBN/EEG-ET/NDARTN400TB1/NDARTN400TB1_Video3_Samples_ET.mat, Despicable, 60, 3333520607, 3504063754, 170543147
/Volumes/methlab_data/HBN/EEG-ET/NDARTN400TB1/NDARTN400TB1_Video4_Samples_ET.mat, Present, 60, 4280922311, 4483985501, 203063190
/Volumes/methlab_data/HBN/EEG-ET/NDARTN487KDK/NDARTN487KDK_Video1_Samples_ET.mat, Diary, 60, 2199630294, 2317024232, 117393938
/Volumes/methlab_data/HBN/EEG-ET/NDARTN487KDK/NDARTN487KDK_Video3_Samples_ET.mat, Despicable, 60, 3044432959, 3214978464, 170545505
/Volumes/methlab_data/HBN/EEG-ET/NDARTN712UJK/NDARTN712UJK_Video-DM_Samples_ET.mat, Despicable, 60, 3817543388, 3988093977, 170550589
/Volumes/methlab_data/HBN/EEG-ET/NDARTN712UJK/NDARTN712UJK_Video-FF_Samples_ET.mat, Fractals, 60, 3195012245, 3358004492, 162992247
/Volumes/methlab_data/HBN/EEG-ET/NDARTN712UJK/NDARTN712UJK_Video-TP_Samples_ET.mat, Present, 60, 4737219592, 4940280194, 203060602
/Volumes/methlab_data/HBN/EEG-ET/NDARTN712UJK/NDARTN712UJK_Video-WK_Samples_ET.mat, Diary, 60, 4279635080, 4397027101, 117392021
/Volumes/methlab_data/HBN/EEG-ET/NDARTP022VL6/NDARTP022VL6_Video-DM_Samples_ET.mat, Despicable, 60, 2577928268, 2748469800, 170541532
/Volumes/methlab_data/HBN/EEG-ET/NDARTP022VL6/NDARTP022VL6_Video-FF_Samples_ET.mat, Fractals, 60, 2128943000, 2291934196, 162991196
/Volumes/methlab_data/HBN/EEG-ET/NDARTP022VL6/NDARTP022VL6_Video-TP_Samples_ET.mat, Present, 60, 2793857852, 2996919375, 203061523
/Volumes/methlab_data/HBN/EEG-ET/NDARTP022VL6/NDARTP022VL6_Video-WK_Samples_ET.mat, Diary, 60, 1458058922, 1575447999, 117389077
/Volumes/methlab_data/HBN/EEG-ET/NDARTP190KAN/NDARTP190KAN_Video1_Samples_ET.mat, Despicable, 120, 2148495660, 2235235608, 2405782882
2.572872e+08, 1.705473e+08, /Volumes/methlab_data/HBN/EEG-ET/NDARTP190KAN/NDARTP190KAN_Video2_Samples_ET.mat, Fractals, 120, 2431044118, 2594031036, 162986918
/Volumes/methlab_data/HBN/EEG-ET/NDARTP190KAN/NDARTP190KAN_Video3_Samples_ET.mat, Diary, 120, 2623413061, 2740810190, 117397129
/Volumes/methlab_data/HBN/EEG-ET/NDARTP270UAV/NDARTP270UAV_Video-DM_Samples_ET.mat, Despicable, 60, 2283967350, 2454505976, 170538626
/Volumes/methlab_data/HBN/EEG-ET/NDARTP270UAV/NDARTP270UAV_Video-FF_Samples_ET.mat, Fractals, 60, 2675310136, 2838298440, 162988304
/Volumes/methlab_data/HBN/EEG-ET/NDARTP270UAV/NDARTP270UAV_Video-WK_Samples_ET.mat, Diary, 60, 2506198526, 2623597562, 117399036
/Volumes/methlab_data/HBN/EEG-ET/NDARTP307VUC/NDARTP307VUC_Video-DM_Samples_ET.mat, Despicable, 30, 4875305021, 5045854365, 170549344
/Volumes/methlab_data/HBN/EEG-ET/NDARTP307VUC/NDARTP307VUC_Video-TP_Samples_ET.mat, Present, 30, 5373015078, 5576279700, 203264622
/Volumes/methlab_data/HBN/EEG-ET/NDARTP307VUC/NDARTP307VUC_Video-WK_Samples_ET.mat, Diary, 30, 3713761734, 3831147260, 117385526
/Volumes/methlab_data/HBN/EEG-ET/NDARTP313AGH/NDARTP313AGH_Video3_Samples_ET.mat, Despicable, 60, 1816381085, 1986920760, 170539675
/Volumes/methlab_data/HBN/EEG-ET/NDARTP795WU2/NDARTP795WU2_Video1_Samples_ET.mat, Diary, 60, 4770448391, 4887842455, 117394064
/Volumes/methlab_data/HBN/EEG-ET/NDARTP795WU2/NDARTP795WU2_Video3_Samples_ET.mat, Despicable, 60, 4327991477, 4498537099, 170545622
/Volumes/methlab_data/HBN/EEG-ET/NDARTR157NPQ/NDARTR157NPQ_Video1_Samples_ET.mat, Diary, 120, 5804973341, 5922371718, 117398377
/Volumes/methlab_data/HBN/EEG-ET/NDARTR157NPQ/NDARTR157NPQ_Video2_Samples_ET.mat, Despicable, 120, 6698445603, 6868991589, 170545986
/Volumes/methlab_data/HBN/EEG-ET/NDARTR157NPQ/NDARTR157NPQ_Video3_Samples_ET.mat, Fractals, 120, 6918805988, 7081794334, 162988346
/Volumes/methlab_data/HBN/EEG-ET/NDARTR157NPQ/NDARTR157NPQ_Video4_Samples_ET.mat, Present, 120, 7790232612, 7993299195, 203066583
/Volumes/methlab_data/HBN/EEG-ET/NDARTR175UDC/NDARTR175UDC_Video-DM_Samples_ET.mat, Despicable, 120, 4322238191, 4492784777, 170546586
/Volumes/methlab_data/HBN/EEG-ET/NDARTR175UDC/NDARTR175UDC_Video-FF_Samples_ET.mat, Fractals, 120, 3694669338, 3857652787, 162983449
/Volumes/methlab_data/HBN/EEG-ET/NDARTR175UDC/NDARTR175UDC_Video-TP_Samples_ET.mat, Present, 120, 5123332436, 5326399964, 203067528
/Volumes/methlab_data/HBN/EEG-ET/NDARTR175UDC/NDARTR175UDC_Video-WK_Samples_ET.mat, Diary, 120, 2863165559, 2980563365, 117397806
/Volumes/methlab_data/HBN/EEG-ET/NDARTR365NCY/NDARTR365NCY_Video1_Samples_ET.mat, Diary, 60, 4301436211, 4418831080, 117394869
/Volumes/methlab_data/HBN/EEG-ET/NDARTR365NCY/NDARTR365NCY_Video3_Samples_ET.mat, Despicable, 60, 3517131507, 3687678929, 170547422
/Volumes/methlab_data/HBN/EEG-ET/NDARTR464DCR/NDARTR464DCR_Video-DM_Samples_ET.mat, Despicable, 60, 3302728583, 3473280833, 170552250
/Volumes/methlab_data/HBN/EEG-ET/NDARTR464DCR/NDARTR464DCR_Video-FF_Samples_ET.mat, Fractals, 60, 2349390747, 2512374540, 162983793
/Volumes/methlab_data/HBN/EEG-ET/NDARTR464DCR/NDARTR464DCR_Video-TP_Samples_ET.mat, Present, 60, 4169963965, 4373030302, 203066337
/Volumes/methlab_data/HBN/EEG-ET/NDARTR464DCR/NDARTR464DCR_Video-WK_Samples_ET.mat, Diary, 60, 3737348489, 3854741933, 117393444
/Volumes/methlab_data/HBN/EEG-ET/NDARTR811WH9/NDARTR811WH9_Video1_Samples_ET.mat, Diary, 60, 4192755136, 4310150162, 117395026
/Volumes/methlab_data/HBN/EEG-ET/NDARTR811WH9/NDARTR811WH9_Video3_Samples_ET.mat, Despicable, 60, 5650736395, 5821280974, 170544579
/Volumes/methlab_data/HBN/EEG-ET/NDARTR840XP1/NDARTR840XP1_Video1_Samples_ET.mat, Diary, 60, 5387031443, 5504419251, 117387808
/Volumes/methlab_data/HBN/EEG-ET/NDARTR840XP1/NDARTR840XP1_Video3_Samples_ET.mat, Despicable, 60, 5800917327, 5971463565, 170546238
/Volumes/methlab_data/HBN/EEG-ET/NDARTT242GNN/NDARTT242GNN_Video1_Samples_ET.mat, Diary, 60, 3013757389, 3131153263, 117395874
/Volumes/methlab_data/HBN/EEG-ET/NDARTT242GNN/NDARTT242GNN_Video3_Samples_ET.mat, Despicable, 60, 2801444581, 2971986943, 170542362
/Volumes/methlab_data/HBN/EEG-ET/NDARTT517NTJ/NDARTT517NTJ_Video-DM_Samples_ET.mat, Despicable, 60, 2249824759, 2420372360, 170547601
/Volumes/methlab_data/HBN/EEG-ET/NDARTT517NTJ/NDARTT517NTJ_Video-FF_Samples_ET.mat, Fractals, 60, 1792749215, 1955740565, 162991350
/Volumes/methlab_data/HBN/EEG-ET/NDARTT517NTJ/NDARTT517NTJ_Video-TP_Samples_ET.mat, Present, 60, 3191488991, 3394551682, 203062691
/Volumes/methlab_data/HBN/EEG-ET/NDARTT517NTJ/NDARTT517NTJ_Video-WK_Samples_ET.mat, Diary, 60, 2759087021, 2876475090, 117388069
/Volumes/methlab_data/HBN/EEG-ET/NDARTT667RKQ/NDARTT667RKQ_Video-DM_Samples_ET.mat, Despicable, 60, 2854202916, 3024746405, 170543489
/Volumes/methlab_data/HBN/EEG-ET/NDARTT667RKQ/NDARTT667RKQ_Video-FF_Samples_ET.mat, Fractals, 60, 3292689618, 3455672846, 162983228
/Volumes/methlab_data/HBN/EEG-ET/NDARTT667RKQ/NDARTT667RKQ_Video-TP_Samples_ET.mat, Present, 60, 3766731437, 3969805893, 203074456
/Volumes/methlab_data/HBN/EEG-ET/NDARTT667RKQ/NDARTT667RKQ_Video-WK_Samples_ET.mat, Diary, 60, 2174246681, 2291640607, 117393926
/Volumes/methlab_data/HBN/EEG-ET/NDARTT728XK8/NDARTT728XK8_Video-DM_Samples_ET.mat, Despicable, 120, 6252561676, 6423108716, 170547040
/Volumes/methlab_data/HBN/EEG-ET/NDARTT728XK8/NDARTT728XK8_Video-FF_Samples_ET.mat, Fractals, 120, 4977398769, 5140386783, 162988014
/Volumes/methlab_data/HBN/EEG-ET/NDARTT728XK8/NDARTT728XK8_Video-TP_Samples_ET.mat, Present, 120, 7167465087, 7370532104, 203067017
/Volumes/methlab_data/HBN/EEG-ET/NDARTT728XK8/NDARTT728XK8_Video-WK_Samples_ET.mat, Diary, 120, 6920437736, 7037834002, 117396266
/Volumes/methlab_data/HBN/EEG-ET/NDARTU280GKF/NDARTU280GKF_Video-DM_Samples_ET.mat, Despicable, 60, 4806273035, 4976810865, 170537830
/Volumes/methlab_data/HBN/EEG-ET/NDARTU280GKF/NDARTU280GKF_Video-TP_Samples_ET.mat, Present, 60, 5402745542, 5606023551, 203278009
/Volumes/methlab_data/HBN/EEG-ET/NDARTU280GKF/NDARTU280GKF_Video-WK_Samples_ET.mat, Diary, 60, 4409253824, 4526643995, 117390171
/Volumes/methlab_data/HBN/EEG-ET/NDARTU407HDD/NDARTU407HDD_Video-DM_Samples_ET.mat, Despicable, 60, 2505054569, 2675592009, 170537440
/Volumes/methlab_data/HBN/EEG-ET/NDARTU407HDD/NDARTU407HDD_Video-TP_Samples_ET.mat, Present, 60, 3414614019, 3617892557, 203278538
/Volumes/methlab_data/HBN/EEG-ET/NDARTU407HDD/NDARTU407HDD_Video-WK_Samples_ET.mat, Diary, 60, 2980151120, 3097537121, 117386001
/Volumes/methlab_data/HBN/EEG-ET/NDARTU644WHZ/NDARTU644WHZ_Video1_Samples_ET.mat, Diary, 60, 3985526403, 4102920494, 117394091
/Volumes/methlab_data/HBN/EEG-ET/NDARTU644WHZ/NDARTU644WHZ_Video2_Samples_ET.mat, Fractals, 60, 4673895526, 4836887872, 162992346
/Volumes/methlab_data/HBN/EEG-ET/NDARTU644WHZ/NDARTU644WHZ_Video3_Samples_ET.mat, Despicable, 60, 5090230134, 5260772814, 170542680
/Volumes/methlab_data/HBN/EEG-ET/NDARTU644WHZ/NDARTU644WHZ_Video4_Samples_ET.mat, Present, 60, 5559823407, 5762887124, 203063717
/Volumes/methlab_data/HBN/EEG-ET/NDARTU768MY1/NDARTU768MY1_Video1_Samples_ET.mat, Diary, 60, 1724358914, 1841757042, 117398128
/Volumes/methlab_data/HBN/EEG-ET/NDARTU768MY1/NDARTU768MY1_Video3_Samples_ET.mat, Despicable, 60, 2976492409, 3147040155, 170547746
/Volumes/methlab_data/HBN/EEG-ET/NDARTU777GVV/NDARTU777GVV_Video1_Samples_ET.mat, Diary, 60, 3242997197, 3360387153, 117389956
/Volumes/methlab_data/HBN/EEG-ET/NDARTU777GVV/NDARTU777GVV_Video3_Samples_ET.mat, Despicable, 60, 2819646515, 2990186105, 170539590
/Volumes/methlab_data/HBN/EEG-ET/NDARTV034RN2/NDARTV034RN2_Video-DM_Samples_ET.mat, Despicable, 60, 2289522077, 2460066904, 170544827
/Volumes/methlab_data/HBN/EEG-ET/NDARTV034RN2/NDARTV034RN2_Video-FF_Samples_ET.mat, Fractals, 60, 1698183213, 1861175686, 162992473
/Volumes/methlab_data/HBN/EEG-ET/NDARTV034RN2/NDARTV034RN2_Video-TP_Samples_ET.mat, Present, 60, 3509211028, 3712272874, 203061846
/Volumes/methlab_data/HBN/EEG-ET/NDARTV034RN2/NDARTV034RN2_Video-WK_Samples_ET.mat, Diary, 60, 2948143600, 3065536790, 117393190
/Volumes/methlab_data/HBN/EEG-ET/NDARTV107XD4/NDARTV107XD4_Video1_Samples_ET.mat, Diary, 60, 5009088875, 5126484780, 117395905
/Volumes/methlab_data/HBN/EEG-ET/NDARTV107XD4/NDARTV107XD4_Video2_Samples_ET.mat, Fractals, 60, 3728233744, 3891217761, 162984017
/Volumes/methlab_data/HBN/EEG-ET/NDARTV107XD4/NDARTV107XD4_Video3_Samples_ET.mat, Despicable, 60, 4566720602, 4737257021, 170536419
/Volumes/methlab_data/HBN/EEG-ET/NDARTV107XD4/NDARTV107XD4_Video4_Samples_ET.mat, Present, 60, 5462404891, 5665476280, 203071389
/Volumes/methlab_data/HBN/EEG-ET/NDARTV119WJK/NDARTV119WJK_Video-DM_Samples_ET.mat, Despicable, 60, 5611046285, 5781595574, 170549289
/Volumes/methlab_data/HBN/EEG-ET/NDARTV119WJK/NDARTV119WJK_Video-FF_Samples_ET.mat, Fractals, 60, 6045217453, 6208207424, 162989971
/Volumes/methlab_data/HBN/EEG-ET/NDARTV119WJK/NDARTV119WJK_Video-TP_Samples_ET.mat, Present, 60, 6599543381, 6802599624, 203056243
/Volumes/methlab_data/HBN/EEG-ET/NDARTV119WJK/NDARTV119WJK_Video-WK_Samples_ET.mat, Diary, 60, 5003348719, 5120741515, 117392796
/Volumes/methlab_data/HBN/EEG-ET/NDARTV222FA9/NDARTV222FA9_Video-DM_Samples_ET.mat, Despicable, 120, 4385358112, 4555904903, 170546791
/Volumes/methlab_data/HBN/EEG-ET/NDARTV222FA9/NDARTV222FA9_Video-FF_Samples_ET.mat, Fractals, 120, 3814924002, 3977909844, 162985842
/Volumes/methlab_data/HBN/EEG-ET/NDARTV222FA9/NDARTV222FA9_Video-TP_Samples_ET.mat, Present, 120, 5226993657, 5430059950, 203066293
/Volumes/methlab_data/HBN/EEG-ET/NDARTV222FA9/NDARTV222FA9_Video-WK_Samples_ET.mat, Diary, 120, 4620727420, 4738124183, 117396763
/Volumes/methlab_data/HBN/EEG-ET/NDARTV296UNC/NDARTV296UNC_Video-DM_Samples_ET.mat, Despicable, 60, 5579296994, 5749846556, 170549562
/Volumes/methlab_data/HBN/EEG-ET/NDARTV296UNC/NDARTV296UNC_Video-FF_Samples_ET.mat, Fractals, 60, 4861150226, 5024140461, 162990235
/Volumes/methlab_data/HBN/EEG-ET/NDARTV296UNC/NDARTV296UNC_Video-TP_Samples_ET.mat, Present, 60, 6074159811, 6277229397, 203069586
/Volumes/methlab_data/HBN/EEG-ET/NDARTV296UNC/NDARTV296UNC_Video-WK_Samples_ET.mat, Diary, 60, 4241315005, 4358716998, 117401993
/Volumes/methlab_data/HBN/EEG-ET/NDARTV480WBU/NDARTV480WBU_Video-DM_Samples_ET.mat, Despicable, 30, 2247553650, 2418093298, 170539648
/Volumes/methlab_data/HBN/EEG-ET/NDARTV480WBU/NDARTV480WBU_Video-TP_Samples_ET.mat, Present, 30, 2769661914, 2972935697, 203273783
/Volumes/methlab_data/HBN/EEG-ET/NDARTV480WBU/NDARTV480WBU_Video-WK_Samples_ET.mat, Diary, 30, 1015160009, 1132557121, 117397112
/Volumes/methlab_data/HBN/EEG-ET/NDARTV525XC0/NDARTV525XC0_Video1_Samples_ET.mat, Diary, 60, 88985216747, 89102608763, 117392016
/Volumes/methlab_data/HBN/EEG-ET/NDARTV525XC0/NDARTV525XC0_Video3_Samples_ET.mat, Despicable, 60, 88513910554, 88684453129, 170542575
/Volumes/methlab_data/HBN/EEG-ET/NDARTV525XC0/NDARTV525XC0_Video4_Samples_ET.mat, Present, 60, 89430773757, 89633830330, 203056573
/Volumes/methlab_data/HBN/EEG-ET/NDARTW456RAG/NDARTW456RAG_Video-DM_Samples_ET.mat, Despicable, 60, 4233323983, 4403873727, 170549744
/Volumes/methlab_data/HBN/EEG-ET/NDARTW456RAG/NDARTW456RAG_Video-FF_Samples_ET.mat, Fractals, 60, 3713921242, 3876909662, 162988420
/Volumes/methlab_data/HBN/EEG-ET/NDARTW456RAG/NDARTW456RAG_Video-TP_Samples_ET.mat, Present, 60, 5241799950, 5444861739, 203061789
/Volumes/methlab_data/HBN/EEG-ET/NDARTW456RAG/NDARTW456RAG_Video-WK_Samples_ET.mat, Diary, 60, 4767570194, 4884958333, 117388139
/Volumes/methlab_data/HBN/EEG-ET/NDARTW501ZKN/NDARTW501ZKN_Video-DM_Samples_ET.mat, Despicable, 120, 13872874812, 14043422021, 170547209
/Volumes/methlab_data/HBN/EEG-ET/NDARTW501ZKN/NDARTW501ZKN_Video-FF_Samples_ET.mat, Fractals, 120, 12627243328, 12790230365, 162987037
/Volumes/methlab_data/HBN/EEG-ET/NDARTW501ZKN/NDARTW501ZKN_Video-TP_Samples_ET.mat, Present, 120, 14188932535, 14392000135, 203067600
/Volumes/methlab_data/HBN/EEG-ET/NDARTW501ZKN/NDARTW501ZKN_Video-WK_Samples_ET.mat, Diary, 120, 13416932006, 13534320593, 117388587
/Volumes/methlab_data/HBN/EEG-ET/NDARTW567YUQ/NDARTW567YUQ_Video-DM_Samples_ET.mat, Despicable, 30, 4442293416, 4612827100, 170533684
/Volumes/methlab_data/HBN/EEG-ET/NDARTW567YUQ/NDARTW567YUQ_Video-TP_Samples_ET.mat, Present, 30, 4940645070, 5143921938, 203276868
/Volumes/methlab_data/HBN/EEG-ET/NDARTW567YUQ/NDARTW567YUQ_Video-WK_Samples_ET.mat, Diary, 30, 3235928760, 3353317862, 117389102
/Volumes/methlab_data/HBN/EEG-ET/NDARTW855BPJ/NDARTW855BPJ_Video1_Samples_ET.mat, Diary, 60, 3180244262, 3297637194, 117392932
/Volumes/methlab_data/HBN/EEG-ET/NDARTW855BPJ/NDARTW855BPJ_Video3_Samples_ET.mat, Despicable, 60, 2502216392, 2672767855, 170551463
/Volumes/methlab_data/HBN/EEG-ET/NDARTW939GJF/NDARTW939GJF_Video1_Samples_ET.mat, Diary, 60, 2354684132, 2472083118, 117398986
/Volumes/methlab_data/HBN/EEG-ET/NDARTW939GJF/NDARTW939GJF_Video3_Samples_ET.mat, Despicable, 60, 3536419208, 3706961749, 170542541
/Volumes/methlab_data/HBN/EEG-ET/NDARTX012JHM/NDARTX012JHM_Video1_Samples_ET.mat, Diary, 60, 2228552358, 2345945489, 117393131
/Volumes/methlab_data/HBN/EEG-ET/NDARTX012JHM/NDARTX012JHM_Video3_Samples_ET.mat, Despicable, 60, 3742366042, 3912913673, 170547631
/Volumes/methlab_data/HBN/EEG-ET/NDARTX575YBU/NDARTX575YBU_Video-DM_Samples_ET.mat, Despicable, 60, 1216555221, 1387097732, 170542511
/Volumes/methlab_data/HBN/EEG-ET/NDARTX575YBU/NDARTX575YBU_Video-FF_Samples_ET.mat, Fractals, 60, 745073227, 908055371, 162982144
/Volumes/methlab_data/HBN/EEG-ET/NDARTX575YBU/NDARTX575YBU_Video-TP_Samples_ET.mat, Present, 60, 1721350775, 1924407193, 203056418
/Volumes/methlab_data/HBN/EEG-ET/NDARTX575YBU/NDARTX575YBU_Video-WK_Samples_ET.mat, Diary, 60, 173900805, 291295795, 117394990
/Volumes/methlab_data/HBN/EEG-ET/NDARTX659HAF/NDARTX659HAF_Video1_Samples_ET.mat, Diary, 120, 3323903546, 3441300162, 117396616
/Volumes/methlab_data/HBN/EEG-ET/NDARTX659HAF/NDARTX659HAF_Video2_Samples_ET.mat, Despicable, 120, 5376092339, 5546633756, 170541417
/Volumes/methlab_data/HBN/EEG-ET/NDARTX659HAF/NDARTX659HAF_Video3_Samples_ET.mat, Fractals, 120, 5912134108, 6075131520, 162997412
/Volumes/methlab_data/HBN/EEG-ET/NDARTX659HAF/NDARTX659HAF_Video4_Samples_ET.mat, Present, 120, 6581100193, 6784166997, 203066804
/Volumes/methlab_data/HBN/EEG-ET/NDARTX795AKR/NDARTX795AKR_Video1_Samples_ET.mat, Despicable, 120, 2363958068, 2506457029, 2677004012
3.130459e+08, 1.705470e+08, /Volumes/methlab_data/HBN/EEG-ET/NDARTX795AKR/NDARTX795AKR_Video2_Samples_ET.mat, Fractals, 120, 2900573903, 3063561312, 162987409
/Volumes/methlab_data/HBN/EEG-ET/NDARTX795AKR/NDARTX795AKR_Video3_Samples_ET.mat, Diary, 120, 3211542435, 3328940001, 117397566
/Volumes/methlab_data/HBN/EEG-ET/NDARTX795AKR/NDARTX795AKR_Video4_Samples_ET.mat, Present, 120, 3593299367, 3796367672, 203068305
/Volumes/methlab_data/HBN/EEG-ET/NDARTX934NH6/NDARTX934NH6_Video1_Samples_ET.mat, Diary, 60, 2726440242, 2843829286, 117389044
/Volumes/methlab_data/HBN/EEG-ET/NDARTX934NH6/NDARTX934NH6_Video3_Samples_ET.mat, Despicable, 60, 2515411983, 2685958636, 170546653
/Volumes/methlab_data/HBN/EEG-ET/NDARTY010EYP/NDARTY010EYP_Video-DM_Samples_ET.mat, Despicable, 120, 6255180046, 6425727761, 170547715
/Volumes/methlab_data/HBN/EEG-ET/NDARTY010EYP/NDARTY010EYP_Video-FF_Samples_ET.mat, Fractals, 120, 5705763531, 5868748704, 162985173
/Volumes/methlab_data/HBN/EEG-ET/NDARTY010EYP/NDARTY010EYP_Video-TP_Samples_ET.mat, Present, 120, 6901656484, 7104724272, 203067788
/Volumes/methlab_data/HBN/EEG-ET/NDARTY010EYP/NDARTY010EYP_Video-WK_Samples_ET.mat, Diary, 120, 4927976780, 5045368059, 117391279
/Volumes/methlab_data/HBN/EEG-ET/NDARTY146DKE/NDARTY146DKE_Video1_Samples_ET.mat, Fractals, 120, 21383631254, 21546627808, 162996554
/Volumes/methlab_data/HBN/EEG-ET/NDARTY146DKE/NDARTY146DKE_Video2_Samples_ET.mat, Despicable, 120, 22522148523, 22692690147, 170541624
/Volumes/methlab_data/HBN/EEG-ET/NDARTY146DKE/NDARTY146DKE_Video3_Samples_ET.mat, Diary, 120, 23076618863, 23194009617, 117390754
/Volumes/methlab_data/HBN/EEG-ET/NDARTY146DKE/NDARTY146DKE_Video4_Samples_ET.mat, Present, 120, 23806104354, 24009168376, 203064022
/Volumes/methlab_data/HBN/EEG-ET/NDARTY225EWV/NDARTY225EWV_Video1_Samples_ET.mat, Diary, 120, 7920514456, 8037903131, 117388675
/Volumes/methlab_data/HBN/EEG-ET/NDARTY225EWV/NDARTY225EWV_Video2_Samples_ET.mat, Despicable, 120, 8707452210, 8877995440, 170543230
/Volumes/methlab_data/HBN/EEG-ET/NDARTY225EWV/NDARTY225EWV_Video3_Samples_ET.mat, Fractals, 120, 9261726922, 9424713888, 162986966
/Volumes/methlab_data/HBN/EEG-ET/NDARTY225EWV/NDARTY225EWV_Video4_Samples_ET.mat, Present, 120, 9937543454, 10140611024, 203067570
/Volumes/methlab_data/HBN/EEG-ET/NDARTY533VXQ/NDARTY533VXQ_Video-DM_Samples_ET.mat, Despicable, 60, 3274092599, 3444633289, 170540690
/Volumes/methlab_data/HBN/EEG-ET/NDARTY533VXQ/NDARTY533VXQ_Video-FF_Samples_ET.mat, Fractals, 60, 2485849813, 2648838159, 162988346
/Volumes/methlab_data/HBN/EEG-ET/NDARTY533VXQ/NDARTY533VXQ_Video-TP_Samples_ET.mat, Present, 60, 4149177827, 4352248541, 203070714
/Volumes/methlab_data/HBN/EEG-ET/NDARTY533VXQ/NDARTY533VXQ_Video-WK_Samples_ET.mat, Diary, 60, 3719254592, 3836645707, 117391115
/Volumes/methlab_data/HBN/EEG-ET/NDARTY549YDG/NDARTY549YDG_Video1_Samples_ET.mat, Diary, 60, 3784278406, 3901670393, 117391987
/Volumes/methlab_data/HBN/EEG-ET/NDARTY549YDG/NDARTY549YDG_Video2_Samples_ET.mat, Fractals, 60, 4353466613, 4516450807, 162984194
/Volumes/methlab_data/HBN/EEG-ET/NDARTY549YDG/NDARTY549YDG_Video3_Samples_ET.mat, Despicable, 60, 4775344755, 4945886264, 170541509
/Volumes/methlab_data/HBN/EEG-ET/NDARTY549YDG/NDARTY549YDG_Video4_Samples_ET.mat, Present, 60, 5248176876, 5451236377, 203059501
/Volumes/methlab_data/HBN/EEG-ET/NDARTY636BWN/NDARTY636BWN_Video1_Samples_ET.mat, Diary, 120, 2899408696, 3016796566, 117387870
/Volumes/methlab_data/HBN/EEG-ET/NDARTY636BWN/NDARTY636BWN_Video2_Samples_ET.mat, Despicable, 120, 3773664103, 3944210723, 170546620
/Volumes/methlab_data/HBN/EEG-ET/NDARTY636BWN/NDARTY636BWN_Video3_Samples_ET.mat, Fractals, 120, 4286471211, 4449458323, 162987112
/Volumes/methlab_data/HBN/EEG-ET/NDARTY636BWN/NDARTY636BWN_Video4_Samples_ET.mat, Present, 120, 4979171156, 5182235921, 203064765
/Volumes/methlab_data/HBN/EEG-ET/NDARTY815JXG/NDARTY815JXG_Video-DM_Samples_ET.mat, Despicable, 60, 3929327262, 4099865741, 170538479
/Volumes/methlab_data/HBN/EEG-ET/NDARTY815JXG/NDARTY815JXG_Video-TP_Samples_ET.mat, Present, 60, 4769137403, 4972404989, 203267586
/Volumes/methlab_data/HBN/EEG-ET/NDARTY815JXG/NDARTY815JXG_Video-WK_Samples_ET.mat, Diary, 60, 4354063241, 4471452177, 117388936
/Volumes/methlab_data/HBN/EEG-ET/NDARTZ018PD5/NDARTZ018PD5_Video-DM_Samples_ET.mat, Despicable, 60, 4593730652, 4764281370, 170550718
/Volumes/methlab_data/HBN/EEG-ET/NDARTZ018PD5/NDARTZ018PD5_Video-FF_Samples_ET.mat, Fractals, 60, 4071937416, 4234927765, 162990349
/Volumes/methlab_data/HBN/EEG-ET/NDARTZ018PD5/NDARTZ018PD5_Video-TP_Samples_ET.mat, Present, 60, 5167846914, 5370916645, 203069731
/Volumes/methlab_data/HBN/EEG-ET/NDARTZ018PD5/NDARTZ018PD5_Video-WK_Samples_ET.mat, Diary, 60, 3532263548, 3649652593, 117389045
/Volumes/methlab_data/HBN/EEG-ET/NDARTZ901LDK/NDARTZ901LDK_Video1_Samples_ET.mat, Diary, 60, 6360318396, 6477719371, 117400975
/Volumes/methlab_data/HBN/EEG-ET/NDARTZ901LDK/NDARTZ901LDK_Video3_Samples_ET.mat, Despicable, 60, 5878915208, 6049466766, 170551558
/Volumes/methlab_data/HBN/EEG-ET/NDARTZ901LDK/NDARTZ901LDK_Video4_Samples_ET.mat, Present, 60, 6789309542, 6992382066, 203072524
/Volumes/methlab_data/HBN/EEG-ET/NDARTZ926NMZ/NDARTZ926NMZ_Video1_Samples_ET.mat, Diary, 60, 235567284, 352955501, 117388217
/Volumes/methlab_data/HBN/EEG-ET/NDARTZ926NMZ/NDARTZ926NMZ_Video3_Samples_ET.mat, Despicable, 60, 3697930291, 3868486641, 170556350
/Volumes/methlab_data/HBN/EEG-ET/NDARUA052GW0/NDARUA052GW0_Video-DM_Samples_ET.mat, Despicable, 30, 2939900568, 3110449055, 170548487
/Volumes/methlab_data/HBN/EEG-ET/NDARUA052GW0/NDARUA052GW0_Video-TP_Samples_ET.mat, Present, 30, 3462236496, 3665501074, 203264578
/Volumes/methlab_data/HBN/EEG-ET/NDARUA052GW0/NDARUA052GW0_Video-WK_Samples_ET.mat, Diary, 30, 1985150260, 2102539256, 117388996
/Volumes/methlab_data/HBN/EEG-ET/NDARUA421HT8/NDARUA421HT8_Video1_Samples_ET.mat, Diary, 60, 1358469542, 1475863540, 117393998
/Volumes/methlab_data/HBN/EEG-ET/NDARUA421HT8/NDARUA421HT8_Video3_Samples_ET.mat, Despicable, 60, 1143637621, 1314180240, 170542619
/Volumes/methlab_data/HBN/EEG-ET/NDARUA745NA8/NDARUA745NA8_Video-DM_Samples_ET.mat, Despicable, 60, 4498459251, 4668996780, 170537529
/Volumes/methlab_data/HBN/EEG-ET/NDARUA745NA8/NDARUA745NA8_Video-TP_Samples_ET.mat, Present, 60, 5025203463, 5228482148, 203278685
/Volumes/methlab_data/HBN/EEG-ET/NDARUA745NA8/NDARUA745NA8_Video-WK_Samples_ET.mat, Diary, 60, 3272961251, 3390347212, 117385961
/Volumes/methlab_data/HBN/EEG-ET/NDARUA821NUN/NDARUA821NUN_Video-DM_Samples_ET.mat, Despicable, 30, 2970669830, 3141208491, 170538661
/Volumes/methlab_data/HBN/EEG-ET/NDARUA821NUN/NDARUA821NUN_Video-TP_Samples_ET.mat, Present, 30, 3437766203, 3641045986, 203279783
/Volumes/methlab_data/HBN/EEG-ET/NDARUA821NUN/NDARUA821NUN_Video-WK_Samples_ET.mat, Diary, 30, 2804184067, 2921569114, 117385047
/Volumes/methlab_data/HBN/EEG-ET/NDARUB100PP9/NDARUB100PP9_Video-DM_Samples_ET.mat, Despicable, 30, 3966347280, 4136882897, 170535617
/Volumes/methlab_data/HBN/EEG-ET/NDARUB100PP9/NDARUB100PP9_Video-TP_Samples_ET.mat, Present, 30, 4720506476, 4923774207, 203267731
/Volumes/methlab_data/HBN/EEG-ET/NDARUB100PP9/NDARUB100PP9_Video-WK_Samples_ET.mat, Diary, 30, 4353193842, 4470579809, 117385967
/Volumes/methlab_data/HBN/EEG-ET/NDARUB231LHN/NDARUB231LHN_Video1_Samples_ET.mat, Diary, 60, 4532363099, 4649754031, 117390932
/Volumes/methlab_data/HBN/EEG-ET/NDARUB231LHN/NDARUB231LHN_Video3_Samples_ET.mat, Despicable, 60, 4061849780, 4232395267, 170545487
/Volumes/methlab_data/HBN/EEG-ET/NDARUB231LHN/NDARUB231LHN_Video4_Samples_ET.mat, Present, 60, 4944431130, 5147507587, 203076457
/Volumes/methlab_data/HBN/EEG-ET/NDARUB495UD1/NDARUB495UD1_Video-DM_Samples_ET.mat, Despicable, 60, 4283589394, 4454131815, 170542421
/Volumes/methlab_data/HBN/EEG-ET/NDARUB495UD1/NDARUB495UD1_Video-FF_Samples_ET.mat, Fractals, 60, 3856992242, 4019976343, 162984101
/Volumes/methlab_data/HBN/EEG-ET/NDARUB495UD1/NDARUB495UD1_Video-TP_Samples_ET.mat, Present, 60, 4755003171, 4958067567, 203064396
/Volumes/methlab_data/HBN/EEG-ET/NDARUB495UD1/NDARUB495UD1_Video-WK_Samples_ET.mat, Diary, 60, 3197193473, 3314588358, 117394885
/Volumes/methlab_data/HBN/EEG-ET/NDARUB962AXN/NDARUB962AXN_Video1_Samples_ET.mat, Diary, 120, 9774808978, 9892205324, 117396346
/Volumes/methlab_data/HBN/EEG-ET/NDARUB962AXN/NDARUB962AXN_Video2_Samples_ET.mat, Fractals, 120, 10585743813, 10748731369, 162987556
/Volumes/methlab_data/HBN/EEG-ET/NDARUB962AXN/NDARUB962AXN_Video3_Samples_ET.mat, Despicable, 120, 11002951544, 11173493657, 170542113
/Volumes/methlab_data/HBN/EEG-ET/NDARUB962AXN/NDARUB962AXN_Video4_Samples_ET.mat, Present, 120, 11660168285, 11863235806, 203067521
/Volumes/methlab_data/HBN/EEG-ET/NDARUC022JWT/NDARUC022JWT_Video1_Samples_ET.mat, Diary, 60, 3770584321, 3887979540, 117395219
/Volumes/methlab_data/HBN/EEG-ET/NDARUC022JWT/NDARUC022JWT_Video2_Samples_ET.mat, Fractals, 60, 4570576334, 4733569495, 162993161
/Volumes/methlab_data/HBN/EEG-ET/NDARUC022JWT/NDARUC022JWT_Video3_Samples_ET.mat, Despicable, 60, 5006043914, 5176584386, 170540472
/Volumes/methlab_data/HBN/EEG-ET/NDARUC022JWT/NDARUC022JWT_Video4_Samples_ET.mat, Present, 60, 5511915209, 5714980657, 203065448
/Volumes/methlab_data/HBN/EEG-ET/NDARUC144FN6/NDARUC144FN6_Video-DM_Samples_ET.mat, Despicable, 120, 6513320627, 6683867990, 170547363
/Volumes/methlab_data/HBN/EEG-ET/NDARUC144FN6/NDARUC144FN6_Video-FF_Samples_ET.mat, Fractals, 120, 5649528190, 5812523758, 162995568
/Volumes/methlab_data/HBN/EEG-ET/NDARUC144FN6/NDARUC144FN6_Video-TP_Samples_ET.mat, Present, 120, 7695735059, 7898799890, 203064831
/Volumes/methlab_data/HBN/EEG-ET/NDARUC144FN6/NDARUC144FN6_Video-WK_Samples_ET.mat, Diary, 120, 6988918149, 7106314928, 117396779
/Volumes/methlab_data/HBN/EEG-ET/NDARUC308ZLR/NDARUC308ZLR_Video-DM_Samples_ET.mat, Despicable, 30, 3695284037, 3865821322, 170537285
/Volumes/methlab_data/HBN/EEG-ET/NDARUC308ZLR/NDARUC308ZLR_Video-TP_Samples_ET.mat, Present, 30, 5081414557, 5284690935, 203276378
/Volumes/methlab_data/HBN/EEG-ET/NDARUC308ZLR/NDARUC308ZLR_Video-WK_Samples_ET.mat, Diary, 30, 4408084721, 4525476523, 117391802
/Volumes/methlab_data/HBN/EEG-ET/NDARUC356FCD/NDARUC356FCD_Video-DM_Samples_ET.mat, Despicable, 120, 5488457362, 5659013165, 170555803
/Volumes/methlab_data/HBN/EEG-ET/NDARUC356FCD/NDARUC356FCD_Video-FF_Samples_ET.mat, Fractals, 120, 4615376967, 4778360564, 162983597
/Volumes/methlab_data/HBN/EEG-ET/NDARUC356FCD/NDARUC356FCD_Video-TP_Samples_ET.mat, Present, 120, 6746919957, 6949986906, 203066949
/Volumes/methlab_data/HBN/EEG-ET/NDARUC356FCD/NDARUC356FCD_Video-WK_Samples_ET.mat, Diary, 120, 6124033476, 6241420768, 117387292
/Volumes/methlab_data/HBN/EEG-ET/NDARUC591FWN/NDARUC591FWN_Video-DM_Samples_ET.mat, Despicable, 60, 3669551610, 3840092915, 170541305
/Volumes/methlab_data/HBN/EEG-ET/NDARUC591FWN/NDARUC591FWN_Video-FF_Samples_ET.mat, Fractals, 60, 3250854195, 3413836150, 162981955
/Volumes/methlab_data/HBN/EEG-ET/NDARUC591FWN/NDARUC591FWN_Video-TP_Samples_ET.mat, Present, 60, 4139164909, 4342227215, 203062306
/Volumes/methlab_data/HBN/EEG-ET/NDARUC591FWN/NDARUC591FWN_Video-WK_Samples_ET.mat, Diary, 60, 2657363408, 2774758248, 117394840
/Volumes/methlab_data/HBN/EEG-ET/NDARUC715YN4/NDARUC715YN4_Video-DM_Samples_ET.mat, Despicable, 60, 6231748305, 6402291437, 170543132
/Volumes/methlab_data/HBN/EEG-ET/NDARUC715YN4/NDARUC715YN4_Video-FF_Samples_ET.mat, Fractals, 60, 5801541853, 5964522608, 162980755
/Volumes/methlab_data/HBN/EEG-ET/NDARUC715YN4/NDARUC715YN4_Video-WK_Samples_ET.mat, Diary, 60, 4997224762, 5114620140, 117395378
/Volumes/methlab_data/HBN/EEG-ET/NDARUC771VM5/NDARUC771VM5_Video1_Samples_ET.mat, Fractals, 120, 2834173339, 2997159763, 162986424
/Volumes/methlab_data/HBN/EEG-ET/NDARUC771VM5/NDARUC771VM5_Video2_Samples_ET.mat, Diary, 120, 3551157375, 3668555241, 117397866
/Volumes/methlab_data/HBN/EEG-ET/NDARUC771VM5/NDARUC771VM5_Video3_Samples_ET.mat, Despicable, 120, 3754926291, 3925473471, 170547180
/Volumes/methlab_data/HBN/EEG-ET/NDARUC980NZ5/NDARUC980NZ5_Video-DM_Samples_ET.mat, Despicable, 60, 6527611748, 6698160264, 170548516
/Volumes/methlab_data/HBN/EEG-ET/NDARUC980NZ5/NDARUC980NZ5_Video-FF_Samples_ET.mat, Fractals, 60, 7047985513, 7210974645, 162989132
/Volumes/methlab_data/HBN/EEG-ET/NDARUC980NZ5/NDARUC980NZ5_Video-TP_Samples_ET.mat, Present, 60, 7543207404, 7746275918, 203068514
/Volumes/methlab_data/HBN/EEG-ET/NDARUC980NZ5/NDARUC980NZ5_Video-WK_Samples_ET.mat, Diary, 60, 5740188316, 5857577271, 117388955
/Volumes/methlab_data/HBN/EEG-ET/NDARUD394JAW/NDARUD394JAW_Video-WK_Samples_ET.mat, Diary, 60, 3521132903, 3638525846, 117392943
/Volumes/methlab_data/HBN/EEG-ET/NDARUD764NFJ/NDARUD764NFJ_Video1_Samples_ET.mat, Diary, 60, 2139133205, 2256528124, 117394919
/Volumes/methlab_data/HBN/EEG-ET/NDARUD764NFJ/NDARUD764NFJ_Video3_Samples_ET.mat, Despicable, 60, 753481741, 924026153, 170544412
/Volumes/methlab_data/HBN/EEG-ET/NDARUD776KFT/NDARUD776KFT_Video1_Samples_ET.mat, Diary, 60, 3937406866, 4054790846, 117383980
/Volumes/methlab_data/HBN/EEG-ET/NDARUD776KFT/NDARUD776KFT_Video2_Samples_ET.mat, Fractals, 60, 4099165232, 4262151451, 162986219
/Volumes/methlab_data/HBN/EEG-ET/NDARUD776KFT/NDARUD776KFT_Video3_Samples_ET.mat, Despicable, 60, 3716672787, 3887219377, 170546590
/Volumes/methlab_data/HBN/EEG-ET/NDARUD776KFT/NDARUD776KFT_Video4_Samples_ET.mat, Present, 60, 4311905612, 4514973199, 203067587
/Volumes/methlab_data/HBN/EEG-ET/NDARUE113AXB/NDARUE113AXB_Video-DM_Samples_ET.mat, Despicable, 30, 4271916573, 4442456196, 170539623
/Volumes/methlab_data/HBN/EEG-ET/NDARUE113AXB/NDARUE113AXB_Video-TP_Samples_ET.mat, Present, 30, 5213188296, 5416455094, 203266798
/Volumes/methlab_data/HBN/EEG-ET/NDARUE113AXB/NDARUE113AXB_Video-WK_Samples_ET.mat, Diary, 30, 4718197224, 4835581267, 117384043
/Volumes/methlab_data/HBN/EEG-ET/NDARUE398GGV/NDARUE398GGV_Video1_Samples_ET.mat, Diary, 120, 7041308537, 7158704982, 117396445
/Volumes/methlab_data/HBN/EEG-ET/NDARUE398GGV/NDARUE398GGV_Video2_Samples_ET.mat, Fractals, 120, 7486483995, 7649470873, 162986878
/Volumes/methlab_data/HBN/EEG-ET/NDARUE398GGV/NDARUE398GGV_Video3_Samples_ET.mat, Despicable, 120, 8000812073, 8171358986, 170546913
/Volumes/methlab_data/HBN/EEG-ET/NDARUE398GGV/NDARUE398GGV_Video4_Samples_ET.mat, Present, 120, 8733216876, 8936284048, 203067172
/Volumes/methlab_data/HBN/EEG-ET/NDARUE533XNH/NDARUE533XNH_Video1_Samples_ET.mat, Diary, 60, 3644123302, 3761516386, 117393084
/Volumes/methlab_data/HBN/EEG-ET/NDARUE533XNH/NDARUE533XNH_Video3_Samples_ET.mat, Despicable, 60, 3106394795, 3276934477, 170539682
/Volumes/methlab_data/HBN/EEG-ET/NDARUE605HGP/NDARUE605HGP_Video-DM_Samples_ET.mat, Despicable, 30, 4304790835, 4475323354, 170532519
/Volumes/methlab_data/HBN/EEG-ET/NDARUE605HGP/NDARUE605HGP_Video-TP_Samples_ET.mat, Present, 30, 4781890989, 4985160636, 203269647
/Volumes/methlab_data/HBN/EEG-ET/NDARUE605HGP/NDARUE605HGP_Video-WK_Samples_ET.mat, Diary, 30, 3030028047, 3147416091, 117388044
/Volumes/methlab_data/HBN/EEG-ET/NDARUF069EHR/NDARUF069EHR_Video1_Samples_ET.mat, Diary, 60, 2395151611, 2512547654, 117396043
/Volumes/methlab_data/HBN/EEG-ET/NDARUF069EHR/NDARUF069EHR_Video3_Samples_ET.mat, Despicable, 60, 3508487042, 3679026671, 170539629
/Volumes/methlab_data/HBN/EEG-ET/NDARUF152ARR/NDARUF152ARR_Video1_Samples_ET.mat, Diary, 60, 4245967903, 4363364891, 117396988
/Volumes/methlab_data/HBN/EEG-ET/NDARUF152ARR/NDARUF152ARR_Video3_Samples_ET.mat, Despicable, 60, 3820436216, 3990984742, 170548526
/Volumes/methlab_data/HBN/EEG-ET/NDARUF170ABA/NDARUF170ABA_Video-DM_Samples_ET.mat, Despicable, 60, 4132402647, 4302945264, 170542617
/Volumes/methlab_data/HBN/EEG-ET/NDARUF170ABA/NDARUF170ABA_Video-FF_Samples_ET.mat, Fractals, 60, 4577907723, 4740889018, 162981295
/Volumes/methlab_data/HBN/EEG-ET/NDARUF170ABA/NDARUF170ABA_Video-TP_Samples_ET.mat, Present, 60, 5186866436, 5389984129, 203117693
/Volumes/methlab_data/HBN/EEG-ET/NDARUF170ABA/NDARUF170ABA_Video-WK_Samples_ET.mat, Diary, 60, 3587653372, 3705044392, 117391020
/Volumes/methlab_data/HBN/EEG-ET/NDARUF236HM7/NDARUF236HM7_Video-DM_Samples_ET.mat, Despicable, 120, 4830019241, 5000565275, 170546034
/Volumes/methlab_data/HBN/EEG-ET/NDARUF236HM7/NDARUF236HM7_Video-FF_Samples_ET.mat, Fractals, 120, 4149893073, 4312879409, 162986336
/Volumes/methlab_data/HBN/EEG-ET/NDARUF236HM7/NDARUF236HM7_Video-TP_Samples_ET.mat, Present, 120, 5962231536, 6165299316, 203067780
/Volumes/methlab_data/HBN/EEG-ET/NDARUF236HM7/NDARUF236HM7_Video-WK_Samples_ET.mat, Diary, 120, 5290855036, 5408242875, 117387839
/Volumes/methlab_data/HBN/EEG-ET/NDARUF389TXE/NDARUF389TXE_Video1_Samples_ET.mat, Diary, 60, 3688110634, 3805502578, 117391944
/Volumes/methlab_data/HBN/EEG-ET/NDARUF389TXE/NDARUF389TXE_Video3_Samples_ET.mat, Despicable, 60, 5256151112, 5426689629, 170538517
/Volumes/methlab_data/HBN/EEG-ET/NDARUF540ZJ1/NDARUF540ZJ1_Video-DM_Samples_ET.mat, Despicable, 120, 2207256001, 2377797900, 170541899
/Volumes/methlab_data/HBN/EEG-ET/NDARUF540ZJ1/NDARUF540ZJ1_Video-FF_Samples_ET.mat, Fractals, 120, 2634891274, 2797870708, 162979434
/Volumes/methlab_data/HBN/EEG-ET/NDARUF540ZJ1/NDARUF540ZJ1_Video-TP_Samples_ET.mat, Present, 120, 2999108301, 3202171923, 203063622
/Volumes/methlab_data/HBN/EEG-ET/NDARUF540ZJ1/NDARUF540ZJ1_Video-WK_Samples_ET.mat, Diary, 120, 2841962361, 2959354102, 117391741
/Volumes/methlab_data/HBN/EEG-ET/NDARUF850XKH/NDARUF850XKH_Video-DM_Samples_ET.mat, Despicable, 60, 6186713917, 6357254462, 170540545
/Volumes/methlab_data/HBN/EEG-ET/NDARUF850XKH/NDARUF850XKH_Video-FF_Samples_ET.mat, Fractals, 60, 5724982629, 5887970831, 162988202
/Volumes/methlab_data/HBN/EEG-ET/NDARUF850XKH/NDARUF850XKH_Video-TP_Samples_ET.mat, Present, 60, 6699655387, 6902722894, 203067507
/Volumes/methlab_data/HBN/EEG-ET/NDARUF850XKH/NDARUF850XKH_Video-WK_Samples_ET.mat, Diary, 60, 5157458583, 5274853559, 117394976
/Volumes/methlab_data/HBN/EEG-ET/NDARUF935UL3/NDARUF935UL3_Video1_Samples_ET.mat, Diary, 60, 3658630268, 3776023273, 117393005
/Volumes/methlab_data/HBN/EEG-ET/NDARUF935UL3/NDARUF935UL3_Video3_Samples_ET.mat, Despicable, 60, 5541477443, 5712022021, 170544578
/Volumes/methlab_data/HBN/EEG-ET/NDARUG323DM3/NDARUG323DM3_Video1_Samples_ET.mat, Diary, 60, 12251653222, 12369051684, 117398462
/Volumes/methlab_data/HBN/EEG-ET/NDARUG323DM3/NDARUG323DM3_Video3_Samples_ET.mat, Despicable, 60, 11814276369, 11984829612, 170553243
/Volumes/methlab_data/HBN/EEG-ET/NDARUG492VF0/NDARUG492VF0_Video1_Samples_ET.mat, Diary, 60, 4011094241, 4128490113, 117395872
/Volumes/methlab_data/HBN/EEG-ET/NDARUG492VF0/NDARUG492VF0_Video2_Samples_ET.mat, Fractals, 60, 4937412454, 5100395226, 162982772
/Volumes/methlab_data/HBN/EEG-ET/NDARUG492VF0/NDARUG492VF0_Video3_Samples_ET.mat, Despicable, 60, 5366026709, 5536593149, 170566440
/Volumes/methlab_data/HBN/EEG-ET/NDARUG492VF0/NDARUG492VF0_Video4_Samples_ET.mat, Present, 60, 5861070176, 6064142559, 203072383
/Volumes/methlab_data/HBN/EEG-ET/NDARUG507AZX/NDARUG507AZX_Video1_Samples_ET.mat, Diary, 60, 2636276861, 2753661739, 117384878
/Volumes/methlab_data/HBN/EEG-ET/NDARUG507AZX/NDARUG507AZX_Video3_Samples_ET.mat, Despicable, 60, 4049577544, 4220122950, 170545406
/Volumes/methlab_data/HBN/EEG-ET/NDARUG859NKB/NDARUG859NKB_Video-DM_Samples_ET.mat, Despicable, 60, 4270374649, 4440923287, 170548638
/Volumes/methlab_data/HBN/EEG-ET/NDARUG859NKB/NDARUG859NKB_Video-FF_Samples_ET.mat, Fractals, 60, 3454618679, 3617610011, 162991332
/Volumes/methlab_data/HBN/EEG-ET/NDARUG859NKB/NDARUG859NKB_Video-TP_Samples_ET.mat, Present, 60, 4749736682, 4952807326, 203070644
/Volumes/methlab_data/HBN/EEG-ET/NDARUG859NKB/NDARUG859NKB_Video-WK_Samples_ET.mat, Diary, 60, 3884001386, 4001391488, 117390102
/Volumes/methlab_data/HBN/EEG-ET/NDARUH536DUK/NDARUH536DUK_Video-DM_Samples_ET.mat, Despicable, 60, 4135987893, 4306529618, 170541725
/Volumes/methlab_data/HBN/EEG-ET/NDARUH536DUK/NDARUH536DUK_Video-FF_Samples_ET.mat, Fractals, 60, 3612949769, 3775938165, 162988396
/Volumes/methlab_data/HBN/EEG-ET/NDARUH536DUK/NDARUH536DUK_Video-TP_Samples_ET.mat, Present, 60, 4760591878, 4963659599, 203067721
/Volumes/methlab_data/HBN/EEG-ET/NDARUH536DUK/NDARUH536DUK_Video-WK_Samples_ET.mat, Diary, 60, 2854452046, 2971844153, 117392107
/Volumes/methlab_data/HBN/EEG-ET/NDARUJ182TDW/NDARUJ182TDW_Video-DM_Samples_ET.mat, Despicable, 120, 4725752416, 4896297904, 170545488
/Volumes/methlab_data/HBN/EEG-ET/NDARUJ182TDW/NDARUJ182TDW_Video-FF_Samples_ET.mat, Fractals, 120, 3537138362, 3700125524, 162987162
/Volumes/methlab_data/HBN/EEG-ET/NDARUJ182TDW/NDARUJ182TDW_Video-TP_Samples_ET.mat, Present, 120, 6017004033, 6220069062, 203065029
/Volumes/methlab_data/HBN/EEG-ET/NDARUJ182TDW/NDARUJ182TDW_Video-WK_Samples_ET.mat, Diary, 120, 5260268960, 5377660666, 117391706
/Volumes/methlab_data/HBN/EEG-ET/NDARUJ292JXV/NDARUJ292JXV_Video-DM_Samples_ET.mat, Despicable, 120, 3914729954, 4085277368, 170547414
/Volumes/methlab_data/HBN/EEG-ET/NDARUJ292JXV/NDARUJ292JXV_Video-FF_Samples_ET.mat, Fractals, 120, 3013086318, 3176082433, 162996115
/Volumes/methlab_data/HBN/EEG-ET/NDARUJ292JXV/NDARUJ292JXV_Video-TP_Samples_ET.mat, Present, 120, 4853135973, 5056202860, 203066887
/Volumes/methlab_data/HBN/EEG-ET/NDARUJ292JXV/NDARUJ292JXV_Video-WK_Samples_ET.mat, Diary, 120, 4362597794, 4479995392, 117397598
/Volumes/methlab_data/HBN/EEG-ET/NDARUJ646APQ/NDARUJ646APQ_Video1_Samples_ET.mat, Diary, 60, 3139821029, 3257215584, 117394555
/Volumes/methlab_data/HBN/EEG-ET/NDARUJ646APQ/NDARUJ646APQ_Video3_Samples_ET.mat, Despicable, 60, 2697091102, 2867637454, 170546352
/Volumes/methlab_data/HBN/EEG-ET/NDARUJ744NEU/NDARUJ744NEU_Video1_Samples_ET.mat, Diary, 60, 2535444040, 2652839845, 117395805
/Volumes/methlab_data/HBN/EEG-ET/NDARUJ744NEU/NDARUJ744NEU_Video4_Samples_ET.mat, Present, 60, 698876585, 901938763, 203062178
/Volumes/methlab_data/HBN/EEG-ET/NDARUJ779NM0/NDARUJ779NM0_Video1_Samples_ET.mat, Diary, 60, 4754612910, 4872009856, 117396946
/Volumes/methlab_data/HBN/EEG-ET/NDARUJ779NM0/NDARUJ779NM0_Video3_Samples_ET.mat, Despicable, 60, 4310441010, 4480981539, 170540529
/Volumes/methlab_data/HBN/EEG-ET/NDARUJ894ZXG/NDARUJ894ZXG_Video-DM_Samples_ET.mat, Despicable, 60, 2345999725, 2516542237, 170542512
/Volumes/methlab_data/HBN/EEG-ET/NDARUJ894ZXG/NDARUJ894ZXG_Video-FF_Samples_ET.mat, Fractals, 60, 1649977120, 1812965291, 162988171
/Volumes/methlab_data/HBN/EEG-ET/NDARUJ894ZXG/NDARUJ894ZXG_Video-TP_Samples_ET.mat, Present, 60, 3223506489, 3426578943, 203072454
/Volumes/methlab_data/HBN/EEG-ET/NDARUJ894ZXG/NDARUJ894ZXG_Video-WK_Samples_ET.mat, Diary, 60, 2790084497, 2907476325, 117391828
/Volumes/methlab_data/HBN/EEG-ET/NDARUJ962NZB/NDARUJ962NZB_Video1_Samples_ET.mat, Diary, 60, 1953390460, 2070806678, 117416218
/Volumes/methlab_data/HBN/EEG-ET/NDARUJ962NZB/NDARUJ962NZB_Video3_Samples_ET.mat, Despicable, 60, 1213125096, 1383666914, 170541818
/Volumes/methlab_data/HBN/EEG-ET/NDARUK025ZFT/NDARUK025ZFT_Video-DM_Samples_ET.mat, Despicable, 60, 7427334484, 7597885308, 170550824
/Volumes/methlab_data/HBN/EEG-ET/NDARUK025ZFT/NDARUK025ZFT_Video-TP_Samples_ET.mat, Present, 60, 8262929355, 8466195387, 203266032
/Volumes/methlab_data/HBN/EEG-ET/NDARUK025ZFT/NDARUK025ZFT_Video-WK_Samples_ET.mat, Diary, 60, 7656781997, 7774171186, 117389189
/Volumes/methlab_data/HBN/EEG-ET/NDARUK054GTN/NDARUK054GTN_Video-DM_Samples_ET.mat, Despicable, 60, 4390458366, 4560998152, 170539786
/Volumes/methlab_data/HBN/EEG-ET/NDARUK054GTN/NDARUK054GTN_Video-FF_Samples_ET.mat, Fractals, 60, 3250999672, 3413982055, 162982383
/Volumes/methlab_data/HBN/EEG-ET/NDARUK054GTN/NDARUK054GTN_Video-WK_Samples_ET.mat, Diary, 60, 3934440516, 4051832639, 117392123
/Volumes/methlab_data/HBN/EEG-ET/NDARUK329RUU/NDARUK329RUU_Video1_Samples_ET.mat, Diary, 60, 3217860044, 3335259237, 117399193
/Volumes/methlab_data/HBN/EEG-ET/NDARUK329RUU/NDARUK329RUU_Video3_Samples_ET.mat, Despicable, 60, 4351167343, 4521716040, 170548697
/Volumes/methlab_data/HBN/EEG-ET/NDARUK329RUU/NDARUK329RUU_Video4_Samples_ET.mat, Present, 60, 4836758624, 5039821299, 203062675
/Volumes/methlab_data/HBN/EEG-ET/NDARUK588UY6/NDARUK588UY6_Video-DM_Samples_ET.mat, Despicable, 60, 4917579992, 5088115688, 170535696
/Volumes/methlab_data/HBN/EEG-ET/NDARUK588UY6/NDARUK588UY6_Video-TP_Samples_ET.mat, Present, 60, 6969799451, 7173078252, 203278801
/Volumes/methlab_data/HBN/EEG-ET/NDARUK588UY6/NDARUK588UY6_Video-WK_Samples_ET.mat, Diary, 60, 5711131251, 5828521291, 117390040
/Volumes/methlab_data/HBN/EEG-ET/NDARUK658FMU/NDARUK658FMU_Video-DM_Samples_ET.mat, Despicable, 120, 6189631044, 6360173444, 170542400
/Volumes/methlab_data/HBN/EEG-ET/NDARUK658FMU/NDARUK658FMU_Video-FF_Samples_ET.mat, Fractals, 120, 5415228647, 5578225132, 162996485
/Volumes/methlab_data/HBN/EEG-ET/NDARUK658FMU/NDARUK658FMU_Video-TP_Samples_ET.mat, Present, 120, 7389895421, 7592962244, 203066823
/Volumes/methlab_data/HBN/EEG-ET/NDARUK658FMU/NDARUK658FMU_Video-WK_Samples_ET.mat, Diary, 120, 6721689848, 6839087387, 117397539
/Volumes/methlab_data/HBN/EEG-ET/NDARUK719URM/NDARUK719URM_Video-WK_Samples_ET.mat, Diary, 60, 1435381504, 1552776528, 117395024
/Volumes/methlab_data/HBN/EEG-ET/NDARUL160DMT/NDARUL160DMT_Video-DM_Samples_ET.mat, Despicable, 60, 3213623895, 3384168540, 170544645
/Volumes/methlab_data/HBN/EEG-ET/NDARUL160DMT/NDARUL160DMT_Video-FF_Samples_ET.mat, Fractals, 60, 2764731400, 2927722704, 162991304
/Volumes/methlab_data/HBN/EEG-ET/NDARUL160DMT/NDARUL160DMT_Video-TP_Samples_ET.mat, Present, 60, 3736309597, 3939368201, 203058604
/Volumes/methlab_data/HBN/EEG-ET/NDARUL160DMT/NDARUL160DMT_Video-WK_Samples_ET.mat, Diary, 60, 1889769559, 2007164619, 117395060
/Volumes/methlab_data/HBN/EEG-ET/NDARUL224GN6/NDARUL224GN6_Video1_Samples_ET.mat, Diary, 120, 3074879097, 3192276487, 117397390
/Volumes/methlab_data/HBN/EEG-ET/NDARUL224GN6/NDARUL224GN6_Video2_Samples_ET.mat, Fractals, 120, 4606357865, 4769354929, 162997064
/Volumes/methlab_data/HBN/EEG-ET/NDARUL224GN6/NDARUL224GN6_Video3_Samples_ET.mat, Despicable, 120, 5124795151, 5295342002, 170546851
/Volumes/methlab_data/HBN/EEG-ET/NDARUL224GN6/NDARUL224GN6_Video4_Samples_ET.mat, Present, 120, 5801805925, 6004870626, 203064701
/Volumes/methlab_data/HBN/EEG-ET/NDARUL290YKN/NDARUL290YKN_Video-DM_Samples_ET.mat, Despicable, 30, 5614618640, 5785157189, 170538549
/Volumes/methlab_data/HBN/EEG-ET/NDARUL290YKN/NDARUL290YKN_Video-TP_Samples_ET.mat, Present, 30, 6087713951, 6290990609, 203276658
/Volumes/methlab_data/HBN/EEG-ET/NDARUL290YKN/NDARUL290YKN_Video-WK_Samples_ET.mat, Diary, 30, 4479420466, 4596812428, 117391962
/Volumes/methlab_data/HBN/EEG-ET/NDARUL341DD2/NDARUL341DD2_Video3_Samples_ET.mat, Despicable, 60, 2036592018, 2207131445, 170539427
/Volumes/methlab_data/HBN/EEG-ET/NDARUL456EER/NDARUL456EER_Video1_Samples_ET.mat, Diary, 60, 6860141877, 6977543152, 117401275
/Volumes/methlab_data/HBN/EEG-ET/NDARUL456EER/NDARUL456EER_Video3_Samples_ET.mat, Despicable, 60, 6412519492, 6583071443, 170551951
/Volumes/methlab_data/HBN/EEG-ET/NDARUL636NGK/NDARUL636NGK_Video-DM_Samples_ET.mat, Despicable, 60, 5532697099, 5703242749, 170545650
/Volumes/methlab_data/HBN/EEG-ET/NDARUL636NGK/NDARUL636NGK_Video-FF_Samples_ET.mat, Fractals, 60, 4827979656, 4990963975, 162984319
/Volumes/methlab_data/HBN/EEG-ET/NDARUL636NGK/NDARUL636NGK_Video-TP_Samples_ET.mat, Present, 60, 6025156397, 6228215032, 203058635
/Volumes/methlab_data/HBN/EEG-ET/NDARUL636NGK/NDARUL636NGK_Video-WK_Samples_ET.mat, Diary, 60, 4170253476, 4287646531, 117393055
/Volumes/methlab_data/HBN/EEG-ET/NDARUL675RXW/NDARUL675RXW_Video-DM_Samples_ET.mat, Despicable, 60, 4243996733, 4414541171, 170544438
/Volumes/methlab_data/HBN/EEG-ET/NDARUL675RXW/NDARUL675RXW_Video-FF_Samples_ET.mat, Fractals, 60, 3820451544, 3983444695, 162993151
/Volumes/methlab_data/HBN/EEG-ET/NDARUL675RXW/NDARUL675RXW_Video-TP_Samples_ET.mat, Present, 60, 4762670034, 4965742486, 203072452
/Volumes/methlab_data/HBN/EEG-ET/NDARUL675RXW/NDARUL675RXW_Video-WK_Samples_ET.mat, Diary, 60, 3111394754, 3228786681, 117391927
/Volumes/methlab_data/HBN/EEG-ET/NDARUL694GYN/NDARUL694GYN_Video-DM_Samples_ET.mat, Despicable, 60, 3962042165, 4132587104, 170544939
/Volumes/methlab_data/HBN/EEG-ET/NDARUL694GYN/NDARUL694GYN_Video-FF_Samples_ET.mat, Fractals, 60, 3514567897, 3677561469, 162993572
/Volumes/methlab_data/HBN/EEG-ET/NDARUL694GYN/NDARUL694GYN_Video-TP_Samples_ET.mat, Present, 60, 4476590998, 4679648999, 203058001
/Volumes/methlab_data/HBN/EEG-ET/NDARUL694GYN/NDARUL694GYN_Video-WK_Samples_ET.mat, Diary, 60, 2887884531, 3005352834, 117468303
/Volumes/methlab_data/HBN/EEG-ET/NDARUL881JR9/NDARUL881JR9_Video1_Samples_ET.mat, Diary, 120, 4195164484, 4312552621, 117388137
/Volumes/methlab_data/HBN/EEG-ET/NDARUL881JR9/NDARUL881JR9_Video2_Samples_ET.mat, Fractals, 120, 5437895939, 5600883550, 162987611
/Volumes/methlab_data/HBN/EEG-ET/NDARUL881JR9/NDARUL881JR9_Video3_Samples_ET.mat, Despicable, 120, 5929383282, 6099930936, 170547654
/Volumes/methlab_data/HBN/EEG-ET/NDARUL945XUU/NDARUL945XUU_Video1_Samples_ET.mat, Diary, 120, 3301413306, 3418810591, 117397285
/Volumes/methlab_data/HBN/EEG-ET/NDARUL945XUU/NDARUL945XUU_Video2_Samples_ET.mat, Fractals, 120, 4613233880, 4776217491, 162983611
/Volumes/methlab_data/HBN/EEG-ET/NDARUL945XUU/NDARUL945XUU_Video3_Samples_ET.mat, Despicable, 120, 5120585533, 5291127031, 170541498
/Volumes/methlab_data/HBN/EEG-ET/NDARUL945XUU/NDARUL945XUU_Video4_Samples_ET.mat, Present, 120, 5760856599, 5963934776, 203078177
/Volumes/methlab_data/HBN/EEG-ET/NDARUM009GEZ/NDARUM009GEZ_Video1_Samples_ET.mat, Diary, 120, 3262749846, 3380137218, 117387372
/Volumes/methlab_data/HBN/EEG-ET/NDARUM009GEZ/NDARUM009GEZ_Video2_Samples_ET.mat, Fractals, 120, 4217613230, 4380601319, 162988089
/Volumes/methlab_data/HBN/EEG-ET/NDARUM009GEZ/NDARUM009GEZ_Video3_Samples_ET.mat, Despicable, 120, 4709231351, 4879778443, 170547092
/Volumes/methlab_data/HBN/EEG-ET/NDARUM009GEZ/NDARUM009GEZ_Video4_Samples_ET.mat, Present, 120, 5342722997, 5545786605, 203063608
/Volumes/methlab_data/HBN/EEG-ET/NDARUM569EV1/NDARUM569EV1_Video1_Samples_ET.mat, Diary, 60, 3414436783, 3531831769, 117394986
/Volumes/methlab_data/HBN/EEG-ET/NDARUM569EV1/NDARUM569EV1_Video3_Samples_ET.mat, Despicable, 60, 2987008769, 3157556322, 170547553
/Volumes/methlab_data/HBN/EEG-ET/NDARUM721FCJ/NDARUM721FCJ_Video-DM_Samples_ET.mat, Despicable, 30, 4263041534, 4433578183, 170536649
/Volumes/methlab_data/HBN/EEG-ET/NDARUM721FCJ/NDARUM721FCJ_Video-TP_Samples_ET.mat, Present, 30, 4757926544, 4961202339, 203275795
/Volumes/methlab_data/HBN/EEG-ET/NDARUM721FCJ/NDARUM721FCJ_Video-WK_Samples_ET.mat, Diary, 30, 3127401323, 3244787351, 117386028
/Volumes/methlab_data/HBN/EEG-ET/NDARUM791WPF/NDARUM791WPF_Video1_Samples_ET.mat, Diary, 60, 4978595968, 5095995987, 117400019
/Volumes/methlab_data/HBN/EEG-ET/NDARUM791WPF/NDARUM791WPF_Video3_Samples_ET.mat, Despicable, 60, 5998111404, 6168656963, 170545559
/Volumes/methlab_data/HBN/EEG-ET/NDARUM991EE8/NDARUM991EE8_Video1_Samples_ET.mat, Diary, 60, 39080500, 156468255, 117387755
/Volumes/methlab_data/HBN/EEG-ET/NDARUM991EE8/NDARUM991EE8_Video3_Samples_ET.mat, Despicable, 60, 1409863011, 1580402226, 170539215
/Volumes/methlab_data/HBN/EEG-ET/NDARUN221VCJ/NDARUN221VCJ_Video1_Samples_ET.mat, Despicable, 120, 1864985107, 1940213132, 2110760453
2.457753e+08, 1.705473e+08, /Volumes/methlab_data/HBN/EEG-ET/NDARUN221VCJ/NDARUN221VCJ_Video2_Samples_ET.mat, Fractals, 120, 2193181946, 2356168546, 162986600
/Volumes/methlab_data/HBN/EEG-ET/NDARUN221VCJ/NDARUN221VCJ_Video3_Samples_ET.mat, Diary, 120, 2451440624, 2568828854, 117388230
/Volumes/methlab_data/HBN/EEG-ET/NDARUN221VCJ/NDARUN221VCJ_Video4_Samples_ET.mat, Present, 120, 2686428174, 2889494874, 203066700
/Volumes/methlab_data/HBN/EEG-ET/NDARUN300FG1/NDARUN300FG1_Video1_Samples_ET.mat, Diary, 120, 2953272664, 3070660129, 117387465
/Volumes/methlab_data/HBN/EEG-ET/NDARUN300FG1/NDARUN300FG1_Video2_Samples_ET.mat, Fractals, 120, 3662978401, 3825965481, 162987080
/Volumes/methlab_data/HBN/EEG-ET/NDARUN300FG1/NDARUN300FG1_Video3_Samples_ET.mat, Despicable, 120, 4164180497, 4334724893, 170544396
/Volumes/methlab_data/HBN/EEG-ET/NDARUN300FG1/NDARUN300FG1_Video4_Samples_ET.mat, Present, 120, 4813122625, 5016186807, 203064182
/Volumes/methlab_data/HBN/EEG-ET/NDARUP101NXA/NDARUP101NXA_Video1_Samples_ET.mat, Diary, 60, 3415937643, 3533331850, 117394207
/Volumes/methlab_data/HBN/EEG-ET/NDARUP101NXA/NDARUP101NXA_Video3_Samples_ET.mat, Despicable, 60, 2985347653, 3155890470, 170542817
/Volumes/methlab_data/HBN/EEG-ET/NDARUP249AMD/NDARUP249AMD_Video1_Samples_ET.mat, Diary, 60, 2920784422, 3038175443, 117391021
/Volumes/methlab_data/HBN/EEG-ET/NDARUP249AMD/NDARUP249AMD_Video3_Samples_ET.mat, Despicable, 60, 2402090712, 2572642307, 170551595
/Volumes/methlab_data/HBN/EEG-ET/NDARUP441BKK/NDARUP441BKK_Video-DM_Samples_ET.mat, Despicable, 60, 3064993122, 3235531754, 170538632
/Volumes/methlab_data/HBN/EEG-ET/NDARUP441BKK/NDARUP441BKK_Video-FF_Samples_ET.mat, Fractals, 60, 3527685383, 3690666679, 162981296
/Volumes/methlab_data/HBN/EEG-ET/NDARUP441BKK/NDARUP441BKK_Video-TP_Samples_ET.mat, Present, 60, 4096494713, 4299564325, 203069612
/Volumes/methlab_data/HBN/EEG-ET/NDARUP441BKK/NDARUP441BKK_Video-WK_Samples_ET.mat, Diary, 60, 2294857440, 2412248489, 117391049
/Volumes/methlab_data/HBN/EEG-ET/NDARUR009YJM/NDARUR009YJM_Video-DM_Samples_ET.mat, Despicable, 120, 14476651647, 14647198287, 170546640
/Volumes/methlab_data/HBN/EEG-ET/NDARUR009YJM/NDARUR009YJM_Video-FF_Samples_ET.mat, Fractals, 120, 13108892765, 13271876661, 162983896
/Volumes/methlab_data/HBN/EEG-ET/NDARUR009YJM/NDARUR009YJM_Video-TP_Samples_ET.mat, Present, 120, 15038578076, 15241654564, 203076488
/Volumes/methlab_data/HBN/EEG-ET/NDARUR009YJM/NDARUR009YJM_Video-WK_Samples_ET.mat, Diary, 120, 14023973000, 14141381583, 117408583
/Volumes/methlab_data/HBN/EEG-ET/NDARUR126CFH/NDARUR126CFH_Video-DM_Samples_ET.mat, Despicable, 120, 2759210922, 2929757460, 170546538
/Volumes/methlab_data/HBN/EEG-ET/NDARUR126CFH/NDARUR126CFH_Video-FF_Samples_ET.mat, Fractals, 120, 3874682131, 4037669918, 162987787
/Volumes/methlab_data/HBN/EEG-ET/NDARUR126CFH/NDARUR126CFH_Video-TP_Samples_ET.mat, Present, 120, 4154110569, 4357178188, 203067619
/Volumes/methlab_data/HBN/EEG-ET/NDARUR126CFH/NDARUR126CFH_Video-WK_Samples_ET.mat, Diary, 120, 3535414613, 3652812894, 117398281
/Volumes/methlab_data/HBN/EEG-ET/NDARUR987CDM/NDARUR987CDM_Video1_Samples_ET.mat, Diary, 120, 2838177896, 2955574621, 117396725
/Volumes/methlab_data/HBN/EEG-ET/NDARUR987CDM/NDARUR987CDM_Video2_Samples_ET.mat, Despicable, 120, 3736232289, 3906788462, 170556173
/Volumes/methlab_data/HBN/EEG-ET/NDARUR987CDM/NDARUR987CDM_Video3_Samples_ET.mat, Fractals, 120, 4230227241, 4393215446, 162988205
/Volumes/methlab_data/HBN/EEG-ET/NDARUR987CDM/NDARUR987CDM_Video4_Samples_ET.mat, Present, 120, 4794324059, 4997391771, 203067712
/Volumes/methlab_data/HBN/EEG-ET/NDARUT018UYN/NDARUT018UYN_Video1_Samples_ET.mat, Diary, 60, 4411559336, 4528958422, 117399086
/Volumes/methlab_data/HBN/EEG-ET/NDARUT018UYN/NDARUT018UYN_Video3_Samples_ET.mat, Despicable, 60, 3988106677, 4158647386, 170540709
/Volumes/methlab_data/HBN/EEG-ET/NDARUT142RT3/NDARUT142RT3_Video-DM_Samples_ET.mat, Despicable, 60, 3894587266, 4065132926, 170545660
/Volumes/methlab_data/HBN/EEG-ET/NDARUT142RT3/NDARUT142RT3_Video-TP_Samples_ET.mat, Present, 60, 4378529543, 4581834359, 203304816
/Volumes/methlab_data/HBN/EEG-ET/NDARUT142RT3/NDARUT142RT3_Video-WK_Samples_ET.mat, Diary, 60, 3502258795, 3619647861, 117389066
/Volumes/methlab_data/HBN/EEG-ET/NDARUT233WU9/NDARUT233WU9_Video1_Samples_ET.mat, Fractals, 120, 6818770730, 6981757742, 162987012
/Volumes/methlab_data/HBN/EEG-ET/NDARUT233WU9/NDARUT233WU9_Video2_Samples_ET.mat, Despicable, 120, 7973069298, 8143612995, 170543697
/Volumes/methlab_data/HBN/EEG-ET/NDARUT233WU9/NDARUT233WU9_Video3_Samples_ET.mat, Diary, 120, 8254441384, 8371839564, 117398180
/Volumes/methlab_data/HBN/EEG-ET/NDARUT233WU9/NDARUT233WU9_Video4_Samples_ET.mat, Present, 120, 8418910616, 8621978379, 203067763
/Volumes/methlab_data/HBN/EEG-ET/NDARUT470BM4/NDARUT470BM4_Video1_Samples_ET.mat, Diary, 60, 4126514176, 4243902161, 117387985
/Volumes/methlab_data/HBN/EEG-ET/NDARUT470BM4/NDARUT470BM4_Video3_Samples_ET.mat, Despicable, 60, 3695717757, 3866258289, 170540532
/Volumes/methlab_data/HBN/EEG-ET/NDARUT470BM4/NDARUT470BM4_Video4_Samples_ET.mat, Present, 60, 4536014539, 4739084070, 203069531
/Volumes/methlab_data/HBN/EEG-ET/NDARUT607MWK/NDARUT607MWK_Video1_Samples_ET.mat, Diary, 60, 3891091549, 4008485570, 117394021
/Volumes/methlab_data/HBN/EEG-ET/NDARUT607MWK/NDARUT607MWK_Video3_Samples_ET.mat, Despicable, 60, 3372880222, 3543422744, 170542522
/Volumes/methlab_data/HBN/EEG-ET/NDARUT880HVY/NDARUT880HVY_Video-DM_Samples_ET.mat, Despicable, 30, 5202696376, 5373234892, 170538516
/Volumes/methlab_data/HBN/EEG-ET/NDARUT880HVY/NDARUT880HVY_Video-TP_Samples_ET.mat, Present, 30, 5714491032, 5917769693, 203278661
/Volumes/methlab_data/HBN/EEG-ET/NDARUT880HVY/NDARUT880HVY_Video-WK_Samples_ET.mat, Diary, 30, 4123507768, 4240894732, 117386964
/Volumes/methlab_data/HBN/EEG-ET/NDARUT891XYJ/NDARUT891XYJ_Video1_Samples_ET.mat, Diary, 120, 5060896793, 5178283481, 117386688
/Volumes/methlab_data/HBN/EEG-ET/NDARUT891XYJ/NDARUT891XYJ_Video2_Samples_ET.mat, Despicable, 120, 6023644673, 6194190185, 170545512
/Volumes/methlab_data/HBN/EEG-ET/NDARUT891XYJ/NDARUT891XYJ_Video3_Samples_ET.mat, Fractals, 120, 6523252601, 6686249838, 162997237
/Volumes/methlab_data/HBN/EEG-ET/NDARUT891XYJ/NDARUT891XYJ_Video4_Samples_ET.mat, Present, 120, 7188126783, 7391188026, 203061243
/Volumes/methlab_data/HBN/EEG-ET/NDARUU314RH7/NDARUU314RH7_Video-DM_Samples_ET.mat, Despicable, 60, 5298200520, 5468738060, 170537540
/Volumes/methlab_data/HBN/EEG-ET/NDARUU314RH7/NDARUU314RH7_Video-FF_Samples_ET.mat, Fractals, 60, 3902310102, 4065299335, 162989233
/Volumes/methlab_data/HBN/EEG-ET/NDARUU314RH7/NDARUU314RH7_Video-TP_Samples_ET.mat, Present, 60, 5865621479, 6068691993, 203070514
/Volumes/methlab_data/HBN/EEG-ET/NDARUU314RH7/NDARUU314RH7_Video-WK_Samples_ET.mat, Diary, 60, 5044659343, 5162047320, 117387977
/Volumes/methlab_data/HBN/EEG-ET/NDARUU615WPR/NDARUU615WPR_Video1_Samples_ET.mat, Diary, 120, 10380716993, 10498114309, 117397316
/Volumes/methlab_data/HBN/EEG-ET/NDARUU615WPR/NDARUU615WPR_Video2_Samples_ET.mat, Fractals, 120, 11509589555, 11672577297, 162987742
/Volumes/methlab_data/HBN/EEG-ET/NDARUU615WPR/NDARUU615WPR_Video3_Samples_ET.mat, Despicable, 120, 12033667003, 12204234206, 170567203
/Volumes/methlab_data/HBN/EEG-ET/NDARUU615WPR/NDARUU615WPR_Video4_Samples_ET.mat, Present, 120, 12697243610, 12900311006, 203067396
/Volumes/methlab_data/HBN/EEG-ET/NDARUU801VFA/NDARUU801VFA_Video-DM_Samples_ET.mat, Despicable, 60, 3520538947, 3691081417, 170542470
/Volumes/methlab_data/HBN/EEG-ET/NDARUU801VFA/NDARUU801VFA_Video-FF_Samples_ET.mat, Fractals, 60, 3901086729, 4064076848, 162990119
/Volumes/methlab_data/HBN/EEG-ET/NDARUU801VFA/NDARUU801VFA_Video-TP_Samples_ET.mat, Present, 60, 4117737733, 4320799177, 203061444
/Volumes/methlab_data/HBN/EEG-ET/NDARUU801VFA/NDARUU801VFA_Video-WK_Samples_ET.mat, Diary, 60, 3743673536, 3861068505, 117394969
/Volumes/methlab_data/HBN/EEG-ET/NDARUU939VRT/NDARUU939VRT_Video-DM_Samples_ET.mat, Despicable, 30, 4732712844, 4903249992, 170537148
/Volumes/methlab_data/HBN/EEG-ET/NDARUU939VRT/NDARUU939VRT_Video-TP_Samples_ET.mat, Present, 30, 5343556202, 5546825476, 203269274
/Volumes/methlab_data/HBN/EEG-ET/NDARUU939VRT/NDARUU939VRT_Video-WK_Samples_ET.mat, Diary, 30, 3281579340, 3398971079, 117391739
/Volumes/methlab_data/HBN/EEG-ET/NDARUU991VRE/NDARUU991VRE_Video-DM_Samples_ET.mat, Despicable, 60, 3462723409, 3633266014, 170542605
/Volumes/methlab_data/HBN/EEG-ET/NDARUU991VRE/NDARUU991VRE_Video-FF_Samples_ET.mat, Fractals, 60, 3676154306, 3839149577, 162995271
/Volumes/methlab_data/HBN/EEG-ET/NDARUU991VRE/NDARUU991VRE_Video-TP_Samples_ET.mat, Present, 60, 4039733365, 4242803946, 203070581
/Volumes/methlab_data/HBN/EEG-ET/NDARUU991VRE/NDARUU991VRE_Video-WK_Samples_ET.mat, Diary, 60, 3880457752, 3997851766, 117394014
/Volumes/methlab_data/HBN/EEG-ET/NDARUV041YCY/NDARUV041YCY_Video1_Samples_ET.mat, Fractals, 120, 7443793218, 7606777718, 162984500
/Volumes/methlab_data/HBN/EEG-ET/NDARUV041YCY/NDARUV041YCY_Video2_Samples_ET.mat, Diary, 120, 8037501393, 8154894459, 117393066
/Volumes/methlab_data/HBN/EEG-ET/NDARUV041YCY/NDARUV041YCY_Video3_Samples_ET.mat, Despicable, 120, 8379391944, 8549931096, 170539152
/Volumes/methlab_data/HBN/EEG-ET/NDARUV041YCY/NDARUV041YCY_Video4_Samples_ET.mat, Present, 120, 9021344665, 9224408779, 203064114
/Volumes/methlab_data/HBN/EEG-ET/NDARUV147TDD/NDARUV147TDD_Video-DM_Samples_ET.mat, Despicable, 120, 4342110991, 4512658652, 170547661
/Volumes/methlab_data/HBN/EEG-ET/NDARUV147TDD/NDARUV147TDD_Video-FF_Samples_ET.mat, Fractals, 120, 3892369599, 4055355538, 162985939
/Volumes/methlab_data/HBN/EEG-ET/NDARUV147TDD/NDARUV147TDD_Video-TP_Samples_ET.mat, Present, 120, 5002113591, 5205177813, 203064222
/Volumes/methlab_data/HBN/EEG-ET/NDARUV147TDD/NDARUV147TDD_Video-WK_Samples_ET.mat, Diary, 120, 3413181027, 3530567548, 117386521
/Volumes/methlab_data/HBN/EEG-ET/NDARUV263YB5/NDARUV263YB5_Video1_Samples_ET.mat, Diary, 60, 3147643194, 3265042233, 117399039
/Volumes/methlab_data/HBN/EEG-ET/NDARUV263YB5/NDARUV263YB5_Video3_Samples_ET.mat, Despicable, 60, 2719018197, 2889560762, 170542565
/Volumes/methlab_data/HBN/EEG-ET/NDARUV418FB8/NDARUV418FB8_Video1_Samples_ET.mat, Diary, 60, 2998085198, 3115477044, 117391846
/Volumes/methlab_data/HBN/EEG-ET/NDARUV418FB8/NDARUV418FB8_Video3_Samples_ET.mat, Despicable, 60, 3761187350, 3931730644, 170543294
/Volumes/methlab_data/HBN/EEG-ET/NDARUV621PB0/NDARUV621PB0_Video1_Samples_ET.mat, Diary, 120, 20413989305, 20531386001, 117396696
/Volumes/methlab_data/HBN/EEG-ET/NDARUW206XUG/NDARUW206XUG_Video-FF_Samples_ET.mat, Fractals, 60, 4044324883, 4207315314, 162990431
/Volumes/methlab_data/HBN/EEG-ET/NDARUW206XUG/NDARUW206XUG_Video-TP_Samples_ET.mat, Present, 60, 5354356371, 5557428166, 203071795
/Volumes/methlab_data/HBN/EEG-ET/NDARUW206XUG/NDARUW206XUG_Video-WK_Samples_ET.mat, Diary, 60, 3312148530, 3429541651, 117393121
/Volumes/methlab_data/HBN/EEG-ET/NDARUW816MP3/NDARUW816MP3_Video1_Samples_ET.mat, Diary, 60, 2373814222, 2491201991, 117387769
/Volumes/methlab_data/HBN/EEG-ET/NDARUW816MP3/NDARUW816MP3_Video3_Samples_ET.mat, Despicable, 60, 1822649166, 1993192730, 170543564
/Volumes/methlab_data/HBN/EEG-ET/NDARUW904FMQ/NDARUW904FMQ_Video1_Samples_ET.mat, Diary, 60, 4229109250, 4346502334, 117393084
/Volumes/methlab_data/HBN/EEG-ET/NDARUW904FMQ/NDARUW904FMQ_Video3_Samples_ET.mat, Despicable, 60, 3800142706, 3970686405, 170543699
/Volumes/methlab_data/HBN/EEG-ET/NDARUX114RGJ/NDARUX114RGJ_Video1_Samples_ET.mat, Diary, 60, 4577715848, 4695110738, 117394890
/Volumes/methlab_data/HBN/EEG-ET/NDARUX114RGJ/NDARUX114RGJ_Video3_Samples_ET.mat, Despicable, 60, 4096976476, 4267519896, 170543420
/Volumes/methlab_data/HBN/EEG-ET/NDARUX187JTB/NDARUX187JTB_Video-DM_Samples_ET.mat, Despicable, 30, 2643392270, 2813926903, 170534633
/Volumes/methlab_data/HBN/EEG-ET/NDARUX187JTB/NDARUX187JTB_Video-TP_Samples_ET.mat, Present, 30, 3522030692, 3725298480, 203267788
/Volumes/methlab_data/HBN/EEG-ET/NDARUX187JTB/NDARUX187JTB_Video-WK_Samples_ET.mat, Diary, 30, 3087874644, 3205264690, 117390046
/Volumes/methlab_data/HBN/EEG-ET/NDARUX216VHK/NDARUX216VHK_Video1_Samples_ET.mat, Diary, 60, 2951464985, 3068861487, 117396502
/Volumes/methlab_data/HBN/EEG-ET/NDARUX216VHK/NDARUX216VHK_Video3_Samples_ET.mat, Despicable, 60, 3363251923, 3533797240, 170545317
/Volumes/methlab_data/HBN/EEG-ET/NDARUX315PE6/NDARUX315PE6_Video-DM_Samples_ET.mat, Despicable, 60, 4127321473, 4297859009, 170537536
/Volumes/methlab_data/HBN/EEG-ET/NDARUX315PE6/NDARUX315PE6_Video-TP_Samples_ET.mat, Present, 60, 4603111740, 4806376330, 203264590
/Volumes/methlab_data/HBN/EEG-ET/NDARUX315PE6/NDARUX315PE6_Video-WK_Samples_ET.mat, Diary, 60, 3015322678, 3132709651, 117386973
/Volumes/methlab_data/HBN/EEG-ET/NDARUX340FYC/NDARUX340FYC_Video-DM_Samples_ET.mat, Despicable, 60, 3861993242, 4032541831, 170548589
/Volumes/methlab_data/HBN/EEG-ET/NDARUX340FYC/NDARUX340FYC_Video-FF_Samples_ET.mat, Fractals, 60, 3106789318, 3269778569, 162989251
/Volumes/methlab_data/HBN/EEG-ET/NDARUX340FYC/NDARUX340FYC_Video-TP_Samples_ET.mat, Present, 60, 4735249647, 4938320261, 203070614
/Volumes/methlab_data/HBN/EEG-ET/NDARUX340FYC/NDARUX340FYC_Video-WK_Samples_ET.mat, Diary, 60, 4312218559, 4429605639, 117387080
/Volumes/methlab_data/HBN/EEG-ET/NDARUX534HZQ/NDARUX534HZQ_Video1_Samples_ET.mat, Diary, 60, 3787717883, 3905113863, 117395980
/Volumes/methlab_data/HBN/EEG-ET/NDARUX534HZQ/NDARUX534HZQ_Video2_Samples_ET.mat, Fractals, 60, 4375699382, 4538690559, 162991177
/Volumes/methlab_data/HBN/EEG-ET/NDARUX534HZQ/NDARUX534HZQ_Video3_Samples_ET.mat, Despicable, 60, 4803104400, 4973649936, 170545536
/Volumes/methlab_data/HBN/EEG-ET/NDARUX534HZQ/NDARUX534HZQ_Video4_Samples_ET.mat, Present, 60, 5283919170, 5486979676, 203060506
/Volumes/methlab_data/HBN/EEG-ET/NDARUX818MGE/NDARUX818MGE_Video-DM_Samples_ET.mat, Despicable, 60, 9636702676, 9807238193, 170535517
/Volumes/methlab_data/HBN/EEG-ET/NDARUX818MGE/NDARUX818MGE_Video-TP_Samples_ET.mat, Present, 60, 10397295154, 10600571826, 203276672
/Volumes/methlab_data/HBN/EEG-ET/NDARUX818MGE/NDARUX818MGE_Video-WK_Samples_ET.mat, Diary, 60, 10003019607, 10120405503, 117385896
/Volumes/methlab_data/HBN/EEG-ET/NDARUX885LMW/NDARUX885LMW_Video1_Samples_ET.mat, Diary, 60, 3200671833, 3318064804, 117392971
/Volumes/methlab_data/HBN/EEG-ET/NDARUX885LMW/NDARUX885LMW_Video2_Samples_ET.mat, Fractals, 60, 4027371994, 4190363189, 162991195
/Volumes/methlab_data/HBN/EEG-ET/NDARUX885LMW/NDARUX885LMW_Video3_Samples_ET.mat, Despicable, 60, 4482406557, 4652957092, 170550535
/Volumes/methlab_data/HBN/EEG-ET/NDARUX885LMW/NDARUX885LMW_Video4_Samples_ET.mat, Present, 60, 5004688629, 5207760137, 203071508
/Volumes/methlab_data/HBN/EEG-ET/NDARUX886JLM/NDARUX886JLM_Video1_Samples_ET.mat, Diary, 60, 5714160006, 5831545870, 117385864
/Volumes/methlab_data/HBN/EEG-ET/NDARUX886JLM/NDARUX886JLM_Video3_Samples_ET.mat, Despicable, 60, 5286023743, 5456565200, 170541457
/Volumes/methlab_data/HBN/EEG-ET/NDARUX911VE1/NDARUX911VE1_Video-DM_Samples_ET.mat, Despicable, 30, 2324618476, 2495154994, 170536518
/Volumes/methlab_data/HBN/EEG-ET/NDARUX911VE1/NDARUX911VE1_Video-TP_Samples_ET.mat, Present, 30, 87463208, 290731643, 203268435
/Volumes/methlab_data/HBN/EEG-ET/NDARUX911VE1/NDARUX911VE1_Video-WK_Samples_ET.mat, Diary, 30, 1641503489, 1758892329, 117388840
/Volumes/methlab_data/HBN/EEG-ET/NDARUY024RVP/NDARUY024RVP_Video-DM_Samples_ET.mat, Despicable, 30, 2876532826, 3047072591, 170539765
/Volumes/methlab_data/HBN/EEG-ET/NDARUY024RVP/NDARUY024RVP_Video-TP_Samples_ET.mat, Present, 30, 3831025591, 4034301531, 203275940
/Volumes/methlab_data/HBN/EEG-ET/NDARUY024RVP/NDARUY024RVP_Video-WK_Samples_ET.mat, Diary, 30, 3320410086, 3437797219, 117387133
/Volumes/methlab_data/HBN/EEG-ET/NDARUY379PT5/NDARUY379PT5_Video-DM_Samples_ET.mat, Despicable, 60, 6256030278, 6426571741, 170541463
/Volumes/methlab_data/HBN/EEG-ET/NDARUY379PT5/NDARUY379PT5_Video-FF_Samples_ET.mat, Fractals, 60, 5732168275, 5895156475, 162988200
/Volumes/methlab_data/HBN/EEG-ET/NDARUY379PT5/NDARUY379PT5_Video-TP_Samples_ET.mat, Present, 60, 6754095059, 6957155499, 203060440
/Volumes/methlab_data/HBN/EEG-ET/NDARUY379PT5/NDARUY379PT5_Video-WK_Samples_ET.mat, Diary, 60, 4884740746, 5002132670, 117391924
/Volumes/methlab_data/HBN/EEG-ET/NDARUY529FNK/NDARUY529FNK_Video1_Samples_ET.mat, Diary, 120, 5195710209, 5313106416, 117396207
/Volumes/methlab_data/HBN/EEG-ET/NDARUY529FNK/NDARUY529FNK_Video2_Samples_ET.mat, Fractals, 120, 5846663727, 6009652058, 162988331
/Volumes/methlab_data/HBN/EEG-ET/NDARUY529FNK/NDARUY529FNK_Video3_Samples_ET.mat, Despicable, 120, 6378246818, 6548788612, 170541794
/Volumes/methlab_data/HBN/EEG-ET/NDARUY529FNK/NDARUY529FNK_Video4_Samples_ET.mat, Present, 120, 7104307963, 7307375135, 203067172
/Volumes/methlab_data/HBN/EEG-ET/NDARUY549PGQ/NDARUY549PGQ_Video1_Samples_ET.mat, Fractals, 120, 6274371214, 6437367814, 162996600
/Volumes/methlab_data/HBN/EEG-ET/NDARUY549PGQ/NDARUY549PGQ_Video2_Samples_ET.mat, Despicable, 120, 7058313350, 7228854366, 170541016
/Volumes/methlab_data/HBN/EEG-ET/NDARUY549PGQ/NDARUY549PGQ_Video3_Samples_ET.mat, Diary, 120, 7532040333, 7649437323, 117396990
/Volumes/methlab_data/HBN/EEG-ET/NDARUY549PGQ/NDARUY549PGQ_Video4_Samples_ET.mat, Present, 120, 8114116771, 8317183834, 203067063
/Volumes/methlab_data/HBN/EEG-ET/NDARUY730ANT/NDARUY730ANT_Video1_Samples_ET.mat, Diary, 60, 3658618069, 3776013035, 117394966
/Volumes/methlab_data/HBN/EEG-ET/NDARUY730ANT/NDARUY730ANT_Video2_Samples_ET.mat, Fractals, 60, 3452605478, 3615588698, 162983220
/Volumes/methlab_data/HBN/EEG-ET/NDARUY730ANT/NDARUY730ANT_Video3_Samples_ET.mat, Despicable, 60, 3221111910, 3391666455, 170554545
/Volumes/methlab_data/HBN/EEG-ET/NDARUY730ANT/NDARUY730ANT_Video4_Samples_ET.mat, Present, 60, 3820593514, 4023663046, 203069532
/Volumes/methlab_data/HBN/EEG-ET/NDARUY811CYU/NDARUY811CYU_Video1_Samples_ET.mat, Diary, 60, 4711369210, 4828768979, 117399769
/Volumes/methlab_data/HBN/EEG-ET/NDARUY811CYU/NDARUY811CYU_Video3_Samples_ET.mat, Despicable, 60, 4287723559, 4458272800, 170549241
/Volumes/methlab_data/HBN/EEG-ET/NDARUY818JG8/NDARUY818JG8_Video-DM_Samples_ET.mat, Despicable, 60, 7650513611, 7821056026, 170542415
/Volumes/methlab_data/HBN/EEG-ET/NDARUY818JG8/NDARUY818JG8_Video-FF_Samples_ET.mat, Fractals, 60, 7226047967, 7389033064, 162985097
/Volumes/methlab_data/HBN/EEG-ET/NDARUY818JG8/NDARUY818JG8_Video-TP_Samples_ET.mat, Present, 60, 8131427116, 8334489488, 203062372
/Volumes/methlab_data/HBN/EEG-ET/NDARUY818JG8/NDARUY818JG8_Video-WK_Samples_ET.mat, Diary, 60, 6551490793, 6668885674, 117394881
/Volumes/methlab_data/HBN/EEG-ET/NDARUY825AKX/NDARUY825AKX_Video-DM_Samples_ET.mat, Despicable, 60, 5542437289, 5712976883, 170539594
/Volumes/methlab_data/HBN/EEG-ET/NDARUY825AKX/NDARUY825AKX_Video-TP_Samples_ET.mat, Present, 60, 6025793038, 6229062759, 203269721
/Volumes/methlab_data/HBN/EEG-ET/NDARUY825AKX/NDARUY825AKX_Video-WK_Samples_ET.mat, Diary, 60, 4280373009, 4397762026, 117389017
/Volumes/methlab_data/HBN/EEG-ET/NDARUY876VL1/NDARUY876VL1_Video1_Samples_ET.mat, Diary, 60, 3595330709, 3712724552, 117393843
/Volumes/methlab_data/HBN/EEG-ET/NDARUY876VL1/NDARUY876VL1_Video3_Samples_ET.mat, Despicable, 60, 3760576289, 3931116639, 170540350
/Volumes/methlab_data/HBN/EEG-ET/NDARUZ200NRJ/NDARUZ200NRJ_Video-DM_Samples_ET.mat, Despicable, 60, 4764389042, 4934926650, 170537608
/Volumes/methlab_data/HBN/EEG-ET/NDARUZ200NRJ/NDARUZ200NRJ_Video-TP_Samples_ET.mat, Present, 60, 5251922552, 5455200226, 203277674
/Volumes/methlab_data/HBN/EEG-ET/NDARUZ200NRJ/NDARUZ200NRJ_Video-WK_Samples_ET.mat, Diary, 60, 3592672051, 3710061068, 117389017
/Volumes/methlab_data/HBN/EEG-ET/NDARUZ206DRV/NDARUZ206DRV_Video1_Samples_ET.mat, Diary, 60, 5577717701, 5695104625, 117386924
/Volumes/methlab_data/HBN/EEG-ET/NDARUZ206DRV/NDARUZ206DRV_Video3_Samples_ET.mat, Despicable, 60, 5112527141, 5283070625, 170543484
/Volumes/methlab_data/HBN/EEG-ET/NDARUZ345THD/NDARUZ345THD_Video-DM_Samples_ET.mat, Despicable, 120, 4939624078, 5110171295, 170547217
/Volumes/methlab_data/HBN/EEG-ET/NDARUZ345THD/NDARUZ345THD_Video-FF_Samples_ET.mat, Fractals, 120, 4469518028, 4632504273, 162986245
/Volumes/methlab_data/HBN/EEG-ET/NDARUZ345THD/NDARUZ345THD_Video-TP_Samples_ET.mat, Present, 120, 5712818739, 5915886252, 203067513
/Volumes/methlab_data/HBN/EEG-ET/NDARUZ345THD/NDARUZ345THD_Video-WK_Samples_ET.mat, Diary, 120, 3582782832, 3700180411, 117397579
/Volumes/methlab_data/HBN/EEG-ET/NDARUZ368BT4/NDARUZ368BT4_Video1_Samples_ET.mat, Fractals, 120, 23608214500, 23771207857, 162993357
/Volumes/methlab_data/HBN/EEG-ET/NDARUZ368BT4/NDARUZ368BT4_Video2_Samples_ET.mat, Despicable, 120, 24353013698, 24523563718, 170550020
/Volumes/methlab_data/HBN/EEG-ET/NDARUZ368BT4/NDARUZ368BT4_Video3_Samples_ET.mat, Diary, 120, 24793108894, 24910502975, 117394081
/Volumes/methlab_data/HBN/EEG-ET/NDARUZ368BT4/NDARUZ368BT4_Video4_Samples_ET.mat, Present, 120, 25395917145, 25598989278, 203072133
/Volumes/methlab_data/HBN/EEG-ET/NDARUZ601TW4/NDARUZ601TW4_Video1_Samples_ET.mat, Diary, 30, 1748599579, 1865990415, 117390836
/Volumes/methlab_data/HBN/EEG-ET/NDARUZ601TW4/NDARUZ601TW4_Video2_Samples_ET.mat, Fractals, 30, 2354792279, 2517781317, 162989038
/Volumes/methlab_data/HBN/EEG-ET/NDARUZ601TW4/NDARUZ601TW4_Video3_Samples_ET.mat, Despicable, 30, 2784824705, 2955365049, 170540344
/Volumes/methlab_data/HBN/EEG-ET/NDARUZ601TW4/NDARUZ601TW4_Video4_Samples_ET.mat, Present, 30, 3304288228, 3507359519, 203071291
/Volumes/methlab_data/HBN/EEG-ET/NDARUZ859WCN/NDARUZ859WCN_Video-DM_Samples_ET.mat, Despicable, 30, 3539652721, 3710189320, 170536599
/Volumes/methlab_data/HBN/EEG-ET/NDARUZ859WCN/NDARUZ859WCN_Video-TP_Samples_ET.mat, Present, 30, 4140586582, 4343862321, 203275739
/Volumes/methlab_data/HBN/EEG-ET/NDARUZ859WCN/NDARUZ859WCN_Video-WK_Samples_ET.mat, Diary, 30, 3951579961, 4068968972, 117389011
/Volumes/methlab_data/HBN/EEG-ET/NDARVA930UA3/NDARVA930UA3_Video1_Samples_ET.mat, Present, 120, 5282738103, 5485804006, 203065903
/Volumes/methlab_data/HBN/EEG-ET/NDARVA930UA3/NDARVA930UA3_Video2_Samples_ET.mat, Diary, 120, 7771887211, 7889283698, 117396487
/Volumes/methlab_data/HBN/EEG-ET/NDARVA930UA3/NDARVA930UA3_Video3_Samples_ET.mat, Fractals, 120, 8511618680, 8674606841, 162988161
/Volumes/methlab_data/HBN/EEG-ET/NDARVA930UA3/NDARVA930UA3_Video4_Samples_ET.mat, Present, 120, 8788866905, 8991944418, 203077513
/Volumes/methlab_data/HBN/EEG-ET/NDARVB012UWL/NDARVB012UWL_Video1_Samples_ET.mat, Diary, 120, 5940053616, 6057440789, 117387173
/Volumes/methlab_data/HBN/EEG-ET/NDARVB012UWL/NDARVB012UWL_Video2_Samples_ET.mat, Despicable, 120, 6232444540, 6402991996, 170547456
/Volumes/methlab_data/HBN/EEG-ET/NDARVB012UWL/NDARVB012UWL_Video3_Samples_ET.mat, Fractals, 120, 6446062142, 6609050032, 162987890
/Volumes/methlab_data/HBN/EEG-ET/NDARVB012UWL/NDARVB012UWL_Video4_Samples_ET.mat, Present, 120, 6969259875, 7172327517, 203067642
/Volumes/methlab_data/HBN/EEG-ET/NDARVB151GXF/NDARVB151GXF_Video1_Samples_ET.mat, Diary, 60, 14874131021, 14991527066, 117396045
/Volumes/methlab_data/HBN/EEG-ET/NDARVB151GXF/NDARVB151GXF_Video2_Samples_ET.mat, Fractals, 60, 15907597963, 16070589257, 162991294
/Volumes/methlab_data/HBN/EEG-ET/NDARVB151GXF/NDARVB151GXF_Video3_Samples_ET.mat, Despicable, 60, 15405193628, 15575736864, 170543236
/Volumes/methlab_data/HBN/EEG-ET/NDARVB151GXF/NDARVB151GXF_Video4_Samples_ET.mat, Present, 60, 16374641291, 16577703939, 203062648
/Volumes/methlab_data/HBN/EEG-ET/NDARVB297WUM/NDARVB297WUM_Video1_Samples_ET.mat, Diary, 60, 4240185996, 4357585034, 117399038
/Volumes/methlab_data/HBN/EEG-ET/NDARVB297WUM/NDARVB297WUM_Video3_Samples_ET.mat, Despicable, 60, 3809561545, 3980113186, 170551641
/Volumes/methlab_data/HBN/EEG-ET/NDARVB587ECK/NDARVB587ECK_Video-DM_Samples_ET.mat, Despicable, 30, 4629190256, 4799737792, 170547536
/Volumes/methlab_data/HBN/EEG-ET/NDARVB587ECK/NDARVB587ECK_Video-TP_Samples_ET.mat, Present, 30, 5140396491, 5343663139, 203266648
/Volumes/methlab_data/HBN/EEG-ET/NDARVB587ECK/NDARVB587ECK_Video-WK_Samples_ET.mat, Diary, 30, 4216105348, 4333492316, 117386968
/Volumes/methlab_data/HBN/EEG-ET/NDARVB607WW4/NDARVB607WW4_Video1_Samples_ET.mat, Diary, 60, 3416488181, 3533882151, 117393970
/Volumes/methlab_data/HBN/EEG-ET/NDARVB607WW4/NDARVB607WW4_Video3_Samples_ET.mat, Despicable, 60, 2958984879, 3129524414, 170539535
/Volumes/methlab_data/HBN/EEG-ET/NDARVB727UJC/NDARVB727UJC_Video-DM_Samples_ET.mat, Despicable, 30, 4535766922, 4706305097, 170538175
/Volumes/methlab_data/HBN/EEG-ET/NDARVB727UJC/NDARVB727UJC_Video-TP_Samples_ET.mat, Present, 30, 5015015380, 5218282794, 203267414
/Volumes/methlab_data/HBN/EEG-ET/NDARVB727UJC/NDARVB727UJC_Video-WK_Samples_ET.mat, Diary, 30, 3244606700, 3361995116, 117388416
/Volumes/methlab_data/HBN/EEG-ET/NDARVB811FVD/NDARVB811FVD_Video1_Samples_ET.mat, Diary, 60, 3960815547, 4078209587, 117394040
/Volumes/methlab_data/HBN/EEG-ET/NDARVB811FVD/NDARVB811FVD_Video3_Samples_ET.mat, Despicable, 60, 3517548154, 3688093759, 170545605
/Volumes/methlab_data/HBN/EEG-ET/NDARVB819ENX/NDARVB819ENX_Video-DM_Samples_ET.mat, Despicable, 120, 4351938125, 4522485149, 170547024
/Volumes/methlab_data/HBN/EEG-ET/NDARVB819ENX/NDARVB819ENX_Video-FF_Samples_ET.mat, Fractals, 120, 3796157935, 3959152908, 162994973
/Volumes/methlab_data/HBN/EEG-ET/NDARVB819ENX/NDARVB819ENX_Video-TP_Samples_ET.mat, Present, 120, 4998023809, 5201090714, 203066905
/Volumes/methlab_data/HBN/EEG-ET/NDARVB819ENX/NDARVB819ENX_Video-WK_Samples_ET.mat, Diary, 120, 2892177194, 3009574331, 117397137
/Volumes/methlab_data/HBN/EEG-ET/NDARVB897AH1/NDARVB897AH1_Video-DM_Samples_ET.mat, Despicable, 60, 4236004362, 4406548880, 170544518
/Volumes/methlab_data/HBN/EEG-ET/NDARVB897AH1/NDARVB897AH1_Video-FF_Samples_ET.mat, Fractals, 60, 3802637099, 3965630299, 162993200
/Volumes/methlab_data/HBN/EEG-ET/NDARVB897AH1/NDARVB897AH1_Video-TP_Samples_ET.mat, Present, 60, 4724409461, 4927479990, 203070529
/Volumes/methlab_data/HBN/EEG-ET/NDARVB897AH1/NDARVB897AH1_Video-WK_Samples_ET.mat, Diary, 60, 3202039699, 3319433667, 117393968
/Volumes/methlab_data/HBN/EEG-ET/NDARVB902GA5/NDARVB902GA5_Video1_Samples_ET.mat, Diary, 120, 4423359297, 4540747313, 117388016
/Volumes/methlab_data/HBN/EEG-ET/NDARVB902GA5/NDARVB902GA5_Video2_Samples_ET.mat, Fractals, 120, 5078684687, 5241673779, 162989092
/Volumes/methlab_data/HBN/EEG-ET/NDARVB902GA5/NDARVB902GA5_Video3_Samples_ET.mat, Despicable, 120, 5579272168, 5749813824, 170541656
/Volumes/methlab_data/HBN/EEG-ET/NDARVB902GA5/NDARVB902GA5_Video4_Samples_ET.mat, Present, 120, 6279688290, 6482756189, 203067899
/Volumes/methlab_data/HBN/EEG-ET/NDARVC140PKY/NDARVC140PKY_Video-DM_Samples_ET.mat, Despicable, 120, 7125834816, 7296381970, 170547154
/Volumes/methlab_data/HBN/EEG-ET/NDARVC140PKY/NDARVC140PKY_Video-FF_Samples_ET.mat, Fractals, 120, 5127300561, 5290286785, 162986224
/Volumes/methlab_data/HBN/EEG-ET/NDARVC140PKY/NDARVC140PKY_Video-TP_Samples_ET.mat, Present, 120, 7819520917, 8022598244, 203077327
/Volumes/methlab_data/HBN/EEG-ET/NDARVC140PKY/NDARVC140PKY_Video-WK_Samples_ET.mat, Diary, 120, 6700417706, 6817806194, 117388488
/Volumes/methlab_data/HBN/EEG-ET/NDARVC195NLH/NDARVC195NLH_Video1_Samples_ET.mat, Fractals, 120, 3409361757, 3572358018, 162996261
/Volumes/methlab_data/HBN/EEG-ET/NDARVC195NLH/NDARVC195NLH_Video2_Samples_ET.mat, Despicable, 120, 4266425265, 4436969974, 170544709
/Volumes/methlab_data/HBN/EEG-ET/NDARVC195NLH/NDARVC195NLH_Video3_Samples_ET.mat, Diary, 120, 4748282528, 4865680428, 117397900
/Volumes/methlab_data/HBN/EEG-ET/NDARVC195NLH/NDARVC195NLH_Video4_Samples_ET.mat, Present, 120, 5347450479, 5550516448, 203065969
/Volumes/methlab_data/HBN/EEG-ET/NDARVC246ZY8/NDARVC246ZY8_Video1_Samples_ET.mat, Diary, 60, 1987693536, 2105090592, 117397056
/Volumes/methlab_data/HBN/EEG-ET/NDARVC246ZY8/NDARVC246ZY8_Video3_Samples_ET.mat, Despicable, 60, 3284036385, 3454579134, 170542749
/Volumes/methlab_data/HBN/EEG-ET/NDARVC305AC6/NDARVC305AC6_Video-DM_Samples_ET.mat, Despicable, 120, 4405664583, 4576212319, 170547736
/Volumes/methlab_data/HBN/EEG-ET/NDARVC305AC6/NDARVC305AC6_Video-FF_Samples_ET.mat, Fractals, 120, 3752349428, 3915335810, 162986382
/Volumes/methlab_data/HBN/EEG-ET/NDARVC305AC6/NDARVC305AC6_Video-TP_Samples_ET.mat, Present, 120, 5430529452, 5633599679, 203070227
/Volumes/methlab_data/HBN/EEG-ET/NDARVC305AC6/NDARVC305AC6_Video-WK_Samples_ET.mat, Diary, 120, 4840863135, 4958259519, 117396384
/Volumes/methlab_data/HBN/EEG-ET/NDARVC310XV2/NDARVC310XV2_Video1_Samples_ET.mat, Diary, 60, 3262841351, 3380236311, 117394960
/Volumes/methlab_data/HBN/EEG-ET/NDARVC310XV2/NDARVC310XV2_Video3_Samples_ET.mat, Despicable, 60, 3052339574, 3222882107, 170542533
/Volumes/methlab_data/HBN/EEG-ET/NDARVC310XV2/NDARVC310XV2_Video4_Samples_ET.mat, Present, 60, 3792278461, 3995335953, 203057492
/Volumes/methlab_data/HBN/EEG-ET/NDARVC318GTX/NDARVC318GTX_Video-DM_Samples_ET.mat, Despicable, 60, 3501416167, 3671959561, 170543394
/Volumes/methlab_data/HBN/EEG-ET/NDARVC318GTX/NDARVC318GTX_Video-FF_Samples_ET.mat, Fractals, 60, 3020101370, 3183095450, 162994080
/Volumes/methlab_data/HBN/EEG-ET/NDARVC318GTX/NDARVC318GTX_Video-TP_Samples_ET.mat, Present, 60, 3985200658, 4188261038, 203060380
/Volumes/methlab_data/HBN/EEG-ET/NDARVC318GTX/NDARVC318GTX_Video-WK_Samples_ET.mat, Diary, 60, 2362376059, 2479769958, 117393899
/Volumes/methlab_data/HBN/EEG-ET/NDARVC350WVG/NDARVC350WVG_Video1_Samples_ET.mat, Diary, 60, 25707253183, 25824642024, 117388841
/Volumes/methlab_data/HBN/EEG-ET/NDARVC350WVG/NDARVC350WVG_Video3_Samples_ET.mat, Despicable, 60, 25221358344, 25391909709, 170551365
/Volumes/methlab_data/HBN/EEG-ET/NDARVC350WVG/NDARVC350WVG_Video4_Samples_ET.mat, Present, 60, 26163485082, 26366545386, 203060304
/Volumes/methlab_data/HBN/EEG-ET/NDARVC518NWG/NDARVC518NWG_Video1_Samples_ET.mat, Diary, 120, 8175563918, 8292951603, 117387685
/Volumes/methlab_data/HBN/EEG-ET/NDARVC518NWG/NDARVC518NWG_Video2_Samples_ET.mat, Fractals, 120, 8955222494, 9118205127, 162982633
/Volumes/methlab_data/HBN/EEG-ET/NDARVC518NWG/NDARVC518NWG_Video3_Samples_ET.mat, Despicable, 120, 9375087720, 9545635355, 170547635
/Volumes/methlab_data/HBN/EEG-ET/NDARVC518NWG/NDARVC518NWG_Video4_Samples_ET.mat, Present, 120, 10100266193, 10303327475, 203061282
/Volumes/methlab_data/HBN/EEG-ET/NDARVC673HFA/NDARVC673HFA_Video1_Samples_ET.mat, Fractals, 120, 3937431793, 4100417204, 162985411
/Volumes/methlab_data/HBN/EEG-ET/NDARVC673HFA/NDARVC673HFA_Video2_Samples_ET.mat, Despicable, 120, 4925167469, 5095711679, 170544210
/Volumes/methlab_data/HBN/EEG-ET/NDARVC673HFA/NDARVC673HFA_Video3_Samples_ET.mat, Diary, 120, 5517828303, 5635218320, 117390017
/Volumes/methlab_data/HBN/EEG-ET/NDARVC673HFA/NDARVC673HFA_Video4_Samples_ET.mat, Present, 120, 6242161853, 6445234668, 203072815
/Volumes/methlab_data/HBN/EEG-ET/NDARVC711ZK0/NDARVC711ZK0_Video1_Samples_ET.mat, Diary, 60, 3468409810, 3585804676, 117394866
/Volumes/methlab_data/HBN/EEG-ET/NDARVC711ZK0/NDARVC711ZK0_Video2_Samples_ET.mat, Fractals, 60, 4133937595, 4296928685, 162991090
/Volumes/methlab_data/HBN/EEG-ET/NDARVC711ZK0/NDARVC711ZK0_Video3_Samples_ET.mat, Despicable, 60, 4566110715, 4736654113, 170543398
/Volumes/methlab_data/HBN/EEG-ET/NDARVC711ZK0/NDARVC711ZK0_Video4_Samples_ET.mat, Present, 60, 5069275890, 5272346282, 203070392
/Volumes/methlab_data/HBN/EEG-ET/NDARVC821LP9/NDARVC821LP9_Video-DM_Samples_ET.mat, Despicable, 60, 4656261221, 4826812764, 170551543
/Volumes/methlab_data/HBN/EEG-ET/NDARVC821LP9/NDARVC821LP9_Video-FF_Samples_ET.mat, Fractals, 60, 5183891068, 5346874784, 162983716
/Volumes/methlab_data/HBN/EEG-ET/NDARVC821LP9/NDARVC821LP9_Video-TP_Samples_ET.mat, Present, 60, 5682304253, 5885365764, 203061511
/Volumes/methlab_data/HBN/EEG-ET/NDARVC821LP9/NDARVC821LP9_Video-WK_Samples_ET.mat, Diary, 60, 3921297852, 4038692859, 117395007
/Volumes/methlab_data/HBN/EEG-ET/NDARVC956HHP/NDARVC956HHP_Video-DM_Samples_ET.mat, Despicable, 120, 5139839352, 5310387292, 170547940
/Volumes/methlab_data/HBN/EEG-ET/NDARVC956HHP/NDARVC956HHP_Video-FF_Samples_ET.mat, Fractals, 120, 4769551308, 4932539532, 162988224
/Volumes/methlab_data/HBN/EEG-ET/NDARVC956HHP/NDARVC956HHP_Video-TP_Samples_ET.mat, Present, 120, 5742575533, 5945643398, 203067865
/Volumes/methlab_data/HBN/EEG-ET/NDARVC956HHP/NDARVC956HHP_Video-WK_Samples_ET.mat, Diary, 120, 3654025690, 3771412969, 117387279
/Volumes/methlab_data/HBN/EEG-ET/NDARVC964LX0/NDARVC964LX0_Video1_Samples_ET.mat, Fractals, 120, 4336375985, 4499365067, 162989082
/Volumes/methlab_data/HBN/EEG-ET/NDARVD194JX2/NDARVD194JX2_Video1_Samples_ET.mat, Diary, 60, 7523990026, 7641384084, 117394058
/Volumes/methlab_data/HBN/EEG-ET/NDARVD194JX2/NDARVD194JX2_Video2_Samples_ET.mat, Fractals, 60, 6053712167, 6216691443, 162979276
/Volumes/methlab_data/HBN/EEG-ET/NDARVD194JX2/NDARVD194JX2_Video3_Samples_ET.mat, Despicable, 60, 7003327775, 7173869455, 170541680
/Volumes/methlab_data/HBN/EEG-ET/NDARVD194JX2/NDARVD194JX2_Video4_Samples_ET.mat, Present, 60, 7992520410, 8195576046, 203055636
/Volumes/methlab_data/HBN/EEG-ET/NDARVD495YP9/NDARVD495YP9_Video-TP_Samples_ET.mat, Present, 30, 3988482178, 4191758191, 203276013
/Volumes/methlab_data/HBN/EEG-ET/NDARVD495YP9/NDARVD495YP9_Video-WK_Samples_ET.mat, Diary, 30, 2012581578, 2129970750, 117389172
/Volumes/methlab_data/HBN/EEG-ET/NDARVD543CMZ/NDARVD543CMZ_Video-DM_Samples_ET.mat, Despicable, 120, 3716337041, 3886883738, 170546697
/Volumes/methlab_data/HBN/EEG-ET/NDARVD543CMZ/NDARVD543CMZ_Video-FF_Samples_ET.mat, Fractals, 120, 2307126480, 2470112027, 162985547
/Volumes/methlab_data/HBN/EEG-ET/NDARVD543CMZ/NDARVD543CMZ_Video-TP_Samples_ET.mat, Present, 120, 4406970506, 4610035877, 203065371
/Volumes/methlab_data/HBN/EEG-ET/NDARVD543CMZ/NDARVD543CMZ_Video-WK_Samples_ET.mat, Diary, 120, 3197029565, 3314427110, 117397545
/Volumes/methlab_data/HBN/EEG-ET/NDARVD547NLC/NDARVD547NLC_Video1_Samples_ET.mat, Diary, 60, 888946621, 1006333570, 117386949
/Volumes/methlab_data/HBN/EEG-ET/NDARVD547NLC/NDARVD547NLC_Video3_Samples_ET.mat, Despicable, 60, 675221736, 845764178, 170542442
/Volumes/methlab_data/HBN/EEG-ET/NDARVD552PRC/NDARVD552PRC_Video1_Samples_ET.mat, Fractals, 120, 3905886545, 4068876948, 162990403
/Volumes/methlab_data/HBN/EEG-ET/NDARVD552PRC/NDARVD552PRC_Video2_Samples_ET.mat, Despicable, 120, 4575572910, 4746120147, 170547237
/Volumes/methlab_data/HBN/EEG-ET/NDARVD552PRC/NDARVD552PRC_Video3_Samples_ET.mat, Diary, 120, 5083650322, 5201048364, 117398042
/Volumes/methlab_data/HBN/EEG-ET/NDARVD552PRC/NDARVD552PRC_Video4_Samples_ET.mat, Present, 120, 5669298331, 5872364479, 203066148
/Volumes/methlab_data/HBN/EEG-ET/NDARVD599VP2/NDARVD599VP2_Video-DM_Samples_ET.mat, Despicable, 60, 807922248, 978472029, 170549781
/Volumes/methlab_data/HBN/EEG-ET/NDARVD635FX8/NDARVD635FX8_Video1_Samples_ET.mat, Diary, 120, 3466888909, 3584285041, 117396132
/Volumes/methlab_data/HBN/EEG-ET/NDARVD635FX8/NDARVD635FX8_Video2_Samples_ET.mat, Despicable, 120, 3966553814, 4137094529, 170540715
/Volumes/methlab_data/HBN/EEG-ET/NDARVD635FX8/NDARVD635FX8_Video3_Samples_ET.mat, Fractals, 120, 4225573361, 4388559421, 162986060
/Volumes/methlab_data/HBN/EEG-ET/NDARVD635FX8/NDARVD635FX8_Video4_Samples_ET.mat, Present, 120, 4438440752, 4641502600, 203061848
/Volumes/methlab_data/HBN/EEG-ET/NDARVD685RRJ/NDARVD685RRJ_Video1_Samples_ET.mat, Diary, 60, 5169427116, 5286821287, 117394171
/Volumes/methlab_data/HBN/EEG-ET/NDARVD685RRJ/NDARVD685RRJ_Video3_Samples_ET.mat, Despicable, 60, 4713027995, 4883575766, 170547771
/Volumes/methlab_data/HBN/EEG-ET/NDARVE724GEF/NDARVE724GEF_Video1_Samples_ET.mat, Diary, 60, 3375905804, 3493299405, 117393601
/Volumes/methlab_data/HBN/EEG-ET/NDARVE724GEF/NDARVE724GEF_Video3_Samples_ET.mat, Despicable, 60, 2919738984, 3090292802, 170553818
/Volumes/methlab_data/HBN/EEG-ET/NDARVF039ZLX/NDARVF039ZLX_Video-DM_Samples_ET.mat, Despicable, 120, 6391592108, 6562138987, 170546879
/Volumes/methlab_data/HBN/EEG-ET/NDARVF039ZLX/NDARVF039ZLX_Video-FF_Samples_ET.mat, Fractals, 120, 5809144434, 5972131388, 162986954
/Volumes/methlab_data/HBN/EEG-ET/NDARVF039ZLX/NDARVF039ZLX_Video-TP_Samples_ET.mat, Present, 120, 7119111209, 7322179564, 203068355
/Volumes/methlab_data/HBN/EEG-ET/NDARVF039ZLX/NDARVF039ZLX_Video-WK_Samples_ET.mat, Diary, 120, 4767791753, 4885189191, 117397438
/Volumes/methlab_data/HBN/EEG-ET/NDARVF159VP9/NDARVF159VP9_Video1_Samples_ET.mat, Diary, 60, 5065941646, 5183331446, 117389800
/Volumes/methlab_data/HBN/EEG-ET/NDARVF159VP9/NDARVF159VP9_Video2_Samples_ET.mat, Fractals, 60, 3722076917, 3885063908, 162986991
/Volumes/methlab_data/HBN/EEG-ET/NDARVF159VP9/NDARVF159VP9_Video3_Samples_ET.mat, Despicable, 60, 4609009408, 4779560696, 170551288
/Volumes/methlab_data/HBN/EEG-ET/NDARVF159VP9/NDARVF159VP9_Video4_Samples_ET.mat, Present, 60, 5532955000, 5736016207, 203061207
/Volumes/methlab_data/HBN/EEG-ET/NDARVF544YP6/NDARVF544YP6_Video-DM_Samples_ET.mat, Despicable, 120, 2798610357, 2969152296, 170541939
/Volumes/methlab_data/HBN/EEG-ET/NDARVF544YP6/NDARVF544YP6_Video-FF_Samples_ET.mat, Fractals, 120, 2190943641, 2353929578, 162985937
/Volumes/methlab_data/HBN/EEG-ET/NDARVF544YP6/NDARVF544YP6_Video-TP_Samples_ET.mat, Present, 120, 4013701710, 4216766243, 203064533
/Volumes/methlab_data/HBN/EEG-ET/NDARVF544YP6/NDARVF544YP6_Video-WK_Samples_ET.mat, Diary, 120, 3366317172, 3483712712, 117395540
/Volumes/methlab_data/HBN/EEG-ET/NDARVF786FUU/NDARVF786FUU_Video-DM_Samples_ET.mat, Despicable, 120, 6868829659, 7039376995, 170547336
/Volumes/methlab_data/HBN/EEG-ET/NDARVF786FUU/NDARVF786FUU_Video-FF_Samples_ET.mat, Fractals, 120, 5942006182, 6104992783, 162986601
/Volumes/methlab_data/HBN/EEG-ET/NDARVF786FUU/NDARVF786FUU_Video-TP_Samples_ET.mat, Present, 120, 7824865413, 8027931178, 203065765
/Volumes/methlab_data/HBN/EEG-ET/NDARVF786FUU/NDARVF786FUU_Video-WK_Samples_ET.mat, Diary, 120, 7260828468, 7378224334, 117395866
/Volumes/methlab_data/HBN/EEG-ET/NDARVF852TZ4/NDARVF852TZ4_Video-DM_Samples_ET.mat, Despicable, 30, 11466282357, 11636821616, 170539259
/Volumes/methlab_data/HBN/EEG-ET/NDARVG127VW5/NDARVG127VW5_Video-DM_Samples_ET.mat, Despicable, 120, 22807884671, 22978428199, 170543528
/Volumes/methlab_data/HBN/EEG-ET/NDARVG127VW5/NDARVG127VW5_Video-FF_Samples_ET.mat, Fractals, 120, 22113121909, 22276108529, 162986620
/Volumes/methlab_data/HBN/EEG-ET/NDARVG127VW5/NDARVG127VW5_Video-TP_Samples_ET.mat, Present, 120, 23958550775, 24161617904, 203067129
/Volumes/methlab_data/HBN/EEG-ET/NDARVG127VW5/NDARVG127VW5_Video-WK_Samples_ET.mat, Diary, 120, 23253564775, 23370961920, 117397145
/Volumes/methlab_data/HBN/EEG-ET/NDARVG132NF6/NDARVG132NF6_Video1_Samples_ET.mat, Fractals, 120, 3707027383, 3870010671, 162983288
/Volumes/methlab_data/HBN/EEG-ET/NDARVG132NF6/NDARVG132NF6_Video2_Samples_ET.mat, Diary, 120, 4831302057, 4948699176, 117397119
/Volumes/methlab_data/HBN/EEG-ET/NDARVG132NF6/NDARVG132NF6_Video3_Samples_ET.mat, Despicable, 120, 5321919188, 5492466852, 170547664
/Volumes/methlab_data/HBN/EEG-ET/NDARVG132NF6/NDARVG132NF6_Video4_Samples_ET.mat, Present, 120, 5927746238, 6130813342, 203067104
/Volumes/methlab_data/HBN/EEG-ET/NDARVG148WHV/NDARVG148WHV_Video1_Samples_ET.mat, Diary, 60, 7864688061, 7982079912, 117391851
/Volumes/methlab_data/HBN/EEG-ET/NDARVG148WHV/NDARVG148WHV_Video3_Samples_ET.mat, Despicable, 60, 9277000568, 9447538894, 170538326
/Volumes/methlab_data/HBN/EEG-ET/NDARVG246LT7/NDARVG246LT7_Video-DM_Samples_ET.mat, Despicable, 60, 3056541523, 3227085219, 170543696
/Volumes/methlab_data/HBN/EEG-ET/NDARVG246LT7/NDARVG246LT7_Video-FF_Samples_ET.mat, Fractals, 60, 2033195413, 2196187748, 162992335
/Volumes/methlab_data/HBN/EEG-ET/NDARVG246LT7/NDARVG246LT7_Video-TP_Samples_ET.mat, Present, 60, 4163156597, 4366219327, 203062730
/Volumes/methlab_data/HBN/EEG-ET/NDARVG246LT7/NDARVG246LT7_Video-WK_Samples_ET.mat, Diary, 60, 3711962308, 3829355412, 117393104
/Volumes/methlab_data/HBN/EEG-ET/NDARVG436WGG/NDARVG436WGG_Video1_Samples_ET.mat, Diary, 60, 1911475194, 2028871978, 117396784
/Volumes/methlab_data/HBN/EEG-ET/NDARVG436WGG/NDARVG436WGG_Video3_Samples_ET.mat, Despicable, 60, 3396748231, 3567290517, 170542286
/Volumes/methlab_data/HBN/EEG-ET/NDARVG461LA2/NDARVG461LA2_Video1_Samples_ET.mat, Diary, 60, 3393580050, 3510973013, 117392963
/Volumes/methlab_data/HBN/EEG-ET/NDARVG461LA2/NDARVG461LA2_Video3_Samples_ET.mat, Despicable, 60, 4737312587, 4907854113, 170541526
/Volumes/methlab_data/HBN/EEG-ET/NDARVG597HNL/NDARVG597HNL_Video1_Samples_ET.mat, Fractals, 120, 3572402489, 3735387721, 162985232
/Volumes/methlab_data/HBN/EEG-ET/NDARVG597HNL/NDARVG597HNL_Video3_Samples_ET.mat, Despicable, 120, 5637982546, 5808528866, 170546320
/Volumes/methlab_data/HBN/EEG-ET/NDARVG597HNL/NDARVG597HNL_Video4_Samples_ET.mat, Present, 120, 6380668225, 6583734817, 203066592
/Volumes/methlab_data/HBN/EEG-ET/NDARVG641YGK/NDARVG641YGK_Video-DM_Samples_ET.mat, Despicable, 60, 3850813784, 4021362620, 170548836
/Volumes/methlab_data/HBN/EEG-ET/NDARVG641YGK/NDARVG641YGK_Video-FF_Samples_ET.mat, Fractals, 60, 3027228409, 3190218884, 162990475
/Volumes/methlab_data/HBN/EEG-ET/NDARVG641YGK/NDARVG641YGK_Video-TP_Samples_ET.mat, Present, 60, 4740392926, 4943459776, 203066850
/Volumes/methlab_data/HBN/EEG-ET/NDARVG641YGK/NDARVG641YGK_Video-WK_Samples_ET.mat, Diary, 60, 4324316185, 4441707377, 117391192
/Volumes/methlab_data/HBN/EEG-ET/NDARVG777EUZ/NDARVG777EUZ_Video-DM_Samples_ET.mat, Despicable, 30, 4617925618, 4788464146, 170538528
/Volumes/methlab_data/HBN/EEG-ET/NDARVG777EUZ/NDARVG777EUZ_Video-TP_Samples_ET.mat, Present, 30, 5108412227, 5311678878, 203266651
/Volumes/methlab_data/HBN/EEG-ET/NDARVG777EUZ/NDARVG777EUZ_Video-WK_Samples_ET.mat, Diary, 30, 3521265657, 3638656636, 117390979
/Volumes/methlab_data/HBN/EEG-ET/NDARVG808PKQ/NDARVG808PKQ_Video-DM_Samples_ET.mat, Despicable, 60, 3485055104, 3655601588, 170546484
/Volumes/methlab_data/HBN/EEG-ET/NDARVG808PKQ/NDARVG808PKQ_Video-FF_Samples_ET.mat, Fractals, 60, 3704796318, 3867784426, 162988108
/Volumes/methlab_data/HBN/EEG-ET/NDARVG808PKQ/NDARVG808PKQ_Video-TP_Samples_ET.mat, Present, 60, 4120467889, 4323527328, 203059439
/Volumes/methlab_data/HBN/EEG-ET/NDARVG808PKQ/NDARVG808PKQ_Video-WK_Samples_ET.mat, Diary, 60, 3913116458, 4030506397, 117389939
/Volumes/methlab_data/HBN/EEG-ET/NDARVG958MHH/NDARVG958MHH_Video-DM_Samples_ET.mat, Despicable, 60, 6613498345, 6784048056, 170549711
/Volumes/methlab_data/HBN/EEG-ET/NDARVG958MHH/NDARVG958MHH_Video-FF_Samples_ET.mat, Fractals, 60, 6140870930, 6303864271, 162993341
/Volumes/methlab_data/HBN/EEG-ET/NDARVG958MHH/NDARVG958MHH_Video-TP_Samples_ET.mat, Present, 60, 7146446479, 7349507212, 203060733
/Volumes/methlab_data/HBN/EEG-ET/NDARVG958MHH/NDARVG958MHH_Video-WK_Samples_ET.mat, Diary, 60, 5551932168, 5669327252, 117395084
/Volumes/methlab_data/HBN/EEG-ET/NDARVG971CHH/NDARVG971CHH_Video1_Samples_ET.mat, Diary, 60, 3129197120, 3246586062, 117388942
/Volumes/methlab_data/HBN/EEG-ET/NDARVG971CHH/NDARVG971CHH_Video3_Samples_ET.mat, Despicable, 60, 2683773516, 2854328005, 170554489
/Volumes/methlab_data/HBN/EEG-ET/NDARVH033CA4/NDARVH033CA4_Video1_Samples_ET.mat, Diary, 60, 2945557746, 3062952547, 117394801
/Volumes/methlab_data/HBN/EEG-ET/NDARVH033CA4/NDARVH033CA4_Video3_Samples_ET.mat, Despicable, 60, 2513862312, 2684406602, 170544290
/Volumes/methlab_data/HBN/EEG-ET/NDARVH033CA4/NDARVH033CA4_Video4_Samples_ET.mat, Present, 60, 3384293177, 3587362494, 203069317
/Volumes/methlab_data/HBN/EEG-ET/NDARVH070WH6/NDARVH070WH6_Video1_Samples_ET.mat, Diary, 60, 3003068745, 3120462782, 117394037
/Volumes/methlab_data/HBN/EEG-ET/NDARVH070WH6/NDARVH070WH6_Video3_Samples_ET.mat, Despicable, 60, 4017646344, 4188187936, 170541592
/Volumes/methlab_data/HBN/EEG-ET/NDARVH153RE7/NDARVH153RE7_Video1_Samples_ET.mat, Diary, 60, 7605571536, 7722968381, 117396845
/Volumes/methlab_data/HBN/EEG-ET/NDARVH153RE7/NDARVH153RE7_Video2_Samples_ET.mat, Fractals, 60, 6749245321, 6912223356, 162978035
/Volumes/methlab_data/HBN/EEG-ET/NDARVH153RE7/NDARVH153RE7_Video3_Samples_ET.mat, Despicable, 60, 7983311039, 8153850391, 170539352
/Volumes/methlab_data/HBN/EEG-ET/NDARVH153RE7/NDARVH153RE7_Video4_Samples_ET.mat, Present, 60, 8472290062, 8675360349, 203070287
/Volumes/methlab_data/HBN/EEG-ET/NDARVJ072EHU/NDARVJ072EHU_Video-DM_Samples_ET.mat, Despicable, 120, 4897398814, 5067940390, 170541576
/Volumes/methlab_data/HBN/EEG-ET/NDARVJ072EHU/NDARVJ072EHU_Video-FF_Samples_ET.mat, Fractals, 120, 4131518022, 4294503278, 162985256
/Volumes/methlab_data/HBN/EEG-ET/NDARVJ072EHU/NDARVJ072EHU_Video-TP_Samples_ET.mat, Present, 120, 5960325427, 6163393014, 203067587
/Volumes/methlab_data/HBN/EEG-ET/NDARVJ072EHU/NDARVJ072EHU_Video-WK_Samples_ET.mat, Diary, 120, 5397738914, 5515127388, 117388474
/Volumes/methlab_data/HBN/EEG-ET/NDARVJ405CCN/NDARVJ405CCN_Video-DM_Samples_ET.mat, Despicable, 120, 4177638279, 4348185476, 170547197
/Volumes/methlab_data/HBN/EEG-ET/NDARVJ405CCN/NDARVJ405CCN_Video-FF_Samples_ET.mat, Fractals, 120, 4661574676, 4824561685, 162987009
/Volumes/methlab_data/HBN/EEG-ET/NDARVJ405CCN/NDARVJ405CCN_Video-TP_Samples_ET.mat, Present, 120, 5427446306, 5630510890, 203064584
/Volumes/methlab_data/HBN/EEG-ET/NDARVJ405CCN/NDARVJ405CCN_Video-WK_Samples_ET.mat, Diary, 120, 3586969974, 3704355766, 117385792
/Volumes/methlab_data/HBN/EEG-ET/NDARVJ468UZC/NDARVJ468UZC_Video-DM_Samples_ET.mat, Despicable, 120, 4716328384, 4886885716, 170557332
/Volumes/methlab_data/HBN/EEG-ET/NDARVJ468UZC/NDARVJ468UZC_Video-FF_Samples_ET.mat, Fractals, 120, 3971872992, 4134869146, 162996154
/Volumes/methlab_data/HBN/EEG-ET/NDARVJ468UZC/NDARVJ468UZC_Video-TP_Samples_ET.mat, Present, 120, 5846450192, 6049512747, 203062555
/Volumes/methlab_data/HBN/EEG-ET/NDARVJ468UZC/NDARVJ468UZC_Video-WK_Samples_ET.mat, Diary, 120, 5273815155, 5391212654, 117397499
/Volumes/methlab_data/HBN/EEG-ET/NDARVJ685ZW5/NDARVJ685ZW5_Video1_Samples_ET.mat, Despicable, 120, 5057830893, 5228373855, 170542962
/Volumes/methlab_data/HBN/EEG-ET/NDARVJ685ZW5/NDARVJ685ZW5_Video2_Samples_ET.mat, Diary, 120, 5726744915, 5844142610, 117397695
/Volumes/methlab_data/HBN/EEG-ET/NDARVJ685ZW5/NDARVJ685ZW5_Video3_Samples_ET.mat, Fractals, 120, 5861544542, 6024531754, 162987212
/Volumes/methlab_data/HBN/EEG-ET/NDARVJ685ZW5/NDARVJ685ZW5_Video4_Samples_ET.mat, Present, 120, 6050903455, 6253969526, 203066071
/Volumes/methlab_data/HBN/EEG-ET/NDARVJ687ENB/NDARVJ687ENB_Video-DM_Samples_ET.mat, Despicable, 60, 3640576247, 3811113759, 170537512
/Volumes/methlab_data/HBN/EEG-ET/NDARVJ687ENB/NDARVJ687ENB_Video-TP_Samples_ET.mat, Present, 60, 720084497, 923361193, 203276696
/Volumes/methlab_data/HBN/EEG-ET/NDARVJ687ENB/NDARVJ687ENB_Video-WK_Samples_ET.mat, Diary, 60, 181799108, 299186093, 117386985
/Volumes/methlab_data/HBN/EEG-ET/NDARVK196LEK/NDARVK196LEK_Video-DM_Samples_ET.mat, Despicable, 60, 2758845268, 2929386915, 170541647
/Volumes/methlab_data/HBN/EEG-ET/NDARVK196LEK/NDARVK196LEK_Video-FF_Samples_ET.mat, Fractals, 60, 2124368519, 2287359828, 162991309
/Volumes/methlab_data/HBN/EEG-ET/NDARVK196LEK/NDARVK196LEK_Video-WK_Samples_ET.mat, Diary, 60, 3001197680, 3118588733, 117391053
/Volumes/methlab_data/HBN/EEG-ET/NDARVK407TGE/NDARVK407TGE_Video-DM_Samples_ET.mat, Despicable, 60, 2591173527, 2761711986, 170538459
/Volumes/methlab_data/HBN/EEG-ET/NDARVK407TGE/NDARVK407TGE_Video-FF_Samples_ET.mat, Fractals, 60, 1744275360, 1907266478, 162991118
/Volumes/methlab_data/HBN/EEG-ET/NDARVK407TGE/NDARVK407TGE_Video-WK_Samples_ET.mat, Diary, 60, 2177488313, 2294880259, 117391946
/Volumes/methlab_data/HBN/EEG-ET/NDARVK720WZ0/NDARVK720WZ0_Video1_Samples_ET.mat, Diary, 60, 3554203602, 3671596777, 117393175
/Volumes/methlab_data/HBN/EEG-ET/NDARVK720WZ0/NDARVK720WZ0_Video3_Samples_ET.mat, Despicable, 60, 3971641308, 4142191114, 170549806
/Volumes/methlab_data/HBN/EEG-ET/NDARVK720WZ0/NDARVK720WZ0_Video4_Samples_ET.mat, Present, 60, 4883370108, 5086437974, 203067866
/Volumes/methlab_data/HBN/EEG-ET/NDARVK847ZRT/NDARVK847ZRT_Video1_Samples_ET.mat, Diary, 60, 3243978731, 3361373959, 117395228
/Volumes/methlab_data/HBN/EEG-ET/NDARVK847ZRT/NDARVK847ZRT_Video2_Samples_ET.mat, Fractals, 60, 2498175187, 2661166726, 162991539
/Volumes/methlab_data/HBN/EEG-ET/NDARVK847ZRT/NDARVK847ZRT_Video3_Samples_ET.mat, Despicable, 60, 3656918442, 3827459277, 170540835
/Volumes/methlab_data/HBN/EEG-ET/NDARVK847ZRT/NDARVK847ZRT_Video4_Samples_ET.mat, Present, 60, 4143989589, 4347060509, 203070920
/Volumes/methlab_data/HBN/EEG-ET/NDARVK922KE5/NDARVK922KE5_Video-DM_Samples_ET.mat, Despicable, 60, 3119556123, 3290094943, 170538820
/Volumes/methlab_data/HBN/EEG-ET/NDARVK922KE5/NDARVK922KE5_Video-FF_Samples_ET.mat, Fractals, 60, 2663108804, 2826098274, 162989470
/Volumes/methlab_data/HBN/EEG-ET/NDARVK922KE5/NDARVK922KE5_Video-TP_Samples_ET.mat, Present, 60, 3612378194, 3815446062, 203067868
/Volumes/methlab_data/HBN/EEG-ET/NDARVK922KE5/NDARVK922KE5_Video-WK_Samples_ET.mat, Diary, 60, 1948863863, 2066256049, 117392186
/Volumes/methlab_data/HBN/EEG-ET/NDARVL190JA8/NDARVL190JA8_Video1_Samples_ET.mat, Diary, 120, 7138762391, 7256159178, 117396787
/Volumes/methlab_data/HBN/EEG-ET/NDARVL190JA8/NDARVL190JA8_Video2_Samples_ET.mat, Fractals, 120, 8020573683, 8183560289, 162986606
/Volumes/methlab_data/HBN/EEG-ET/NDARVL190JA8/NDARVL190JA8_Video3_Samples_ET.mat, Despicable, 120, 8478575150, 8649121086, 170545936
/Volumes/methlab_data/HBN/EEG-ET/NDARVL190JA8/NDARVL190JA8_Video4_Samples_ET.mat, Present, 120, 9028007501, 9231071358, 203063857
/Volumes/methlab_data/HBN/EEG-ET/NDARVL498YX5/NDARVL498YX5_Video1_Samples_ET.mat, Diary, 120, 3778827048, 3896214979, 117387931
/Volumes/methlab_data/HBN/EEG-ET/NDARVL498YX5/NDARVL498YX5_Video2_Samples_ET.mat, Fractals, 120, 4599993726, 4762990960, 162997234
/Volumes/methlab_data/HBN/EEG-ET/NDARVL498YX5/NDARVL498YX5_Video3_Samples_ET.mat, Despicable, 120, 5292161165, 5462718059, 170556894
/Volumes/methlab_data/HBN/EEG-ET/NDARVL498YX5/NDARVL498YX5_Video4_Samples_ET.mat, Present, 120, 6037206094, 6240273616, 203067522
/Volumes/methlab_data/HBN/EEG-ET/NDARVL555VVA/NDARVL555VVA_Video1_Samples_ET.mat, Diary, 60, 3689589645, 3806980611, 117390966
/Volumes/methlab_data/HBN/EEG-ET/NDARVL555VVA/NDARVL555VVA_Video3_Samples_ET.mat, Despicable, 60, 3268368985, 3438912524, 170543539
/Volumes/methlab_data/HBN/EEG-ET/NDARVL697YGK/NDARVL697YGK_Video-DM_Samples_ET.mat, Despicable, 60, 19410297473, 19580839037, 170541564
/Volumes/methlab_data/HBN/EEG-ET/NDARVL697YGK/NDARVL697YGK_Video-FF_Samples_ET.mat, Fractals, 60, 19916129920, 20079112149, 162982229
/Volumes/methlab_data/HBN/EEG-ET/NDARVL697YGK/NDARVL697YGK_Video-TP_Samples_ET.mat, Present, 60, 20390247963, 20593304458, 203056495
/Volumes/methlab_data/HBN/EEG-ET/NDARVL697YGK/NDARVL697YGK_Video-WK_Samples_ET.mat, Diary, 60, 18852888558, 18970278619, 117390061
/Volumes/methlab_data/HBN/EEG-ET/NDARVL729TT5/NDARVL729TT5_Video1_Samples_ET.mat, Diary, 60, 4507803975, 4625194255, 117390280
/Volumes/methlab_data/HBN/EEG-ET/NDARVL729TT5/NDARVL729TT5_Video3_Samples_ET.mat, Despicable, 60, 4077961065, 4248511078, 170550013
/Volumes/methlab_data/HBN/EEG-ET/NDARVL729TT5/NDARVL729TT5_Video4_Samples_ET.mat, Present, 60, 4920017354, 5123087426, 203070072
/Volumes/methlab_data/HBN/EEG-ET/NDARVL964HH1/NDARVL964HH1_Video1_Samples_ET.mat, Fractals, 120, 6446298962, 6609284600, 162985638
/Volumes/methlab_data/HBN/EEG-ET/NDARVL964HH1/NDARVL964HH1_Video2_Samples_ET.mat, Despicable, 120, 7103603397, 7274151173, 170547776
/Volumes/methlab_data/HBN/EEG-ET/NDARVL964HH1/NDARVL964HH1_Video3_Samples_ET.mat, Diary, 120, 7594040608, 7711438981, 117398373
/Volumes/methlab_data/HBN/EEG-ET/NDARVL964HH1/NDARVL964HH1_Video4_Samples_ET.mat, Present, 120, 8209357174, 8412425064, 203067890
/Volumes/methlab_data/HBN/EEG-ET/NDARVM025NCF/NDARVM025NCF_Video1_Samples_ET.mat, Diary, 60, 4363032566, 4480425434, 117392868
/Volumes/methlab_data/HBN/EEG-ET/NDARVM025NCF/NDARVM025NCF_Video3_Samples_ET.mat, Despicable, 60, 4727218544, 4897760900, 170542356
/Volumes/methlab_data/HBN/EEG-ET/NDARVM287DJK/NDARVM287DJK_Video-DM_Samples_ET.mat, Despicable, 60, 6154111490, 6324647045, 170535555
/Volumes/methlab_data/HBN/EEG-ET/NDARVM287DJK/NDARVM287DJK_Video-TP_Samples_ET.mat, Present, 60, 6638213567, 6841494225, 203280658
/Volumes/methlab_data/HBN/EEG-ET/NDARVM287DJK/NDARVM287DJK_Video-WK_Samples_ET.mat, Diary, 60, 4755457153, 4872852107, 117394954
/Volumes/methlab_data/HBN/EEG-ET/NDARVM685MER/NDARVM685MER_Video1_Samples_ET.mat, Diary, 60, 2180102449, 2297496474, 117394025
/Volumes/methlab_data/HBN/EEG-ET/NDARVM685MER/NDARVM685MER_Video3_Samples_ET.mat, Despicable, 60, 2985643979, 3156185588, 170541609
/Volumes/methlab_data/HBN/EEG-ET/NDARVM741LKK/NDARVM741LKK_Video-DM_Samples_ET.mat, Despicable, 30, 5833499176, 6004037787, 170538611
/Volumes/methlab_data/HBN/EEG-ET/NDARVM741LKK/NDARVM741LKK_Video-TP_Samples_ET.mat, Present, 30, 6355702487, 6558972274, 203269787
/Volumes/methlab_data/HBN/EEG-ET/NDARVM741LKK/NDARVM741LKK_Video-WK_Samples_ET.mat, Diary, 30, 5413552134, 5530942168, 117390034
/Volumes/methlab_data/HBN/EEG-ET/NDARVM774PA5/NDARVM774PA5_Video-DM_Samples_ET.mat, Despicable, 60, 3305078145, 3475614680, 170536535
/Volumes/methlab_data/HBN/EEG-ET/NDARVM774PA5/NDARVM774PA5_Video-TP_Samples_ET.mat, Present, 60, 4156731035, 4359995636, 203264601
/Volumes/methlab_data/HBN/EEG-ET/NDARVM774PA5/NDARVM774PA5_Video-WK_Samples_ET.mat, Diary, 60, 3929251206, 4046639187, 117387981
/Volumes/methlab_data/HBN/EEG-ET/NDARVN020FRK/NDARVN020FRK_Video-DM_Samples_ET.mat, Despicable, 60, 4985061740, 5155601377, 170539637
/Volumes/methlab_data/HBN/EEG-ET/NDARVN020FRK/NDARVN020FRK_Video-TP_Samples_ET.mat, Present, 60, 5526237488, 5729506299, 203268811
/Volumes/methlab_data/HBN/EEG-ET/NDARVN020FRK/NDARVN020FRK_Video-WK_Samples_ET.mat, Diary, 60, 3732995170, 3850384225, 117389055
/Volumes/methlab_data/HBN/EEG-ET/NDARVN270UU2/NDARVN270UU2_Video1_Samples_ET.mat, Diary, 60, 2566783748, 2684177875, 117394127
/Volumes/methlab_data/HBN/EEG-ET/NDARVN270UU2/NDARVN270UU2_Video2_Samples_ET.mat, Fractals, 60, 2730876938, 2893870327, 162993389
/Volumes/methlab_data/HBN/EEG-ET/NDARVN270UU2/NDARVN270UU2_Video3_Samples_ET.mat, Despicable, 60, 2339842103, 2510380828, 170538725
/Volumes/methlab_data/HBN/EEG-ET/NDARVN270UU2/NDARVN270UU2_Video4_Samples_ET.mat, Present, 60, 2941529048, 3144601845, 203072797
/Volumes/methlab_data/HBN/EEG-ET/NDARVN363NNQ/NDARVN363NNQ_Video1_Samples_ET.mat, Fractals, 120, 25389235696, 25552222435, 162986739
/Volumes/methlab_data/HBN/EEG-ET/NDARVN363NNQ/NDARVN363NNQ_Video2_Samples_ET.mat, Despicable, 120, 26191759907, 26362302121, 170542214
/Volumes/methlab_data/HBN/EEG-ET/NDARVN363NNQ/NDARVN363NNQ_Video3_Samples_ET.mat, Diary, 120, 26700298679, 26817695728, 117397049
/Volumes/methlab_data/HBN/EEG-ET/NDARVN363NNQ/NDARVN363NNQ_Video4_Samples_ET.mat, Present, 120, 27332324447, 27535392223, 203067776
/Volumes/methlab_data/HBN/EEG-ET/NDARVN469KP6/NDARVN469KP6_Video1_Samples_ET.mat, Diary, 60, 2148576583, 2265976633, 117400050
/Volumes/methlab_data/HBN/EEG-ET/NDARVN629CRD/NDARVN629CRD_Video-DM_Samples_ET.mat, Despicable, 120, 4761449665, 4931997627, 170547962
/Volumes/methlab_data/HBN/EEG-ET/NDARVN629CRD/NDARVN629CRD_Video-FF_Samples_ET.mat, Fractals, 120, 3843646281, 4006642508, 162996227
/Volumes/methlab_data/HBN/EEG-ET/NDARVN629CRD/NDARVN629CRD_Video-TP_Samples_ET.mat, Present, 120, 5838005338, 6041070060, 203064722
/Volumes/methlab_data/HBN/EEG-ET/NDARVN629CRD/NDARVN629CRD_Video-WK_Samples_ET.mat, Diary, 120, 5252599491, 5369989608, 117390117
/Volumes/methlab_data/HBN/EEG-ET/NDARVN646NZP/NDARVN646NZP_Video1_Samples_ET.mat, Diary, 60, 2508964591, 2626361785, 117397194
/Volumes/methlab_data/HBN/EEG-ET/NDARVN646NZP/NDARVN646NZP_Video3_Samples_ET.mat, Despicable, 60, 2885807525, 3056351385, 170543860
/Volumes/methlab_data/HBN/EEG-ET/NDARVN648NN2/NDARVN648NN2_Video1_Samples_ET.mat, Fractals, 120, 5632328357, 5795313711, 162985354
/Volumes/methlab_data/HBN/EEG-ET/NDARVN648NN2/NDARVN648NN2_Video2_Samples_ET.mat, Diary, 120, 6613051051, 6730448410, 117397359
/Volumes/methlab_data/HBN/EEG-ET/NDARVN648NN2/NDARVN648NN2_Video3_Samples_ET.mat, Despicable, 120, 7117378580, 7287925680, 170547100
/Volumes/methlab_data/HBN/EEG-ET/NDARVN648NN2/NDARVN648NN2_Video4_Samples_ET.mat, Present, 120, 7881374537, 8084441876, 203067339
/Volumes/methlab_data/HBN/EEG-ET/NDARVN666JV7/NDARVN666JV7_Video1_Samples_ET.mat, Diary, 120, 3333097027, 3450485129, 117388102
/Volumes/methlab_data/HBN/EEG-ET/NDARVN666JV7/NDARVN666JV7_Video2_Samples_ET.mat, Fractals, 120, 4697858475, 4860845187, 162986712
/Volumes/methlab_data/HBN/EEG-ET/NDARVN666JV7/NDARVN666JV7_Video3_Samples_ET.mat, Despicable, 120, 5386263981, 5556810954, 170546973
/Volumes/methlab_data/HBN/EEG-ET/NDARVN666JV7/NDARVN666JV7_Video4_Samples_ET.mat, Present, 120, 6294736058, 6497796904, 203060846
/Volumes/methlab_data/HBN/EEG-ET/NDARVN715MJ9/NDARVN715MJ9_Video1_Samples_ET.mat, Diary, 60, 3462876469, 3580273598, 117397129
/Volumes/methlab_data/HBN/EEG-ET/NDARVN715MJ9/NDARVN715MJ9_Video2_Samples_ET.mat, Fractals, 60, 2128559307, 2291544646, 162985339
/Volumes/methlab_data/HBN/EEG-ET/NDARVN715MJ9/NDARVN715MJ9_Video3_Samples_ET.mat, Despicable, 60, 2973041869, 3143586575, 170544706
/Volumes/methlab_data/HBN/EEG-ET/NDARVN715MJ9/NDARVN715MJ9_Video4_Samples_ET.mat, Present, 60, 4253512959, 4456584697, 203071738
/Volumes/methlab_data/HBN/EEG-ET/NDARVN883AU2/NDARVN883AU2_Video1_Samples_ET.mat, Despicable, 120, 3623560021, 3794106952, 170546931
/Volumes/methlab_data/HBN/EEG-ET/NDARVN883AU2/NDARVN883AU2_Video2_Samples_ET.mat, Diary, 120, 4543274312, 4660672377, 117398065
/Volumes/methlab_data/HBN/EEG-ET/NDARVN883AU2/NDARVN883AU2_Video3_Samples_ET.mat, Fractals, 120, 4690424655, 4853410999, 162986344
/Volumes/methlab_data/HBN/EEG-ET/NDARVN883AU2/NDARVN883AU2_Video4_Samples_ET.mat, Present, 120, 5276510533, 5479577496, 203066963
/Volumes/methlab_data/HBN/EEG-ET/NDARVN892TCF/NDARVN892TCF_Video-DM_Samples_ET.mat, Despicable, 120, 3842237153, 4012783854, 170546701
/Volumes/methlab_data/HBN/EEG-ET/NDARVN892TCF/NDARVN892TCF_Video-FF_Samples_ET.mat, Fractals, 120, 4409082164, 4572066706, 162984542
/Volumes/methlab_data/HBN/EEG-ET/NDARVN892TCF/NDARVN892TCF_Video-TP_Samples_ET.mat, Present, 120, 5006082500, 5209150805, 203068305
/Volumes/methlab_data/HBN/EEG-ET/NDARVN892TCF/NDARVN892TCF_Video-WK_Samples_ET.mat, Diary, 120, 3077862216, 3195259271, 117397055
/Volumes/methlab_data/HBN/EEG-ET/NDARVN899GWP/NDARVN899GWP_Video1_Samples_ET.mat, Diary, 60, 3405990393, 3523385440, 117395047
/Volumes/methlab_data/HBN/EEG-ET/NDARVN899GWP/NDARVN899GWP_Video2_Samples_ET.mat, Fractals, 60, 4138937600, 4301926848, 162989248
/Volumes/methlab_data/HBN/EEG-ET/NDARVN899GWP/NDARVN899GWP_Video3_Samples_ET.mat, Despicable, 60, 4605797695, 4776341267, 170543572
/Volumes/methlab_data/HBN/EEG-ET/NDARVN920VHJ/NDARVN920VHJ_Video1_Samples_ET.mat, Diary, 60, 3092390563, 3209844760, 117454197
/Volumes/methlab_data/HBN/EEG-ET/NDARVN920VHJ/NDARVN920VHJ_Video2_Samples_ET.mat, Fractals, 60, 4329526435, 4492521867, 162995432
/Volumes/methlab_data/HBN/EEG-ET/NDARVN920VHJ/NDARVN920VHJ_Video3_Samples_ET.mat, Despicable, 60, 3796643178, 3967188930, 170545752
/Volumes/methlab_data/HBN/EEG-ET/NDARVN920VHJ/NDARVN920VHJ_Video4_Samples_ET.mat, Present, 60, 4817552960, 5020622733, 203069773
/Volumes/methlab_data/HBN/EEG-ET/NDARVP135ZGE/NDARVP135ZGE_Video1_Samples_ET.mat, Diary, 60, 6959182299, 7076568293, 117385994
/Volumes/methlab_data/HBN/EEG-ET/NDARVP135ZGE/NDARVP135ZGE_Video3_Samples_ET.mat, Despicable, 60, 6195233178, 6365775760, 170542582
/Volumes/methlab_data/HBN/EEG-ET/NDARVP281CJ4/NDARVP281CJ4_Video1_Samples_ET.mat, Diary, 60, 2474904548, 2592301266, 117396718
/Volumes/methlab_data/HBN/EEG-ET/NDARVP281CJ4/NDARVP281CJ4_Video3_Samples_ET.mat, Despicable, 60, 3510448179, 3680991354, 170543175
/Volumes/methlab_data/HBN/EEG-ET/NDARVP285RXV/NDARVP285RXV_Video1_Samples_ET.mat, Diary, 60, 4983564180, 5100960254, 117396074
/Volumes/methlab_data/HBN/EEG-ET/NDARVP285RXV/NDARVP285RXV_Video2_Samples_ET.mat, Fractals, 60, 3774107340, 3937183729, 163076389
/Volumes/methlab_data/HBN/EEG-ET/NDARVP285RXV/NDARVP285RXV_Video3_Samples_ET.mat, Despicable, 60, 4508409947, 4678956661, 170546714
/Volumes/methlab_data/HBN/EEG-ET/NDARVP285RXV/NDARVP285RXV_Video4_Samples_ET.mat, Present, 60, 5407505156, 5610572870, 203067714
/Volumes/methlab_data/HBN/EEG-ET/NDARVP689NR0/NDARVP689NR0_Video-DM_Samples_ET.mat, Despicable, 60, 425783693, 596333410, 170549717
/Volumes/methlab_data/HBN/EEG-ET/NDARVP689NR0/NDARVP689NR0_Video-FF_Samples_ET.mat, Fractals, 60, 860597374, 1023586731, 162989357
/Volumes/methlab_data/HBN/EEG-ET/NDARVP689NR0/NDARVP689NR0_Video-WK_Samples_ET.mat, Diary, 60, 698126432, 815514539, 117388107
/Volumes/methlab_data/HBN/EEG-ET/NDARVP838PLC/NDARVP838PLC_Video-DM_Samples_ET.mat, Despicable, 60, 4651365669, 4821910209, 170544540
/Volumes/methlab_data/HBN/EEG-ET/NDARVP838PLC/NDARVP838PLC_Video-FF_Samples_ET.mat, Fractals, 60, 5121899166, 5284881356, 162982190
/Volumes/methlab_data/HBN/EEG-ET/NDARVP838PLC/NDARVP838PLC_Video-TP_Samples_ET.mat, Present, 60, 5735735956, 5938796500, 203060544
/Volumes/methlab_data/HBN/EEG-ET/NDARVP838PLC/NDARVP838PLC_Video-WK_Samples_ET.mat, Diary, 60, 3537756758, 3655151718, 117394960
/Volumes/methlab_data/HBN/EEG-ET/NDARVP894EX0/NDARVP894EX0_Video-DM_Samples_ET.mat, Despicable, 60, 75005879, 245547127, 170541248
/Volumes/methlab_data/HBN/EEG-ET/NDARVP894EX0/NDARVP894EX0_Video-FF_Samples_ET.mat, Fractals, 60, 3532763677, 3695743505, 162979828
/Volumes/methlab_data/HBN/EEG-ET/NDARVP894EX0/NDARVP894EX0_Video-TP_Samples_ET.mat, Present, 60, 560929452, 763990596, 203061144
/Volumes/methlab_data/HBN/EEG-ET/NDARVP894EX0/NDARVP894EX0_Video-WK_Samples_ET.mat, Diary, 60, 2960083886, 3077476675, 117392789
/Volumes/methlab_data/HBN/EEG-ET/NDARVP953BBF/NDARVP953BBF_Video1_Samples_ET.mat, Diary, 120, 2746722332, 2864118517, 117396185
/Volumes/methlab_data/HBN/EEG-ET/NDARVP953BBF/NDARVP953BBF_Video2_Samples_ET.mat, Fractals, 120, 3901392885, 4064381463, 162988578
/Volumes/methlab_data/HBN/EEG-ET/NDARVP953BBF/NDARVP953BBF_Video3_Samples_ET.mat, Despicable, 120, 4484521360, 4655068398, 170547038
/Volumes/methlab_data/HBN/EEG-ET/NDARVP953BBF/NDARVP953BBF_Video4_Samples_ET.mat, Present, 120, 5152526846, 5355594188, 203067342
/Volumes/methlab_data/HBN/EEG-ET/NDARVR116KG5/NDARVR116KG5_Video-DM_Samples_ET.mat, Despicable, 60, 3600642394, 3771192821, 170550427
/Volumes/methlab_data/HBN/EEG-ET/NDARVR116KG5/NDARVR116KG5_Video-FF_Samples_ET.mat, Fractals, 60, 3116710773, 3279700862, 162990089
/Volumes/methlab_data/HBN/EEG-ET/NDARVR116KG5/NDARVR116KG5_Video-TP_Samples_ET.mat, Present, 60, 4149666979, 4352727327, 203060348
/Volumes/methlab_data/HBN/EEG-ET/NDARVR116KG5/NDARVR116KG5_Video-WK_Samples_ET.mat, Diary, 60, 2496838203, 2614225070, 117386867
/Volumes/methlab_data/HBN/EEG-ET/NDARVR601FUT/NDARVR601FUT_Video-DM_Samples_ET.mat, Despicable, 60, 3557877271, 3728420363, 170543092
/Volumes/methlab_data/HBN/EEG-ET/NDARVR601FUT/NDARVR601FUT_Video-FF_Samples_ET.mat, Fractals, 60, 3045993820, 3208975552, 162981732
/Volumes/methlab_data/HBN/EEG-ET/NDARVR601FUT/NDARVR601FUT_Video-TP_Samples_ET.mat, Present, 60, 4156599367, 4359670559, 203071192
/Volumes/methlab_data/HBN/EEG-ET/NDARVR601FUT/NDARVR601FUT_Video-WK_Samples_ET.mat, Diary, 60, 1818553296, 1935944653, 117391357
/Volumes/methlab_data/HBN/EEG-ET/NDARVT231LJG/NDARVT231LJG_Video1_Samples_ET.mat, Diary, 60, 3156449136, 3273845193, 117396057
/Volumes/methlab_data/HBN/EEG-ET/NDARVT488RXJ/NDARVT488RXJ_Video1_Samples_ET.mat, Diary, 60, 7299078236, 7416473384, 117395148
/Volumes/methlab_data/HBN/EEG-ET/NDARVT488RXJ/NDARVT488RXJ_Video3_Samples_ET.mat, Despicable, 60, 6754396639, 6924938359, 170541720
/Volumes/methlab_data/HBN/EEG-ET/NDARVU320XJZ/NDARVU320XJZ_Video1_Samples_ET.mat, Diary, 60, 3057827764, 3175222677, 117394913
/Volumes/methlab_data/HBN/EEG-ET/NDARVU320XJZ/NDARVU320XJZ_Video2_Samples_ET.mat, Fractals, 60, 4135674028, 4298655168, 162981140
/Volumes/methlab_data/HBN/EEG-ET/NDARVU320XJZ/NDARVU320XJZ_Video3_Samples_ET.mat, Despicable, 60, 3702827315, 3873369799, 170542484
/Volumes/methlab_data/HBN/EEG-ET/NDARVU320XJZ/NDARVU320XJZ_Video4_Samples_ET.mat, Present, 60, 4630647619, 4833707061, 203059442
/Volumes/methlab_data/HBN/EEG-ET/NDARVU416CR6/NDARVU416CR6_Video-DM_Samples_ET.mat, Despicable, 60, 4337036720, 4507574359, 170537639
/Volumes/methlab_data/HBN/EEG-ET/NDARVU416CR6/NDARVU416CR6_Video-TP_Samples_ET.mat, Present, 60, 4875352458, 5078629256, 203276798
/Volumes/methlab_data/HBN/EEG-ET/NDARVU416CR6/NDARVU416CR6_Video-WK_Samples_ET.mat, Diary, 60, 3112413555, 3229798635, 117385080
/Volumes/methlab_data/HBN/EEG-ET/NDARVU683CTN/NDARVU683CTN_Video1_Samples_ET.mat, Diary, 60, 3050309636, 3167704241, 117394605
/Volumes/methlab_data/HBN/EEG-ET/NDARVU683CTN/NDARVU683CTN_Video3_Samples_ET.mat, Despicable, 60, 3821759959, 3992305540, 170545581
/Volumes/methlab_data/HBN/EEG-ET/NDARVU883NDE/NDARVU883NDE_Video1_Samples_ET.mat, Diary, 60, 5053548530, 5170943486, 117394956
/Volumes/methlab_data/HBN/EEG-ET/NDARVU883NDE/NDARVU883NDE_Video2_Samples_ET.mat, Fractals, 60, 5694995575, 5857988729, 162993154
/Volumes/methlab_data/HBN/EEG-ET/NDARVU883NDE/NDARVU883NDE_Video3_Samples_ET.mat, Despicable, 60, 6134870250, 6305411722, 170541472
/Volumes/methlab_data/HBN/EEG-ET/NDARVU883NDE/NDARVU883NDE_Video4_Samples_ET.mat, Present, 60, 6615283565, 6818354027, 203070462
/Volumes/methlab_data/HBN/EEG-ET/NDARVV174JHW/NDARVV174JHW_Video1_Samples_ET.mat, Diary, 60, 3745741128, 3863132138, 117391010
/Volumes/methlab_data/HBN/EEG-ET/NDARVV174JHW/NDARVV174JHW_Video3_Samples_ET.mat, Despicable, 60, 3288831075, 3459367658, 170536583
/Volumes/methlab_data/HBN/EEG-ET/NDARVV248VW0/NDARVV248VW0_Video1_Samples_ET.mat, Diary, 120, 3334836693, 3452234194, 117397501
/Volumes/methlab_data/HBN/EEG-ET/NDARVV248VW0/NDARVV248VW0_Video2_Samples_ET.mat, Fractals, 120, 4705836568, 4868823671, 162987103
/Volumes/methlab_data/HBN/EEG-ET/NDARVV248VW0/NDARVV248VW0_Video3_Samples_ET.mat, Despicable, 120, 5267072778, 5437620188, 170547410
/Volumes/methlab_data/HBN/EEG-ET/NDARVV473XTY/NDARVV473XTY_Video1_Samples_ET.mat, Diary, 60, 3039616215, 3157018105, 117401890
/Volumes/methlab_data/HBN/EEG-ET/NDARVV473XTY/NDARVV473XTY_Video2_Samples_ET.mat, Fractals, 60, 3650399370, 3813388455, 162989085
/Volumes/methlab_data/HBN/EEG-ET/NDARVV473XTY/NDARVV473XTY_Video3_Samples_ET.mat, Despicable, 60, 4074922202, 4245465486, 170543284
/Volumes/methlab_data/HBN/EEG-ET/NDARVV473XTY/NDARVV473XTY_Video4_Samples_ET.mat, Present, 60, 4552805417, 4755878796, 203073379
/Volumes/methlab_data/HBN/EEG-ET/NDARVV704MND/NDARVV704MND_Video-DM_Samples_ET.mat, Despicable, 60, 4453713414, 4624250702, 170537288
/Volumes/methlab_data/HBN/EEG-ET/NDARVV704MND/NDARVV704MND_Video-TP_Samples_ET.mat, Present, 60, 5339442070, 5542712410, 203270340
/Volumes/methlab_data/HBN/EEG-ET/NDARVV704MND/NDARVV704MND_Video-WK_Samples_ET.mat, Diary, 60, 4885799260, 5003184935, 117385675
/Volumes/methlab_data/HBN/EEG-ET/NDARVV926KLM/NDARVV926KLM_Video-DM_Samples_ET.mat, Despicable, 60, 3659405584, 3829949019, 170543435
/Volumes/methlab_data/HBN/EEG-ET/NDARVV926KLM/NDARVV926KLM_Video-FF_Samples_ET.mat, Fractals, 60, 4121895231, 4284881330, 162986099
/Volumes/methlab_data/HBN/EEG-ET/NDARVV926KLM/NDARVV926KLM_Video-TP_Samples_ET.mat, Present, 60, 4508290100, 4711353552, 203063452
/Volumes/methlab_data/HBN/EEG-ET/NDARVV926KLM/NDARVV926KLM_Video-WK_Samples_ET.mat, Diary, 60, 4333585722, 4450972636, 117386914
/Volumes/methlab_data/HBN/EEG-ET/NDARVX111CNA/NDARVX111CNA_Video-DM_Samples_ET.mat, Despicable, 120, 4801195373, 4971736919, 170541546
/Volumes/methlab_data/HBN/EEG-ET/NDARVX111CNA/NDARVX111CNA_Video-FF_Samples_ET.mat, Fractals, 120, 4311419340, 4474403144, 162983804
/Volumes/methlab_data/HBN/EEG-ET/NDARVX111CNA/NDARVX111CNA_Video-TP_Samples_ET.mat, Present, 120, 5469534594, 5672596214, 203061620
/Volumes/methlab_data/HBN/EEG-ET/NDARVX111CNA/NDARVX111CNA_Video-WK_Samples_ET.mat, Diary, 120, 3685140265, 3802534245, 117393980
/Volumes/methlab_data/HBN/EEG-ET/NDARVX162AZU/NDARVX162AZU_Video1_Samples_ET.mat, Diary, 60, 1923066300, 2040461033, 117394733
/Volumes/methlab_data/HBN/EEG-ET/NDARVX162AZU/NDARVX162AZU_Video3_Samples_ET.mat, Despicable, 60, 3133522183, 3304066364, 170544181
/Volumes/methlab_data/HBN/EEG-ET/NDARVX185WX2/NDARVX185WX2_Video-DM_Samples_ET.mat, Despicable, 120, 3789093703, 3959641716, 170548013
/Volumes/methlab_data/HBN/EEG-ET/NDARVX185WX2/NDARVX185WX2_Video-FF_Samples_ET.mat, Fractals, 120, 3118759546, 3281745732, 162986186
/Volumes/methlab_data/HBN/EEG-ET/NDARVX185WX2/NDARVX185WX2_Video-TP_Samples_ET.mat, Present, 120, 4877187128, 5080254570, 203067442
/Volumes/methlab_data/HBN/EEG-ET/NDARVX185WX2/NDARVX185WX2_Video-WK_Samples_ET.mat, Diary, 120, 4242589568, 4359976996, 117387428
/Volumes/methlab_data/HBN/EEG-ET/NDARVX292KKC/NDARVX292KKC_Video1_Samples_ET.mat, Diary, 60, 1511604712, 1629000907, 117396195
/Volumes/methlab_data/HBN/EEG-ET/NDARVX292KKC/NDARVX292KKC_Video3_Samples_ET.mat, Despicable, 60, 853835776, 1024390626, 170554850
/Volumes/methlab_data/HBN/EEG-ET/NDARVX337AC0/NDARVX337AC0_Video1_Samples_ET.mat, Diary, 60, 8419180982, 8536578022, 117397040
/Volumes/methlab_data/HBN/EEG-ET/NDARVX337AC0/NDARVX337AC0_Video3_Samples_ET.mat, Despicable, 60, 7983835178, 8154377776, 170542598
/Volumes/methlab_data/HBN/EEG-ET/NDARVX547MA0/NDARVX547MA0_Video1_Samples_ET.mat, Diary, 120, 2478407658, 2595804688, 117397030
/Volumes/methlab_data/HBN/EEG-ET/NDARVX547MA0/NDARVX547MA0_Video2_Samples_ET.mat, Fractals, 120, 3675500539, 3838498111, 162997572
/Volumes/methlab_data/HBN/EEG-ET/NDARVX547MA0/NDARVX547MA0_Video3_Samples_ET.mat, Despicable, 120, 4175014407, 4345557822, 170543415
/Volumes/methlab_data/HBN/EEG-ET/NDARVX547MA0/NDARVX547MA0_Video4_Samples_ET.mat, Present, 120, 4848753573, 5051821263, 203067690
/Volumes/methlab_data/HBN/EEG-ET/NDARVX856RHN/NDARVX856RHN_Video1_Samples_ET.mat, Despicable, 120, 6404771710, 6575318479, 170546769
/Volumes/methlab_data/HBN/EEG-ET/NDARVX856RHN/NDARVX856RHN_Video2_Samples_ET.mat, Fractals, 120, 7793782916, 7956770767, 162987851
/Volumes/methlab_data/HBN/EEG-ET/NDARVX856RHN/NDARVX856RHN_Video3_Samples_ET.mat, Diary, 120, 8397309736, 8514698988, 117389252
/Volumes/methlab_data/HBN/EEG-ET/NDARVX856RHN/NDARVX856RHN_Video4_Samples_ET.mat, Present, 120, 9074287551, 9277354628, 203067077
/Volumes/methlab_data/HBN/EEG-ET/NDARVY054WEA/NDARVY054WEA_Video1_Samples_ET.mat, Diary, 60, 4383507401, 4500902390, 117394989
/Volumes/methlab_data/HBN/EEG-ET/NDARVY054WEA/NDARVY054WEA_Video3_Samples_ET.mat, Despicable, 60, 3944491173, 4115036707, 170545534
/Volumes/methlab_data/HBN/EEG-ET/NDARVY366HWJ/NDARVY366HWJ_Video1_Samples_ET.mat, Diary, 60, 3684619133, 3802016052, 117396919
/Volumes/methlab_data/HBN/EEG-ET/NDARVY366HWJ/NDARVY366HWJ_Video3_Samples_ET.mat, Despicable, 60, 3139366209, 3309918641, 170552432
/Volumes/methlab_data/HBN/EEG-ET/NDARVY378DFK/NDARVY378DFK_Video-DM_Samples_ET.mat, Despicable, 120, 3847756467, 4018303918, 170547451
/Volumes/methlab_data/HBN/EEG-ET/NDARVY378DFK/NDARVY378DFK_Video-FF_Samples_ET.mat, Fractals, 120, 2981740080, 3144738025, 162997945
/Volumes/methlab_data/HBN/EEG-ET/NDARVY378DFK/NDARVY378DFK_Video-WK_Samples_ET.mat, Diary, 120, 2431514046, 2548902368, 117388322
/Volumes/methlab_data/HBN/EEG-ET/NDARVY564LFB/NDARVY564LFB_Video-DM_Samples_ET.mat, Despicable, 60, 4357452746, 4527995213, 170542467
/Volumes/methlab_data/HBN/EEG-ET/NDARVY564LFB/NDARVY564LFB_Video-FF_Samples_ET.mat, Fractals, 60, 3925201419, 4088190567, 162989148
/Volumes/methlab_data/HBN/EEG-ET/NDARVY564LFB/NDARVY564LFB_Video-TP_Samples_ET.mat, Present, 60, 4834728831, 5037797286, 203068455
/Volumes/methlab_data/HBN/EEG-ET/NDARVY564LFB/NDARVY564LFB_Video-WK_Samples_ET.mat, Diary, 60, 3353089359, 3470487283, 117397924
/Volumes/methlab_data/HBN/EEG-ET/NDARVY860TY0/NDARVY860TY0_Video-DM_Samples_ET.mat, Despicable, 60, 10507321503, 10677859101, 170537598
/Volumes/methlab_data/HBN/EEG-ET/NDARVY860TY0/NDARVY860TY0_Video-TP_Samples_ET.mat, Present, 60, 11500694825, 11703973553, 203278728
/Volumes/methlab_data/HBN/EEG-ET/NDARVY860TY0/NDARVY860TY0_Video-WK_Samples_ET.mat, Diary, 60, 10101286451, 10218675424, 117388973
/Volumes/methlab_data/HBN/EEG-ET/NDARWA102TY7/NDARWA102TY7_Video-DM_Samples_ET.mat, Despicable, 60, 4851830108, 5022371873, 170541765
/Volumes/methlab_data/HBN/EEG-ET/NDARWA102TY7/NDARWA102TY7_Video-FF_Samples_ET.mat, Fractals, 60, 4207709299, 4370704666, 162995367
/Volumes/methlab_data/HBN/EEG-ET/NDARWA102TY7/NDARWA102TY7_Video-TP_Samples_ET.mat, Present, 60, 5732581345, 5935643070, 203061725
/Volumes/methlab_data/HBN/EEG-ET/NDARWA102TY7/NDARWA102TY7_Video-WK_Samples_ET.mat, Diary, 60, 5300252422, 5417647502, 117395080
/Volumes/methlab_data/HBN/EEG-ET/NDARWA276AW0/NDARWA276AW0_Video-WK_Samples_ET.mat, Diary, 30, 2357146527, 2474535420, 117388893
/Volumes/methlab_data/HBN/EEG-ET/NDARWA351ZE2/NDARWA351ZE2_Video1_Samples_ET.mat, Diary, 60, 4309490293, 4426889063, 117398770
/Volumes/methlab_data/HBN/EEG-ET/NDARWA351ZE2/NDARWA351ZE2_Video3_Samples_ET.mat, Despicable, 60, 3875528398, 4046068635, 170540237
/Volumes/methlab_data/HBN/EEG-ET/NDARWA433WYZ/NDARWA433WYZ_Video1_Samples_ET.mat, Fractals, 120, 4844425126, 5007422339, 162997213
/Volumes/methlab_data/HBN/EEG-ET/NDARWA433WYZ/NDARWA433WYZ_Video2_Samples_ET.mat, Despicable, 120, 6111407193, 6281951277, 170544084
/Volumes/methlab_data/HBN/EEG-ET/NDARWA433WYZ/NDARWA433WYZ_Video3_Samples_ET.mat, Diary, 120, 6643844748, 6761242134, 117397386
/Volumes/methlab_data/HBN/EEG-ET/NDARWA433WYZ/NDARWA433WYZ_Video4_Samples_ET.mat, Present, 120, 7441391215, 7644457659, 203066444
/Volumes/methlab_data/HBN/EEG-ET/NDARWA513WM2/NDARWA513WM2_Video1_Samples_ET.mat, Diary, 60, 2965192387, 3082586923, 117394536
/Volumes/methlab_data/HBN/EEG-ET/NDARWA513WM2/NDARWA513WM2_Video3_Samples_ET.mat, Despicable, 60, 3534006024, 3704549372, 170543348
/Volumes/methlab_data/HBN/EEG-ET/NDARWA544RDT/NDARWA544RDT_Video1_Samples_ET.mat, Diary, 60, 3985856848, 4103244633, 117387785
/Volumes/methlab_data/HBN/EEG-ET/NDARWA544RDT/NDARWA544RDT_Video3_Samples_ET.mat, Despicable, 60, 3560560021, 3731110279, 170550258
/Volumes/methlab_data/HBN/EEG-ET/NDARWA570DNL/NDARWA570DNL_Video-DM_Samples_ET.mat, Despicable, 60, 5625742116, 5796278767, 170536651
/Volumes/methlab_data/HBN/EEG-ET/NDARWA570DNL/NDARWA570DNL_Video-TP_Samples_ET.mat, Present, 60, 6031895451, 6235163144, 203267693
/Volumes/methlab_data/HBN/EEG-ET/NDARWA570DNL/NDARWA570DNL_Video-WK_Samples_ET.mat, Diary, 60, 5866349290, 5983737344, 117388054
/Volumes/methlab_data/HBN/EEG-ET/NDARWA606FWB/NDARWA606FWB_Video-DM_Samples_ET.mat, Despicable, 30, 4980894099, 5151433562, 170539463
/Volumes/methlab_data/HBN/EEG-ET/NDARWA606FWB/NDARWA606FWB_Video-WK_Samples_ET.mat, Diary, 30, 3740740763, 3858133539, 117392776
/Volumes/methlab_data/HBN/EEG-ET/NDARWA622HHZ/NDARWA622HHZ_Video1_Samples_ET.mat, Despicable, 120, 332567034, 503114022, 170546988
/Volumes/methlab_data/HBN/EEG-ET/NDARWA622HHZ/NDARWA622HHZ_Video2_Samples_ET.mat, Diary, 120, 858284050, 975681151, 117397101
/Volumes/methlab_data/HBN/EEG-ET/NDARWA622HHZ/NDARWA622HHZ_Video3_Samples_ET.mat, Fractals, 120, 1255269640, 1418257136, 162987496
/Volumes/methlab_data/HBN/EEG-ET/NDARWA622HHZ/NDARWA622HHZ_Video4_Samples_ET.mat, Present, 120, 1954466422, 2157532574, 203066152
/Volumes/methlab_data/HBN/EEG-ET/NDARWB124EMA/NDARWB124EMA_Video1_Samples_ET.mat, Diary, 60, 107721566960, 107838960963, 117394003
/Volumes/methlab_data/HBN/EEG-ET/NDARWB124EMA/NDARWB124EMA_Video3_Samples_ET.mat, Despicable, 60, 109124078040, 109294623599, 170545559
/Volumes/methlab_data/HBN/EEG-ET/NDARWB179TJ0/NDARWB179TJ0_Video-DM_Samples_ET.mat, Despicable, 30, 1254255448, 1424788667, 170533219
/Volumes/methlab_data/HBN/EEG-ET/NDARWB179TJ0/NDARWB179TJ0_Video-TP_Samples_ET.mat, Present, 30, 2366340391, 2569604747, 203264356
/Volumes/methlab_data/HBN/EEG-ET/NDARWB179TJ0/NDARWB179TJ0_Video-WK_Samples_ET.mat, Diary, 30, 1735435637, 1852822422, 117386785
/Volumes/methlab_data/HBN/EEG-ET/NDARWB457JU6/NDARWB457JU6_Video1_Samples_ET.mat, Diary, 60, 4734196027, 4851587044, 117391017
/Volumes/methlab_data/HBN/EEG-ET/NDARWB457JU6/NDARWB457JU6_Video3_Samples_ET.mat, Despicable, 60, 4305940229, 4476480826, 170540597
/Volumes/methlab_data/HBN/EEG-ET/NDARWB457JU6/NDARWB457JU6_Video4_Samples_ET.mat, Present, 60, 5149629736, 5352690308, 203060572
/Volumes/methlab_data/HBN/EEG-ET/NDARWB557CNH/NDARWB557CNH_Video-DM_Samples_ET.mat, Despicable, 120, 5016779386, 5187326128, 170546742
/Volumes/methlab_data/HBN/EEG-ET/NDARWB557CNH/NDARWB557CNH_Video-FF_Samples_ET.mat, Fractals, 120, 4566462556, 4729448495, 162985939
/Volumes/methlab_data/HBN/EEG-ET/NDARWB557CNH/NDARWB557CNH_Video-TP_Samples_ET.mat, Present, 120, 5659543890, 5862613871, 203069981
/Volumes/methlab_data/HBN/EEG-ET/NDARWB557CNH/NDARWB557CNH_Video-WK_Samples_ET.mat, Diary, 120, 4071475145, 4188872814, 117397669
/Volumes/methlab_data/HBN/EEG-ET/NDARWB685NUG/NDARWB685NUG_Video1_Samples_ET.mat, Diary, 60, 6613993524, 6731383643, 117390119
/Volumes/methlab_data/HBN/EEG-ET/NDARWB685NUG/NDARWB685NUG_Video3_Samples_ET.mat, Despicable, 60, 5034692387, 5205230139, 170537752
/Volumes/methlab_data/HBN/EEG-ET/NDARWB782FLR/NDARWB782FLR_Video1_Samples_ET.mat, Diary, 60, 3006882491, 3124276477, 117393986
/Volumes/methlab_data/HBN/EEG-ET/NDARWB782FLR/NDARWB782FLR_Video2_Samples_ET.mat, Fractals, 60, 1828165109, 1991156397, 162991288
/Volumes/methlab_data/HBN/EEG-ET/NDARWB782FLR/NDARWB782FLR_Video3_Samples_ET.mat, Despicable, 60, 2564477673, 2735020285, 170542612
/Volumes/methlab_data/HBN/EEG-ET/NDARWB782FLR/NDARWB782FLR_Video4_Samples_ET.mat, Present, 60, 3424777902, 3627841500, 203063598
/Volumes/methlab_data/HBN/EEG-ET/NDARWB903FVY/NDARWB903FVY_Video-DM_Samples_ET.mat, Despicable, 60, 4215070127, 4385603470, 170533343
/Volumes/methlab_data/HBN/EEG-ET/NDARWB903FVY/NDARWB903FVY_Video-TP_Samples_ET.mat, Present, 60, 5261327338, 5464601786, 203274448
/Volumes/methlab_data/HBN/EEG-ET/NDARWB903FVY/NDARWB903FVY_Video-WK_Samples_ET.mat, Diary, 60, 4820240123, 4938058262, 117818139
/Volumes/methlab_data/HBN/EEG-ET/NDARWC174VE6/NDARWC174VE6_Video1_Samples_ET.mat, Fractals, 120, 8304108463, 8467094014, 162985551
/Volumes/methlab_data/HBN/EEG-ET/NDARWC174VE6/NDARWC174VE6_Video2_Samples_ET.mat, Despicable, 120, 9846642333, 10017188991, 170546658
/Volumes/methlab_data/HBN/EEG-ET/NDARWC174VE6/NDARWC174VE6_Video3_Samples_ET.mat, Diary, 120, 10317809952, 10435207067, 117397115
/Volumes/methlab_data/HBN/EEG-ET/NDARWC174VE6/NDARWC174VE6_Video4_Samples_ET.mat, Present, 120, 10992425694, 11195493261, 203067567
/Volumes/methlab_data/HBN/EEG-ET/NDARWC399JLD/NDARWC399JLD_Video-DM_Samples_ET.mat, Despicable, 30, 6009670836, 6180217366, 170546530
/Volumes/methlab_data/HBN/EEG-ET/NDARWC399JLD/NDARWC399JLD_Video-TP_Samples_ET.mat, Present, 30, 6942868263, 7146132921, 203264658
/Volumes/methlab_data/HBN/EEG-ET/NDARWC399JLD/NDARWC399JLD_Video-WK_Samples_ET.mat, Diary, 30, 6643871994, 6761270958, 117398964
/Volumes/methlab_data/HBN/EEG-ET/NDARWC427JB2/NDARWC427JB2_Video-DM_Samples_ET.mat, Despicable, 60, 4596760357, 4767307907, 170547550
/Volumes/methlab_data/HBN/EEG-ET/NDARWC427JB2/NDARWC427JB2_Video-FF_Samples_ET.mat, Fractals, 60, 4165798821, 4328791025, 162992204
/Volumes/methlab_data/HBN/EEG-ET/NDARWC427JB2/NDARWC427JB2_Video-TP_Samples_ET.mat, Present, 60, 5135496053, 5338559602, 203063549
/Volumes/methlab_data/HBN/EEG-ET/NDARWC427JB2/NDARWC427JB2_Video-WK_Samples_ET.mat, Diary, 60, 3286736636, 3404131619, 117394983
/Volumes/methlab_data/HBN/EEG-ET/NDARWC737UJ0/NDARWC737UJ0_Video1_Samples_ET.mat, Diary, 60, 5250029504, 5367424598, 117395094
/Volumes/methlab_data/HBN/EEG-ET/NDARWC737UJ0/NDARWC737UJ0_Video3_Samples_ET.mat, Despicable, 60, 5500579773, 5671125486, 170545713
/Volumes/methlab_data/HBN/EEG-ET/NDARWC801CB5/NDARWC801CB5_Video1_Samples_ET.mat, Diary, 60, 2126083850, 2243472010, 117388160
/Volumes/methlab_data/HBN/EEG-ET/NDARWC925WDX/NDARWC925WDX_Video1_Samples_ET.mat, Diary, 60, 991811679, 1109204696, 117393017
/Volumes/methlab_data/HBN/EEG-ET/NDARWC925WDX/NDARWC925WDX_Video3_Samples_ET.mat, Despicable, 60, 565662411, 736206978, 170544567
/Volumes/methlab_data/HBN/EEG-ET/NDARWD585PRZ/NDARWD585PRZ_Video-DM_Samples_ET.mat, Despicable, 120, 4938712141, 5109268147, 170556006
/Volumes/methlab_data/HBN/EEG-ET/NDARWD585PRZ/NDARWD585PRZ_Video-FF_Samples_ET.mat, Fractals, 120, 4140347428, 4303343582, 162996154
/Volumes/methlab_data/HBN/EEG-ET/NDARWD585PRZ/NDARWD585PRZ_Video-TP_Samples_ET.mat, Present, 120, 6079213980, 6282275547, 203061567
/Volumes/methlab_data/HBN/EEG-ET/NDARWD585PRZ/NDARWD585PRZ_Video-WK_Samples_ET.mat, Diary, 120, 5485037706, 5602436105, 117398399
/Volumes/methlab_data/HBN/EEG-ET/NDARWD655AAA/NDARWD655AAA_Video1_Samples_ET.mat, Diary, 60, 89815161120, 89932558033, 117396913
/Volumes/methlab_data/HBN/EEG-ET/NDARWD655AAA/NDARWD655AAA_Video3_Samples_ET.mat, Despicable, 60, 89595671086, 89766208543, 170537457
/Volumes/methlab_data/HBN/EEG-ET/NDARWD911WBU/NDARWD911WBU_Video1_Samples_ET.mat, Diary, 60, 3323890117, 3441283006, 117392889
/Volumes/methlab_data/HBN/EEG-ET/NDARWD911WBU/NDARWD911WBU_Video2_Samples_ET.mat, Fractals, 60, 4146872075, 4309885165, 163013090
/Volumes/methlab_data/HBN/EEG-ET/NDARWD911WBU/NDARWD911WBU_Video3_Samples_ET.mat, Despicable, 60, 4576226166, 4746768615, 170542449
/Volumes/methlab_data/HBN/EEG-ET/NDARWD911WBU/NDARWD911WBU_Video4_Samples_ET.mat, Present, 60, 5102977033, 5306049405, 203072372
/Volumes/methlab_data/HBN/EEG-ET/NDARWE130JMG/NDARWE130JMG_Video-DM_Samples_ET.mat, Despicable, 60, 5381056733, 5551593148, 170536415
/Volumes/methlab_data/HBN/EEG-ET/NDARWE130JMG/NDARWE130JMG_Video-TP_Samples_ET.mat, Present, 60, 6296645110, 6499923601, 203278491
/Volumes/methlab_data/HBN/EEG-ET/NDARWE130JMG/NDARWE130JMG_Video-WK_Samples_ET.mat, Diary, 60, 5858170565, 5975560434, 117389869
/Volumes/methlab_data/HBN/EEG-ET/NDARWE145GN9/NDARWE145GN9_Video1_Samples_ET.mat, Diary, 60, 2838284807, 2955680902, 117396095
/Volumes/methlab_data/HBN/EEG-ET/NDARWE145GN9/NDARWE145GN9_Video3_Samples_ET.mat, Despicable, 60, 4008327744, 4178873444, 170545700
/Volumes/methlab_data/HBN/EEG-ET/NDARWE717DEU/NDARWE717DEU_Video-DM_Samples_ET.mat, Despicable, 60, 3920494965, 4091039364, 170544399
/Volumes/methlab_data/HBN/EEG-ET/NDARWE717DEU/NDARWE717DEU_Video-FF_Samples_ET.mat, Fractals, 60, 3496703799, 3659683875, 162980076
/Volumes/methlab_data/HBN/EEG-ET/NDARWE717DEU/NDARWE717DEU_Video-TP_Samples_ET.mat, Present, 60, 4400085509, 4603148901, 203063392
/Volumes/methlab_data/HBN/EEG-ET/NDARWE717DEU/NDARWE717DEU_Video-WK_Samples_ET.mat, Diary, 60, 2853018389, 2970410286, 117391897
/Volumes/methlab_data/HBN/EEG-ET/NDARWE738CX3/NDARWE738CX3_Video-DM_Samples_ET.mat, Despicable, 60, 5761258620, 5931812212, 170553592
/Volumes/methlab_data/HBN/EEG-ET/NDARWE738CX3/NDARWE738CX3_Video-FF_Samples_ET.mat, Fractals, 60, 5142251738, 5305233051, 162981313
/Volumes/methlab_data/HBN/EEG-ET/NDARWE738CX3/NDARWE738CX3_Video-TP_Samples_ET.mat, Present, 60, 6310649135, 6513711773, 203062638
/Volumes/methlab_data/HBN/EEG-ET/NDARWE738CX3/NDARWE738CX3_Video-WK_Samples_ET.mat, Diary, 60, 3779686067, 3897081115, 117395048
/Volumes/methlab_data/HBN/EEG-ET/NDARWE898TG8/NDARWE898TG8_Video1_Samples_ET.mat, Fractals, 120, 7378252989, 7541239327, 162986338
/Volumes/methlab_data/HBN/EEG-ET/NDARWE898TG8/NDARWE898TG8_Video2_Samples_ET.mat, Diary, 120, 8262366704, 8379764556, 117397852
/Volumes/methlab_data/HBN/EEG-ET/NDARWE898TG8/NDARWE898TG8_Video3_Samples_ET.mat, Despicable, 120, 8925458407, 9095998246, 170539839
/Volumes/methlab_data/HBN/EEG-ET/NDARWE898TG8/NDARWE898TG8_Video4_Samples_ET.mat, Present, 120, 9561520069, 9764584231, 203064162
/Volumes/methlab_data/HBN/EEG-ET/NDARWE908KF8/NDARWE908KF8_Video-DM_Samples_ET.mat, Despicable, 60, 3963380344, 4133924952, 170544608
/Volumes/methlab_data/HBN/EEG-ET/NDARWE908KF8/NDARWE908KF8_Video-FF_Samples_ET.mat, Fractals, 60, 3477166574, 3640157852, 162991278
/Volumes/methlab_data/HBN/EEG-ET/NDARWE908KF8/NDARWE908KF8_Video-TP_Samples_ET.mat, Present, 60, 4440383578, 4643447161, 203063583
/Volumes/methlab_data/HBN/EEG-ET/NDARWE908KF8/NDARWE908KF8_Video-WK_Samples_ET.mat, Diary, 60, 2841526187, 2958920211, 117394024
/Volumes/methlab_data/HBN/EEG-ET/NDARWF122UUJ/NDARWF122UUJ_Video1_Samples_ET.mat, Diary, 60, 3398367884, 3515754975, 117387091
/Volumes/methlab_data/HBN/EEG-ET/NDARWF122UUJ/NDARWF122UUJ_Video3_Samples_ET.mat, Despicable, 60, 3165777309, 3336314029, 170536720
/Volumes/methlab_data/HBN/EEG-ET/NDARWF259RB2/NDARWF259RB2_Video-DM_Samples_ET.mat, Despicable, 60, 4213858954, 4384398733, 170539779
/Volumes/methlab_data/HBN/EEG-ET/NDARWF259RB2/NDARWF259RB2_Video-FF_Samples_ET.mat, Fractals, 60, 3740904128, 3903895620, 162991492
/Volumes/methlab_data/HBN/EEG-ET/NDARWF259RB2/NDARWF259RB2_Video-TP_Samples_ET.mat, Present, 60, 4721194140, 4924254926, 203060786
/Volumes/methlab_data/HBN/EEG-ET/NDARWF259RB2/NDARWF259RB2_Video-WK_Samples_ET.mat, Diary, 60, 3177290080, 3294682239, 117392159
/Volumes/methlab_data/HBN/EEG-ET/NDARWF422UK3/NDARWF422UK3_Video-DM_Samples_ET.mat, Despicable, 60, 4595139741, 4765681041, 170541300
/Volumes/methlab_data/HBN/EEG-ET/NDARWF422UK3/NDARWF422UK3_Video-FF_Samples_ET.mat, Fractals, 60, 4142494537, 4305478493, 162983956
/Volumes/methlab_data/HBN/EEG-ET/NDARWF422UK3/NDARWF422UK3_Video-TP_Samples_ET.mat, Present, 60, 5237745919, 5440808160, 203062241
/Volumes/methlab_data/HBN/EEG-ET/NDARWF514TW5/NDARWF514TW5_Video-DM_Samples_ET.mat, Despicable, 60, 4506313873, 4676857357, 170543484
/Volumes/methlab_data/HBN/EEG-ET/NDARWF514TW5/NDARWF514TW5_Video-FF_Samples_ET.mat, Fractals, 60, 3913085881, 4076069045, 162983164
/Volumes/methlab_data/HBN/EEG-ET/NDARWF514TW5/NDARWF514TW5_Video-TP_Samples_ET.mat, Present, 60, 4987049426, 5190118859, 203069433
/Volumes/methlab_data/HBN/EEG-ET/NDARWF514TW5/NDARWF514TW5_Video-WK_Samples_ET.mat, Diary, 60, 3229939401, 3347333329, 117393928
/Volumes/methlab_data/HBN/EEG-ET/NDARWF593BNF/NDARWF593BNF_Video-DM_Samples_ET.mat, Despicable, 60, 4856198515, 5026741041, 170542526
/Volumes/methlab_data/HBN/EEG-ET/NDARWF593BNF/NDARWF593BNF_Video-FF_Samples_ET.mat, Fractals, 60, 5390212871, 5553196094, 162983223
/Volumes/methlab_data/HBN/EEG-ET/NDARWF593BNF/NDARWF593BNF_Video-TP_Samples_ET.mat, Present, 60, 252021021, 455082550, 203061529
/Volumes/methlab_data/HBN/EEG-ET/NDARWF593BNF/NDARWF593BNF_Video-WK_Samples_ET.mat, Diary, 60, 4131436358, 4248829344, 117392986
/Volumes/methlab_data/HBN/EEG-ET/NDARWG200CUE/NDARWG200CUE_Video-DM_Samples_ET.mat, Despicable, 60, 6319526586, 6490066043, 170539457
/Volumes/methlab_data/HBN/EEG-ET/NDARWG200CUE/NDARWG200CUE_Video-FF_Samples_ET.mat, Fractals, 60, 6794160821, 6957148950, 162988129
/Volumes/methlab_data/HBN/EEG-ET/NDARWG200CUE/NDARWG200CUE_Video-TP_Samples_ET.mat, Present, 60, 7372873558, 7575933981, 203060423
/Volumes/methlab_data/HBN/EEG-ET/NDARWG200CUE/NDARWG200CUE_Video-WK_Samples_ET.mat, Diary, 60, 5255641169, 5373031115, 117389946
/Volumes/methlab_data/HBN/EEG-ET/NDARWG549LCF/NDARWG549LCF_Video-DM_Samples_ET.mat, Despicable, 120, 2562866043, 2733413313, 170547270
/Volumes/methlab_data/HBN/EEG-ET/NDARWG549LCF/NDARWG549LCF_Video-FF_Samples_ET.mat, Fractals, 120, 3786704441, 3949689197, 162984756
/Volumes/methlab_data/HBN/EEG-ET/NDARWG549LCF/NDARWG549LCF_Video-TP_Samples_ET.mat, Present, 120, 4540483798, 4743561277, 203077479
/Volumes/methlab_data/HBN/EEG-ET/NDARWG549LCF/NDARWG549LCF_Video-WK_Samples_ET.mat, Diary, 120, 3299681171, 3417078680, 117397509
/Volumes/methlab_data/HBN/EEG-ET/NDARWG820RKE/NDARWG820RKE_Video-DM_Samples_ET.mat, Despicable, 60, 5638851505, 5809390975, 170539470
/Volumes/methlab_data/HBN/EEG-ET/NDARWG820RKE/NDARWG820RKE_Video-FF_Samples_ET.mat, Fractals, 60, 5086067061, 5249058221, 162991160
/Volumes/methlab_data/HBN/EEG-ET/NDARWG820RKE/NDARWG820RKE_Video-TP_Samples_ET.mat, Present, 60, 6142504224, 6345565654, 203061430
/Volumes/methlab_data/HBN/EEG-ET/NDARWG820RKE/NDARWG820RKE_Video-WK_Samples_ET.mat, Diary, 60, 4400197655, 4517592589, 117394934
/Volumes/methlab_data/HBN/EEG-ET/NDARWG831JJ8/NDARWG831JJ8_Video1_Samples_ET.mat, Diary, 60, 3224802432, 3342193318, 117390886
/Volumes/methlab_data/HBN/EEG-ET/NDARWG831JJ8/NDARWG831JJ8_Video3_Samples_ET.mat, Despicable, 60, 2724689386, 2895228803, 170539417
/Volumes/methlab_data/HBN/EEG-ET/NDARWG911DZG/NDARWG911DZG_Video1_Samples_ET.mat, Diary, 120, 11349100518, 11466496810, 117396292
/Volumes/methlab_data/HBN/EEG-ET/NDARWG911DZG/NDARWG911DZG_Video2_Samples_ET.mat, Fractals, 120, 11803246207, 11966243208, 162997001
/Volumes/methlab_data/HBN/EEG-ET/NDARWG911DZG/NDARWG911DZG_Video3_Samples_ET.mat, Despicable, 120, 12112886471, 12283428792, 170542321
/Volumes/methlab_data/HBN/EEG-ET/NDARWG911DZG/NDARWG911DZG_Video4_Samples_ET.mat, Present, 120, 13013140178, 13216206327, 203066149
/Volumes/methlab_data/HBN/EEG-ET/NDARWH725TXP/NDARWH725TXP_Video1_Samples_ET.mat, Diary, 60, 2617165856, 2734554983, 117389127
/Volumes/methlab_data/HBN/EEG-ET/NDARWH725TXP/NDARWH725TXP_Video3_Samples_ET.mat, Despicable, 60, 2345782714, 2516332479, 170549765
/Volumes/methlab_data/HBN/EEG-ET/NDARWH725TXP/NDARWH725TXP_Video4_Samples_ET.mat, Present, 60, 2976311224, 3179378902, 203067678
/Volumes/methlab_data/HBN/EEG-ET/NDARWH778CPD/NDARWH778CPD_Video1_Samples_ET.mat, Diary, 120, 4594265835, 4711662769, 117396934
/Volumes/methlab_data/HBN/EEG-ET/NDARWH778CPD/NDARWH778CPD_Video2_Samples_ET.mat, Fractals, 120, 5536199189, 5699184451, 162985262
/Volumes/methlab_data/HBN/EEG-ET/NDARWH778CPD/NDARWH778CPD_Video3_Samples_ET.mat, Despicable, 120, 6121537586, 6292084500, 170546914
/Volumes/methlab_data/HBN/EEG-ET/NDARWH778CPD/NDARWH778CPD_Video4_Samples_ET.mat, Present, 120, 6855562739, 7058624300, 203061561
/Volumes/methlab_data/HBN/EEG-ET/NDARWH779MZ2/NDARWH779MZ2_Video1_Samples_ET.mat, Diary, 60, 3337864501, 3455262341, 117397840
/Volumes/methlab_data/HBN/EEG-ET/NDARWH779MZ2/NDARWH779MZ2_Video2_Samples_ET.mat, Fractals, 60, 3976493096, 4139490126, 162997030
/Volumes/methlab_data/HBN/EEG-ET/NDARWH779MZ2/NDARWH779MZ2_Video3_Samples_ET.mat, Despicable, 60, 4396976806, 4567519132, 170542326
/Volumes/methlab_data/HBN/EEG-ET/NDARWH779MZ2/NDARWH779MZ2_Video4_Samples_ET.mat, Present, 60, 4881169434, 5084233723, 203064289
/Volumes/methlab_data/HBN/EEG-ET/NDARWJ019VGU/NDARWJ019VGU_Video1_Samples_ET.mat, Diary, 60, 1590203564, 1707592452, 117388888
/Volumes/methlab_data/HBN/EEG-ET/NDARWJ019VGU/NDARWJ019VGU_Video3_Samples_ET.mat, Despicable, 60, 2907693622, 3078233019, 170539397
/Volumes/methlab_data/HBN/EEG-ET/NDARWJ064WYP/NDARWJ064WYP_Video1_Samples_ET.mat, Diary, 60, 8002220037, 8119622036, 117401999
/Volumes/methlab_data/HBN/EEG-ET/NDARWJ064WYP/NDARWJ064WYP_Video3_Samples_ET.mat, Despicable, 60, 7576379971, 7746917559, 170537588
/Volumes/methlab_data/HBN/EEG-ET/NDARWJ064WYP/NDARWJ064WYP_Video4_Samples_ET.mat, Present, 60, 8156953434, 8360014039, 203060605
/Volumes/methlab_data/HBN/EEG-ET/NDARWJ087HKJ/NDARWJ087HKJ_Video1_Samples_ET.mat, Diary, 120, 3381229146, 3498617208, 117388062
/Volumes/methlab_data/HBN/EEG-ET/NDARWJ087HKJ/NDARWJ087HKJ_Video2_Samples_ET.mat, Fractals, 120, 4266313163, 4429301351, 162988188
/Volumes/methlab_data/HBN/EEG-ET/NDARWJ087HKJ/NDARWJ087HKJ_Video3_Samples_ET.mat, Despicable, 120, 4786380564, 4956927983, 170547419
/Volumes/methlab_data/HBN/EEG-ET/NDARWJ321WKG/NDARWJ321WKG_Video-DM_Samples_ET.mat, Despicable, 60, 8402197637, 8572742240, 170544603
/Volumes/methlab_data/HBN/EEG-ET/NDARWJ321WKG/NDARWJ321WKG_Video-FF_Samples_ET.mat, Fractals, 60, 7919262212, 8082254479, 162992267
/Volumes/methlab_data/HBN/EEG-ET/NDARWJ321WKG/NDARWJ321WKG_Video-TP_Samples_ET.mat, Present, 60, 9074937269, 9278039873, 203102604
/Volumes/methlab_data/HBN/EEG-ET/NDARWJ321WKG/NDARWJ321WKG_Video-WK_Samples_ET.mat, Diary, 60, 7207613069, 7325010102, 117397033
/Volumes/methlab_data/HBN/EEG-ET/NDARWJ414WB8/NDARWJ414WB8_Video1_Samples_ET.mat, Diary, 60, 94334932559, 94452327417, 117394858
/Volumes/methlab_data/HBN/EEG-ET/NDARWJ414WB8/NDARWJ414WB8_Video3_Samples_ET.mat, Despicable, 60, 93825623211, 93996161617, 170538406
/Volumes/methlab_data/HBN/EEG-ET/NDARWJ414WB8/NDARWJ414WB8_Video4_Samples_ET.mat, Present, 60, 94814454917, 95017518331, 203063414
/Volumes/methlab_data/HBN/EEG-ET/NDARWJ498CZY/NDARWJ498CZY_Video1_Samples_ET.mat, Diary, 120, 13351813557, 13469210908, 117397351
/Volumes/methlab_data/HBN/EEG-ET/NDARWJ498CZY/NDARWJ498CZY_Video2_Samples_ET.mat, Fractals, 120, 14125821544, 14288815766, 162994222
/Volumes/methlab_data/HBN/EEG-ET/NDARWJ498CZY/NDARWJ498CZY_Video3_Samples_ET.mat, Despicable, 120, 14599118945, 14769662731, 170543786
/Volumes/methlab_data/HBN/EEG-ET/NDARWJ498CZY/NDARWJ498CZY_Video4_Samples_ET.mat, Present, 120, 15291932811, 15494999286, 203066475
/Volumes/methlab_data/HBN/EEG-ET/NDARWJ621JRZ/NDARWJ621JRZ_Video1_Samples_ET.mat, Diary, 120, 3482687977, 3600084017, 117396040
/Volumes/methlab_data/HBN/EEG-ET/NDARWJ621JRZ/NDARWJ621JRZ_Video2_Samples_ET.mat, Fractals, 120, 4888837396, 5051825360, 162987964
/Volumes/methlab_data/HBN/EEG-ET/NDARWJ621JRZ/NDARWJ621JRZ_Video3_Samples_ET.mat, Despicable, 120, 5404494560, 5575037610, 170543050
/Volumes/methlab_data/HBN/EEG-ET/NDARWJ621JRZ/NDARWJ621JRZ_Video4_Samples_ET.mat, Present, 120, 6085282792, 6288350405, 203067613
/Volumes/methlab_data/HBN/EEG-ET/NDARWJ671YX5/NDARWJ671YX5_Video1_Samples_ET.mat, Diary, 60, 4726749083, 4844137313, 117388230
/Volumes/methlab_data/HBN/EEG-ET/NDARWJ671YX5/NDARWJ671YX5_Video3_Samples_ET.mat, Despicable, 60, 4291753847, 4462295701, 170541854
/Volumes/methlab_data/HBN/EEG-ET/NDARWJ671YX5/NDARWJ671YX5_Video4_Samples_ET.mat, Present, 60, 5161392120, 5364462054, 203069934
/Volumes/methlab_data/HBN/EEG-ET/NDARWK051GG4/NDARWK051GG4_Video-DM_Samples_ET.mat, Despicable, 60, 5296548755, 5467093279, 170544524
/Volumes/methlab_data/HBN/EEG-ET/NDARWK051GG4/NDARWK051GG4_Video-FF_Samples_ET.mat, Fractals, 60, 4836230462, 4999218672, 162988210
/Volumes/methlab_data/HBN/EEG-ET/NDARWK051GG4/NDARWK051GG4_Video-TP_Samples_ET.mat, Present, 60, 5872110473, 6075171983, 203061510
/Volumes/methlab_data/HBN/EEG-ET/NDARWK051GG4/NDARWK051GG4_Video-WK_Samples_ET.mat, Diary, 60, 4219076365, 4336470339, 117393974
/Volumes/methlab_data/HBN/EEG-ET/NDARWK065NJ9/NDARWK065NJ9_Video1_Samples_ET.mat, Diary, 60, 2332635618, 2450028019, 117392401
/Volumes/methlab_data/HBN/EEG-ET/NDARWK065NJ9/NDARWK065NJ9_Video3_Samples_ET.mat, Despicable, 60, 1810983808, 1981533056, 170549248
/Volumes/methlab_data/HBN/EEG-ET/NDARWK117NYK/NDARWK117NYK_Video-DM_Samples_ET.mat, Despicable, 60, 2967432043, 3137975592, 170543549
/Volumes/methlab_data/HBN/EEG-ET/NDARWK117NYK/NDARWK117NYK_Video-FF_Samples_ET.mat, Fractals, 60, 2423199476, 2586182669, 162983193
/Volumes/methlab_data/HBN/EEG-ET/NDARWK117NYK/NDARWK117NYK_Video-TP_Samples_ET.mat, Present, 60, 3457474331, 3660543840, 203069509
/Volumes/methlab_data/HBN/EEG-ET/NDARWK117NYK/NDARWK117NYK_Video-WK_Samples_ET.mat, Diary, 60, 1807283259, 1924678242, 117394983
/Volumes/methlab_data/HBN/EEG-ET/NDARWK626PFY/NDARWK626PFY_Video-DM_Samples_ET.mat, Despicable, 120, 4322719743, 4493267340, 170547597
/Volumes/methlab_data/HBN/EEG-ET/NDARWK626PFY/NDARWK626PFY_Video-FF_Samples_ET.mat, Fractals, 120, 3710382362, 3873370439, 162988077
/Volumes/methlab_data/HBN/EEG-ET/NDARWK626PFY/NDARWK626PFY_Video-TP_Samples_ET.mat, Present, 120, 4864291287, 5067354979, 203063692
/Volumes/methlab_data/HBN/EEG-ET/NDARWK626PFY/NDARWK626PFY_Video-WK_Samples_ET.mat, Diary, 120, 3013058869, 3130454958, 117396089
/Volumes/methlab_data/HBN/EEG-ET/NDARWK793VK4/NDARWK793VK4_Video-DM_Samples_ET.mat, Despicable, 60, 7202102593, 7372642149, 170539556
/Volumes/methlab_data/HBN/EEG-ET/NDARWK793VK4/NDARWK793VK4_Video-TP_Samples_ET.mat, Present, 60, 7814237348, 8017516213, 203278865
/Volumes/methlab_data/HBN/EEG-ET/NDARWK793VK4/NDARWK793VK4_Video-WK_Samples_ET.mat, Diary, 60, 5039484585, 5156870595, 117386010
/Volumes/methlab_data/HBN/EEG-ET/NDARWK983JFE/NDARWK983JFE_Video3_Samples_ET.mat, Despicable, 60, 4108092973, 4278634879, 170541906
/Volumes/methlab_data/HBN/EEG-ET/NDARWL486MKR/NDARWL486MKR_Video-DM_Samples_ET.mat, Despicable, 60, 3243618840, 3414167606, 170548766
/Volumes/methlab_data/HBN/EEG-ET/NDARWL486MKR/NDARWL486MKR_Video-FF_Samples_ET.mat, Fractals, 60, 3714390962, 3877380327, 162989365
/Volumes/methlab_data/HBN/EEG-ET/NDARWL486MKR/NDARWL486MKR_Video-TP_Samples_ET.mat, Present, 60, 4237845382, 4440915110, 203069728
/Volumes/methlab_data/HBN/EEG-ET/NDARWL486MKR/NDARWL486MKR_Video-WK_Samples_ET.mat, Diary, 60, 2719194746, 2836582831, 117388085
/Volumes/methlab_data/HBN/EEG-ET/NDARWL656URE/NDARWL656URE_Video-DM_Samples_ET.mat, Despicable, 30, 3962128094, 4132665558, 170537464
/Volumes/methlab_data/HBN/EEG-ET/NDARWL656URE/NDARWL656URE_Video-TP_Samples_ET.mat, Present, 30, 5037424565, 5240702162, 203277597
/Volumes/methlab_data/HBN/EEG-ET/NDARWL656URE/NDARWL656URE_Video-WK_Samples_ET.mat, Diary, 30, 3472363209, 3589750115, 117386906
/Volumes/methlab_data/HBN/EEG-ET/NDARWL758PAM/NDARWL758PAM_Video1_Samples_ET.mat, Diary, 120, 3828836734, 3946226237, 117389503
/Volumes/methlab_data/HBN/EEG-ET/NDARWL758PAM/NDARWL758PAM_Video2_Samples_ET.mat, Fractals, 120, 4832969980, 4995957139, 162987159
/Volumes/methlab_data/HBN/EEG-ET/NDARWL758PAM/NDARWL758PAM_Video3_Samples_ET.mat, Despicable, 120, 5480122675, 5650666009, 170543334
/Volumes/methlab_data/HBN/EEG-ET/NDARWL758PAM/NDARWL758PAM_Video4_Samples_ET.mat, Present, 120, 6222012618, 6425079153, 203066535
/Volumes/methlab_data/HBN/EEG-ET/NDARWM073AMM/NDARWM073AMM_Video-DM_Samples_ET.mat, Despicable, 60, 4014704350, 4185246980, 170542630
/Volumes/methlab_data/HBN/EEG-ET/NDARWM073AMM/NDARWM073AMM_Video-FF_Samples_ET.mat, Fractals, 60, 4380772262, 4543766564, 162994302
/Volumes/methlab_data/HBN/EEG-ET/NDARWM073AMM/NDARWM073AMM_Video-TP_Samples_ET.mat, Present, 60, 4795409509, 4998471144, 203061635
/Volumes/methlab_data/HBN/EEG-ET/NDARWM073AMM/NDARWM073AMM_Video-WK_Samples_ET.mat, Diary, 60, 4615197066, 4732590105, 117393039
/Volumes/methlab_data/HBN/EEG-ET/NDARWM319UU2/NDARWM319UU2_Video1_Samples_ET.mat, Diary, 60, 6803250047, 6920645978, 117395931
/Volumes/methlab_data/HBN/EEG-ET/NDARWM319UU2/NDARWM319UU2_Video3_Samples_ET.mat, Despicable, 60, 6289049059, 6459593486, 170544427
/Volumes/methlab_data/HBN/EEG-ET/NDARWM656UWL/NDARWM656UWL_Video1_Samples_ET.mat, Diary, 60, 3254834129, 3372231289, 117397160
/Volumes/methlab_data/HBN/EEG-ET/NDARWM656UWL/NDARWM656UWL_Video2_Samples_ET.mat, Fractals, 60, 4177136201, 4340120819, 162984618
/Volumes/methlab_data/HBN/EEG-ET/NDARWM656UWL/NDARWM656UWL_Video3_Samples_ET.mat, Despicable, 60, 4607404423, 4777948384, 170543961
/Volumes/methlab_data/HBN/EEG-ET/NDARWM656UWL/NDARWM656UWL_Video4_Samples_ET.mat, Present, 60, 5080508989, 5283580042, 203071053
/Volumes/methlab_data/HBN/EEG-ET/NDARWM683XYZ/NDARWM683XYZ_Video1_Samples_ET.mat, Diary, 60, 4321470973, 4438865964, 117394991
/Volumes/methlab_data/HBN/EEG-ET/NDARWM683XYZ/NDARWM683XYZ_Video2_Samples_ET.mat, Fractals, 60, 4832143986, 4995136255, 162992269
/Volumes/methlab_data/HBN/EEG-ET/NDARWM683XYZ/NDARWM683XYZ_Video3_Samples_ET.mat, Despicable, 60, 5256701163, 5427253749, 170552586
/Volumes/methlab_data/HBN/EEG-ET/NDARWM683XYZ/NDARWM683XYZ_Video4_Samples_ET.mat, Present, 60, 5735145417, 5938217014, 203071597
/Volumes/methlab_data/HBN/EEG-ET/NDARWM953LT0/NDARWM953LT0_Video-DM_Samples_ET.mat, Despicable, 120, 3424786832, 3595333916, 170547084
/Volumes/methlab_data/HBN/EEG-ET/NDARWM953LT0/NDARWM953LT0_Video-FF_Samples_ET.mat, Fractals, 120, 2587422756, 2750408667, 162985911
/Volumes/methlab_data/HBN/EEG-ET/NDARWM953LT0/NDARWM953LT0_Video-TP_Samples_ET.mat, Present, 120, 4389844848, 4592912265, 203067417
/Volumes/methlab_data/HBN/EEG-ET/NDARWM953LT0/NDARWM953LT0_Video-WK_Samples_ET.mat, Diary, 120, 3812753263, 3930192099, 117438836
/Volumes/methlab_data/HBN/EEG-ET/NDARWN169DHY/NDARWN169DHY_Video-DM_Samples_ET.mat, Despicable, 120, 3705387590, 3875934889, 170547299
/Volumes/methlab_data/HBN/EEG-ET/NDARWN169DHY/NDARWN169DHY_Video-FF_Samples_ET.mat, Fractals, 120, 2891523713, 3054510052, 162986339
/Volumes/methlab_data/HBN/EEG-ET/NDARWN169DHY/NDARWN169DHY_Video-TP_Samples_ET.mat, Present, 120, 4996143485, 5199209480, 203065995
/Volumes/methlab_data/HBN/EEG-ET/NDARWN169DHY/NDARWN169DHY_Video-WK_Samples_ET.mat, Diary, 120, 4301345289, 4418741860, 117396571
/Volumes/methlab_data/HBN/EEG-ET/NDARWN424BPK/NDARWN424BPK_Video1_Samples_ET.mat, Diary, 60, 1757526098, 1874917901, 117391803
/Volumes/methlab_data/HBN/EEG-ET/NDARWN424BPK/NDARWN424BPK_Video2_Samples_ET.mat, Fractals, 60, 2760000056, 2922984033, 162983977
/Volumes/methlab_data/HBN/EEG-ET/NDARWN424BPK/NDARWN424BPK_Video3_Samples_ET.mat, Despicable, 60, 3196284725, 3366831040, 170546315
/Volumes/methlab_data/HBN/EEG-ET/NDARWN424BPK/NDARWN424BPK_Video4_Samples_ET.mat, Present, 60, 3668547773, 3871620021, 203072248
/Volumes/methlab_data/HBN/EEG-ET/NDARWN580TUL/NDARWN580TUL_Video-DM_Samples_ET.mat, Despicable, 60, 2884633917, 3055176696, 170542779
/Volumes/methlab_data/HBN/EEG-ET/NDARWN580TUL/NDARWN580TUL_Video-FF_Samples_ET.mat, Fractals, 60, 3168402838, 3331396264, 162993426
/Volumes/methlab_data/HBN/EEG-ET/NDARWN580TUL/NDARWN580TUL_Video-TP_Samples_ET.mat, Present, 60, 3616435040, 3819508825, 203073785
/Volumes/methlab_data/HBN/EEG-ET/NDARWN580TUL/NDARWN580TUL_Video-WK_Samples_ET.mat, Diary, 60, 3392015149, 3509408275, 117393126
/Volumes/methlab_data/HBN/EEG-ET/NDARWN739ED2/NDARWN739ED2_Video-DM_Samples_ET.mat, Despicable, 30, 6690810871, 6861350453, 170539582
/Volumes/methlab_data/HBN/EEG-ET/NDARWN739ED2/NDARWN739ED2_Video-TP_Samples_ET.mat, Present, 30, 7156090822, 7359354565, 203263743
/Volumes/methlab_data/HBN/EEG-ET/NDARWN739ED2/NDARWN739ED2_Video-WK_Samples_ET.mat, Diary, 30, 5737302736, 5854691750, 117389014
/Volumes/methlab_data/HBN/EEG-ET/NDARWN885MGD/NDARWN885MGD_Video1_Samples_ET.mat, Diary, 60, 4863820627, 4981218658, 117398031
/Volumes/methlab_data/HBN/EEG-ET/NDARWN885MGD/NDARWN885MGD_Video2_Samples_ET.mat, Fractals, 60, 5635245206, 5798225511, 162980305
/Volumes/methlab_data/HBN/EEG-ET/NDARWN885MGD/NDARWN885MGD_Video3_Samples_ET.mat, Despicable, 60, 6123178338, 6293728951, 170550613
/Volumes/methlab_data/HBN/EEG-ET/NDARWN885MGD/NDARWN885MGD_Video4_Samples_ET.mat, Present, 60, 6591153304, 6794211935, 203058631
/Volumes/methlab_data/HBN/EEG-ET/NDARWP112TDL/NDARWP112TDL_Video-DM_Samples_ET.mat, Despicable, 60, 4896786368, 5067327068, 170540700
/Volumes/methlab_data/HBN/EEG-ET/NDARWP112TDL/NDARWP112TDL_Video-TP_Samples_ET.mat, Present, 60, 5749140514, 5952406383, 203265869
/Volumes/methlab_data/HBN/EEG-ET/NDARWP112TDL/NDARWP112TDL_Video-WK_Samples_ET.mat, Diary, 60, 5331271814, 5448662925, 117391111
/Volumes/methlab_data/HBN/EEG-ET/NDARWP157RYM/NDARWP157RYM_Video-DM_Samples_ET.mat, Despicable, 60, 5518079262, 5688621079, 170541817
/Volumes/methlab_data/HBN/EEG-ET/NDARWP157RYM/NDARWP157RYM_Video-FF_Samples_ET.mat, Fractals, 60, 6016312324, 6179305654, 162993330
/Volumes/methlab_data/HBN/EEG-ET/NDARWP157RYM/NDARWP157RYM_Video-TP_Samples_ET.mat, Present, 60, 6505839953, 6708900802, 203060849
/Volumes/methlab_data/HBN/EEG-ET/NDARWP157RYM/NDARWP157RYM_Video-WK_Samples_ET.mat, Diary, 60, 5075732948, 5193126118, 117393170
/Volumes/methlab_data/HBN/EEG-ET/NDARWP458FH7/NDARWP458FH7_Video-DM_Samples_ET.mat, Despicable, 30, 4489410520, 4659954403, 170543883
/Volumes/methlab_data/HBN/EEG-ET/NDARWP458FH7/NDARWP458FH7_Video-TP_Samples_ET.mat, Present, 30, 4990406583, 5193673645, 203267062
/Volumes/methlab_data/HBN/EEG-ET/NDARWP458FH7/NDARWP458FH7_Video-WK_Samples_ET.mat, Diary, 30, 2965206324, 3082595530, 117389206
/Volumes/methlab_data/HBN/EEG-ET/NDARWP595TE6/NDARWP595TE6_Video1_Samples_ET.mat, Diary, 60, 5757168813, 5874565958, 117397145
/Volumes/methlab_data/HBN/EEG-ET/NDARWP595TE6/NDARWP595TE6_Video3_Samples_ET.mat, Despicable, 60, 6252926993, 6423467790, 170540797
/Volumes/methlab_data/HBN/EEG-ET/NDARWP634RZL/NDARWP634RZL_Video1_Samples_ET.mat, Diary, 60, 6666170712, 6783563111, 117392399
/Volumes/methlab_data/HBN/EEG-ET/NDARWP634RZL/NDARWP634RZL_Video3_Samples_ET.mat, Despicable, 60, 6441126023, 6611672062, 170546039
/Volumes/methlab_data/HBN/EEG-ET/NDARWP675DHU/NDARWP675DHU_Video-DM_Samples_ET.mat, Despicable, 60, 4596318191, 4766855548, 170537357
/Volumes/methlab_data/HBN/EEG-ET/NDARWP675DHU/NDARWP675DHU_Video-TP_Samples_ET.mat, Present, 60, 5606886858, 5810156248, 203269390
/Volumes/methlab_data/HBN/EEG-ET/NDARWP675DHU/NDARWP675DHU_Video-WK_Samples_ET.mat, Diary, 60, 3689887962, 3807276784, 117388822
/Volumes/methlab_data/HBN/EEG-ET/NDARWP732GD1/NDARWP732GD1_Video1_Samples_ET.mat, Diary, 120, 4933002577, 5050398236, 117395659
/Volumes/methlab_data/HBN/EEG-ET/NDARWP732GD1/NDARWP732GD1_Video2_Samples_ET.mat, Despicable, 120, 6465191811, 6635738765, 170546954
/Volumes/methlab_data/HBN/EEG-ET/NDARWP732GD1/NDARWP732GD1_Video3_Samples_ET.mat, Fractals, 120, 7023240226, 7186229804, 162989578
/Volumes/methlab_data/HBN/EEG-ET/NDARWP732GD1/NDARWP732GD1_Video4_Samples_ET.mat, Present, 120, 7737390712, 7940455862, 203065150
/Volumes/methlab_data/HBN/EEG-ET/NDARWP815VUP/NDARWP815VUP_Video1_Samples_ET.mat, Diary, 60, 3254811112, 3372200254, 117389142
/Volumes/methlab_data/HBN/EEG-ET/NDARWP815VUP/NDARWP815VUP_Video2_Samples_ET.mat, Fractals, 60, 3829344863, 3992337282, 162992419
/Volumes/methlab_data/HBN/EEG-ET/NDARWP815VUP/NDARWP815VUP_Video3_Samples_ET.mat, Despicable, 60, 4282818904, 4453359673, 170540769
/Volumes/methlab_data/HBN/EEG-ET/NDARWP815VUP/NDARWP815VUP_Video4_Samples_ET.mat, Present, 60, 4792253576, 4995322367, 203068791
/Volumes/methlab_data/HBN/EEG-ET/NDARWP954GPJ/NDARWP954GPJ_Video1_Samples_ET.mat, Diary, 60, 3227345317, 3344739364, 117394047
/Volumes/methlab_data/HBN/EEG-ET/NDARWP954GPJ/NDARWP954GPJ_Video3_Samples_ET.mat, Despicable, 60, 2743976437, 2914514075, 170537638
/Volumes/methlab_data/HBN/EEG-ET/NDARWR112FNP/NDARWR112FNP_Video-DM_Samples_ET.mat, Despicable, 60, 5590607353, 5761158915, 170551562
/Volumes/methlab_data/HBN/EEG-ET/NDARWR112FNP/NDARWR112FNP_Video-FF_Samples_ET.mat, Fractals, 60, 5104684001, 5267677190, 162993189
/Volumes/methlab_data/HBN/EEG-ET/NDARWR112FNP/NDARWR112FNP_Video-WK_Samples_ET.mat, Diary, 60, 4421996562, 4539392541, 117395979
/Volumes/methlab_data/HBN/EEG-ET/NDARWR247CE1/NDARWR247CE1_Video1_Samples_ET.mat, Diary, 60, 7853244522, 7970630486, 117385964
/Volumes/methlab_data/HBN/EEG-ET/NDARWR247CE1/NDARWR247CE1_Video2_Samples_ET.mat, Fractals, 60, 8479863321, 8642847495, 162984174
/Volumes/methlab_data/HBN/EEG-ET/NDARWR247CE1/NDARWR247CE1_Video3_Samples_ET.mat, Despicable, 60, 8930099482, 9100650999, 170551517
/Volumes/methlab_data/HBN/EEG-ET/NDARWR247CE1/NDARWR247CE1_Video4_Samples_ET.mat, Present, 60, 9405545446, 9608605976, 203060530
/Volumes/methlab_data/HBN/EEG-ET/NDARWR509KGZ/NDARWR509KGZ_Video-DM_Samples_ET.mat, Despicable, 60, 3402629324, 3573169862, 170540538
/Volumes/methlab_data/HBN/EEG-ET/NDARWR509KGZ/NDARWR509KGZ_Video-FF_Samples_ET.mat, Fractals, 60, 3621261816, 3784251044, 162989228
/Volumes/methlab_data/HBN/EEG-ET/NDARWR509KGZ/NDARWR509KGZ_Video-TP_Samples_ET.mat, Present, 60, 3992875427, 4195936933, 203061506
/Volumes/methlab_data/HBN/EEG-ET/NDARWR509KGZ/NDARWR509KGZ_Video-WK_Samples_ET.mat, Diary, 60, 3826530899, 3943925853, 117394954
/Volumes/methlab_data/HBN/EEG-ET/NDARWR628EFJ/NDARWR628EFJ_Video-DM_Samples_ET.mat, Despicable, 60, 4617893462, 4788434888, 170541426
/Volumes/methlab_data/HBN/EEG-ET/NDARWR628EFJ/NDARWR628EFJ_Video-FF_Samples_ET.mat, Fractals, 60, 4190127288, 4353109434, 162982146
/Volumes/methlab_data/HBN/EEG-ET/NDARWR628EFJ/NDARWR628EFJ_Video-TP_Samples_ET.mat, Present, 60, 5105976135, 5309039569, 203063434
/Volumes/methlab_data/HBN/EEG-ET/NDARWR628EFJ/NDARWR628EFJ_Video-WK_Samples_ET.mat, Diary, 60, 3567967854, 3685356786, 117388932
/Volumes/methlab_data/HBN/EEG-ET/NDARWR732NZE/NDARWR732NZE_Video1_Samples_ET.mat, Diary, 120, 3411833085, 3529230843, 117397758
/Volumes/methlab_data/HBN/EEG-ET/NDARWR732NZE/NDARWR732NZE_Video2_Samples_ET.mat, Despicable, 120, 4575425719, 4745972139, 170546420
/Volumes/methlab_data/HBN/EEG-ET/NDARWR732NZE/NDARWR732NZE_Video3_Samples_ET.mat, Fractals, 120, 5134950950, 5297934471, 162983521
/Volumes/methlab_data/HBN/EEG-ET/NDARWR732NZE/NDARWR732NZE_Video4_Samples_ET.mat, Present, 120, 5890857560, 6093924642, 203067082
/Volumes/methlab_data/HBN/EEG-ET/NDARWR881WMX/NDARWR881WMX_Video1_Samples_ET.mat, Diary, 60, 2112271805, 2229660841, 117389036
/Volumes/methlab_data/HBN/EEG-ET/NDARWR881WMX/NDARWR881WMX_Video3_Samples_ET.mat, Despicable, 60, 3269255098, 3439802763, 170547665
/Volumes/methlab_data/HBN/EEG-ET/NDARWR888KKT/NDARWR888KKT_Video1_Samples_ET.mat, Diary, 60, 74710188786, 74827592593, 117403807
/Volumes/methlab_data/HBN/EEG-ET/NDARWR888KKT/NDARWR888KKT_Video2_Samples_ET.mat, Fractals, 60, 73507862875, 73670854853, 162991978
/Volumes/methlab_data/HBN/EEG-ET/NDARWR888KKT/NDARWR888KKT_Video3_Samples_ET.mat, Despicable, 60, 74253577769, 74424119051, 170541282
/Volumes/methlab_data/HBN/EEG-ET/NDARWR888KKT/NDARWR888KKT_Video4_Samples_ET.mat, Present, 60, 75179024398, 75382095629, 203071231
/Volumes/methlab_data/HBN/EEG-ET/NDARWT086XMF/NDARWT086XMF_Video1_Samples_ET.mat, Diary, 60, 13478552928, 13595944388, 117391460
/Volumes/methlab_data/HBN/EEG-ET/NDARWT086XMF/NDARWT086XMF_Video2_Samples_ET.mat, Fractals, 60, 14154925648, 14317916589, 162990941
/Volumes/methlab_data/HBN/EEG-ET/NDARWT086XMF/NDARWT086XMF_Video3_Samples_ET.mat, Despicable, 60, 14646042733, 14816581943, 170539210
/Volumes/methlab_data/HBN/EEG-ET/NDARWT086XMF/NDARWT086XMF_Video4_Samples_ET.mat, Present, 60, 15141068559, 15344126902, 203058343
/Volumes/methlab_data/HBN/EEG-ET/NDARWT449PUN/NDARWT449PUN_Video1_Samples_ET.mat, Diary, 60, 3892570018, 4009963558, 117393540
/Volumes/methlab_data/HBN/EEG-ET/NDARWT449PUN/NDARWT449PUN_Video3_Samples_ET.mat, Despicable, 60, 5116405545, 5286951431, 170545886
/Volumes/methlab_data/HBN/EEG-ET/NDARWT715BMK/NDARWT715BMK_Video1_Samples_ET.mat, Diary, 60, 5098693190, 5216089162, 117395972
/Volumes/methlab_data/HBN/EEG-ET/NDARWT715BMK/NDARWT715BMK_Video2_Samples_ET.mat, Fractals, 60, 3672414502, 3835396504, 162982002
/Volumes/methlab_data/HBN/EEG-ET/NDARWT715BMK/NDARWT715BMK_Video3_Samples_ET.mat, Despicable, 60, 4579155050, 4749696624, 170541574
/Volumes/methlab_data/HBN/EEG-ET/NDARWT715BMK/NDARWT715BMK_Video4_Samples_ET.mat, Present, 60, 5527569249, 5730630758, 203061509
/Volumes/methlab_data/HBN/EEG-ET/NDARWU018VDB/NDARWU018VDB_Video1_Samples_ET.mat, Fractals, 120, 7089834913, 7252831834, 162996921
/Volumes/methlab_data/HBN/EEG-ET/NDARWU018VDB/NDARWU018VDB_Video2_Samples_ET.mat, Despicable, 120, 8323636539, 8494194114, 170557575
/Volumes/methlab_data/HBN/EEG-ET/NDARWU018VDB/NDARWU018VDB_Video3_Samples_ET.mat, Diary, 120, 8909113624, 9026511405, 117397781
/Volumes/methlab_data/HBN/EEG-ET/NDARWU018VDB/NDARWU018VDB_Video4_Samples_ET.mat, Present, 120, 9603661452, 9806726899, 203065447
/Volumes/methlab_data/HBN/EEG-ET/NDARWU876CWH/NDARWU876CWH_Video-DM_Samples_ET.mat, Despicable, 120, 4365971777, 4536518287, 170546510
/Volumes/methlab_data/HBN/EEG-ET/NDARWU876CWH/NDARWU876CWH_Video-FF_Samples_ET.mat, Fractals, 120, 3563978106, 3726974481, 162996375
/Volumes/methlab_data/HBN/EEG-ET/NDARWU876CWH/NDARWU876CWH_Video-TP_Samples_ET.mat, Present, 120, 5428186042, 5631252117, 203066075
/Volumes/methlab_data/HBN/EEG-ET/NDARWU876CWH/NDARWU876CWH_Video-WK_Samples_ET.mat, Diary, 120, 4796728633, 4914126712, 117398079
/Volumes/methlab_data/HBN/EEG-ET/NDARWU936JGG/NDARWU936JGG_Video-DM_Samples_ET.mat, Despicable, 120, 5958552399, 6129092436, 170540037
/Volumes/methlab_data/HBN/EEG-ET/NDARWU936JGG/NDARWU936JGG_Video-WK_Samples_ET.mat, Diary, 120, 5300090545, 5417487825, 117397280
/Volumes/methlab_data/HBN/EEG-ET/NDARWV155PRG/NDARWV155PRG_Video1_Samples_ET.mat, Diary, 60, 2946079522, 3063472613, 117393091
/Volumes/methlab_data/HBN/EEG-ET/NDARWV155PRG/NDARWV155PRG_Video3_Samples_ET.mat, Despicable, 60, 4146228770, 4316772481, 170543711
/Volumes/methlab_data/HBN/EEG-ET/NDARWV405ZW0/NDARWV405ZW0_Video1_Samples_ET.mat, Diary, 60, 4672718256, 4790110442, 117392186
/Volumes/methlab_data/HBN/EEG-ET/NDARWV405ZW0/NDARWV405ZW0_Video3_Samples_ET.mat, Despicable, 60, 4206921316, 4377464164, 170542848
/Volumes/methlab_data/HBN/EEG-ET/NDARWV449GEM/NDARWV449GEM_Video1_Samples_ET.mat, Despicable, 120, 4396150176, 4566697071, 170546895
/Volumes/methlab_data/HBN/EEG-ET/NDARWV449GEM/NDARWV449GEM_Video2_Samples_ET.mat, Fractals, 120, 4676957366, 4839944871, 162987505
/Volumes/methlab_data/HBN/EEG-ET/NDARWV449GEM/NDARWV449GEM_Video3_Samples_ET.mat, Diary, 120, 5007405417, 5124803540, 117398123
/Volumes/methlab_data/HBN/EEG-ET/NDARWV449GEM/NDARWV449GEM_Video4_Samples_ET.mat, Present, 120, 5311364446, 5514441169, 203076723
/Volumes/methlab_data/HBN/EEG-ET/NDARWV568MEU/NDARWV568MEU_Video1_Samples_ET.mat, Diary, 60, 3526495985, 3643894867, 117398882
/Volumes/methlab_data/HBN/EEG-ET/NDARWV568MEU/NDARWV568MEU_Video2_Samples_ET.mat, Fractals, 60, 2963145335, 3126131371, 162986036
/Volumes/methlab_data/HBN/EEG-ET/NDARWV568MEU/NDARWV568MEU_Video3_Samples_ET.mat, Despicable, 60, 3963439423, 4133976839, 170537416
/Volumes/methlab_data/HBN/EEG-ET/NDARWV568MEU/NDARWV568MEU_Video4_Samples_ET.mat, Present, 60, 4477710490, 4680779863, 203069373
/Volumes/methlab_data/HBN/EEG-ET/NDARWV625CRP/NDARWV625CRP_Video1_Samples_ET.mat, Diary, 60, 5177430982, 5294828022, 117397040
/Volumes/methlab_data/HBN/EEG-ET/NDARWV625CRP/NDARWV625CRP_Video3_Samples_ET.mat, Despicable, 60, 4713247697, 4883798331, 170550634
/Volumes/methlab_data/HBN/EEG-ET/NDARWV677EFC/NDARWV677EFC_Video1_Samples_ET.mat, Diary, 60, 1959531170, 2076926897, 117395727
/Volumes/methlab_data/HBN/EEG-ET/NDARWV677EFC/NDARWV677EFC_Video3_Samples_ET.mat, Despicable, 60, 2737622410, 2908166603, 170544193
/Volumes/methlab_data/HBN/EEG-ET/NDARWV769JM7/NDARWV769JM7_Video-DM_Samples_ET.mat, Despicable, 30, 4672875528, 4843412001, 170536473
/Volumes/methlab_data/HBN/EEG-ET/NDARWV769JM7/NDARWV769JM7_Video-TP_Samples_ET.mat, Present, 30, 5163769247, 5367047833, 203278586
/Volumes/methlab_data/HBN/EEG-ET/NDARWV769JM7/NDARWV769JM7_Video-WK_Samples_ET.mat, Diary, 30, 3413349944, 3530737874, 117387930
/Volumes/methlab_data/HBN/EEG-ET/NDARWV794VM2/NDARWV794VM2_Video1_Samples_ET.mat, Diary, 60, 3600408787, 3717803677, 117394890
/Volumes/methlab_data/HBN/EEG-ET/NDARWV794VM2/NDARWV794VM2_Video2_Samples_ET.mat, Fractals, 60, 2149252440, 2312245377, 162992937
/Volumes/methlab_data/HBN/EEG-ET/NDARWV794VM2/NDARWV794VM2_Video3_Samples_ET.mat, Despicable, 60, 3104997413, 3275539724, 170542311
/Volumes/methlab_data/HBN/EEG-ET/NDARWV794VM2/NDARWV794VM2_Video4_Samples_ET.mat, Present, 60, 4060468241, 4263536515, 203068274
/Volumes/methlab_data/HBN/EEG-ET/NDARWW003WWW/NDARWW003WWW_Video1_Samples_ET.mat, Despicable, 120, 1575835379, 1656614884, 1827161529
2.513262e+08, 1.705466e+08, /Volumes/methlab_data/HBN/EEG-ET/NDARWW003WWW/NDARWW003WWW_Video2_Samples_ET.mat, Fractals, 120, 1880562853, 2043549609, 162986756
/Volumes/methlab_data/HBN/EEG-ET/NDARWW003WWW/NDARWW003WWW_Video3_Samples_ET.mat, Diary, 120, 2098921048, 2216318799, 117397751
/Volumes/methlab_data/HBN/EEG-ET/NDARWW003WWW/NDARWW003WWW_Video4_Samples_ET.mat, Present, 120, 2289069545, 2492137630, 203068085
/Volumes/methlab_data/HBN/EEG-ET/NDARWW005GCU/NDARWW005GCU_Video1_Samples_ET.mat, Diary, 120, 4439301763, 4556699038, 117397275
/Volumes/methlab_data/HBN/EEG-ET/NDARWW005GCU/NDARWW005GCU_Video2_Samples_ET.mat, Fractals, 120, 5895021141, 6058008869, 162987728
/Volumes/methlab_data/HBN/EEG-ET/NDARWW005GCU/NDARWW005GCU_Video3_Samples_ET.mat, Despicable, 120, 6387578735, 6558125731, 170546996
/Volumes/methlab_data/HBN/EEG-ET/NDARWW480TU2/NDARWW480TU2_Video1_Samples_ET.mat, Diary, 120, 3094360890, 3211750098, 117389208
/Volumes/methlab_data/HBN/EEG-ET/NDARWW480TU2/NDARWW480TU2_Video2_Samples_ET.mat, Despicable, 120, 4568074765, 4738622397, 170547632
/Volumes/methlab_data/HBN/EEG-ET/NDARWW480TU2/NDARWW480TU2_Video3_Samples_ET.mat, Fractals, 120, 5143261334, 5306249008, 162987674
/Volumes/methlab_data/HBN/EEG-ET/NDARWW480TU2/NDARWW480TU2_Video4_Samples_ET.mat, Present, 120, 5784987968, 5988055563, 203067595
/Volumes/methlab_data/HBN/EEG-ET/NDARWW820WZN/NDARWW820WZN_Video1_Samples_ET.mat, Diary, 60, 3787822573, 3905215740, 117393167
/Volumes/methlab_data/HBN/EEG-ET/NDARWW820WZN/NDARWW820WZN_Video2_Samples_ET.mat, Fractals, 60, 4506321651, 4669305521, 162983870
/Volumes/methlab_data/HBN/EEG-ET/NDARWW820WZN/NDARWW820WZN_Video3_Samples_ET.mat, Despicable, 60, 4980579649, 5151125919, 170546270
/Volumes/methlab_data/HBN/EEG-ET/NDARWW820WZN/NDARWW820WZN_Video4_Samples_ET.mat, Present, 60, 5502818059, 5705882629, 203064570
/Volumes/methlab_data/HBN/EEG-ET/NDARWW901MTC/NDARWW901MTC_Video1_Samples_ET.mat, Diary, 60, 1990429189, 2107821675, 117392486
/Volumes/methlab_data/HBN/EEG-ET/NDARWW901MTC/NDARWW901MTC_Video3_Samples_ET.mat, Despicable, 60, 3146615355, 3317154655, 170539300
/Volumes/methlab_data/HBN/EEG-ET/NDARWX033HYK/NDARWX033HYK_Video1_Samples_ET.mat, Diary, 60, 2991090791, 3108486614, 117395823
/Volumes/methlab_data/HBN/EEG-ET/NDARWX033HYK/NDARWX033HYK_Video3_Samples_ET.mat, Despicable, 60, 3889620217, 4060166454, 170546237
/Volumes/methlab_data/HBN/EEG-ET/NDARWX338NDL/NDARWX338NDL_Video1_Samples_ET.mat, Diary, 60, 3299582476, 3416977294, 117394818
/Volumes/methlab_data/HBN/EEG-ET/NDARWX338NDL/NDARWX338NDL_Video3_Samples_ET.mat, Despicable, 60, 4703562595, 4874115881, 170553286
/Volumes/methlab_data/HBN/EEG-ET/NDARWX376FTQ/NDARWX376FTQ_Video-WK_Samples_ET.mat, Diary, 60, 71743587402, 71860972275, 117384873
/Volumes/methlab_data/HBN/EEG-ET/NDARWX380JJK/NDARWX380JJK_Video1_Samples_ET.mat, Diary, 60, 2056327713, 2173720746, 117393033
/Volumes/methlab_data/HBN/EEG-ET/NDARWX380JJK/NDARWX380JJK_Video3_Samples_ET.mat, Despicable, 60, 3250241824, 3420791419, 170549595
/Volumes/methlab_data/HBN/EEG-ET/NDARWX711LBK/NDARWX711LBK_Video1_Samples_ET.mat, Diary, 60, 2893092497, 3010480950, 117388453
/Volumes/methlab_data/HBN/EEG-ET/NDARWX711LBK/NDARWX711LBK_Video2_Samples_ET.mat, Fractals, 60, 3528150853, 3691137740, 162986887
/Volumes/methlab_data/HBN/EEG-ET/NDARWX711LBK/NDARWX711LBK_Video3_Samples_ET.mat, Despicable, 60, 4047112710, 4217662951, 170550241
/Volumes/methlab_data/HBN/EEG-ET/NDARWX711LBK/NDARWX711LBK_Video4_Samples_ET.mat, Present, 60, 4511411730, 4714480103, 203068373
/Volumes/methlab_data/HBN/EEG-ET/NDARWY235XNE/NDARWY235XNE_Video1_Samples_ET.mat, Diary, 60, 4551439917, 4668833094, 117393177
/Volumes/methlab_data/HBN/EEG-ET/NDARWY235XNE/NDARWY235XNE_Video3_Samples_ET.mat, Despicable, 60, 4128885603, 4299436422, 170550819
/Volumes/methlab_data/HBN/EEG-ET/NDARWZ024UYK/NDARWZ024UYK_Video3_Samples_ET.mat, Despicable, 60, 1626674613, 1707022307, 1877568723
2.508941e+08, 1.705464e+08, /Volumes/methlab_data/HBN/EEG-ET/NDARWZ115KC6/NDARWZ115KC6_Video-DM_Samples_ET.mat, Despicable, 30, 4733378847, 4903923460, 170544613
/Volumes/methlab_data/HBN/EEG-ET/NDARWZ115KC6/NDARWZ115KC6_Video-WK_Samples_ET.mat, Diary, 30, 3563153491, 3680540508, 117387017
/Volumes/methlab_data/HBN/EEG-ET/NDARWZ346RV4/NDARWZ346RV4_Video1_Samples_ET.mat, Despicable, 120, 1492723389, 1663279711, 170556322
/Volumes/methlab_data/HBN/EEG-ET/NDARWZ495PG4/NDARWZ495PG4_Video1_Samples_ET.mat, Diary, 60, 4649622646, 4767017426, 117394780
/Volumes/methlab_data/HBN/EEG-ET/NDARWZ495PG4/NDARWZ495PG4_Video3_Samples_ET.mat, Despicable, 60, 4222531409, 4393078700, 170547291
/Volumes/methlab_data/HBN/EEG-ET/NDARWZ709DLY/NDARWZ709DLY_Video1_Samples_ET.mat, Diary, 60, 4290983350, 4408371563, 117388213
/Volumes/methlab_data/HBN/EEG-ET/NDARWZ709DLY/NDARWZ709DLY_Video3_Samples_ET.mat, Despicable, 60, 3820929034, 3991477970, 170548936
/Volumes/methlab_data/HBN/EEG-ET/NDARWZ865ZMK/NDARWZ865ZMK_Video-DM_Samples_ET.mat, Despicable, 60, 3829506199, 4000044687, 170538488
/Volumes/methlab_data/HBN/EEG-ET/NDARWZ865ZMK/NDARWZ865ZMK_Video-TP_Samples_ET.mat, Present, 60, 4867476296, 5070756955, 203280659
/Volumes/methlab_data/HBN/EEG-ET/NDARWZ865ZMK/NDARWZ865ZMK_Video-WK_Samples_ET.mat, Diary, 60, 3236512360, 3353899355, 117386995
/Volumes/methlab_data/HBN/EEG-ET/NDARWZ903DD2/NDARWZ903DD2_Video1_Samples_ET.mat, Diary, 60, 6201335381, 6318729126, 117393745
/Volumes/methlab_data/HBN/EEG-ET/NDARWZ903DD2/NDARWZ903DD2_Video2_Samples_ET.mat, Fractals, 60, 6829198146, 6992180425, 162982279
/Volumes/methlab_data/HBN/EEG-ET/NDARWZ903DD2/NDARWZ903DD2_Video3_Samples_ET.mat, Despicable, 60, 7284585910, 7455130549, 170544639
/Volumes/methlab_data/HBN/EEG-ET/NDARWZ903DD2/NDARWZ903DD2_Video4_Samples_ET.mat, Present, 60, 7831881211, 8034943036, 203061825
/Volumes/methlab_data/HBN/EEG-ET/NDARXB023AMW/NDARXB023AMW_Video-DM_Samples_ET.mat, Despicable, 60, 4122185063, 4292761557, 170576494
/Volumes/methlab_data/HBN/EEG-ET/NDARXB023AMW/NDARXB023AMW_Video-FF_Samples_ET.mat, Fractals, 60, 3674779231, 3837764312, 162985081
/Volumes/methlab_data/HBN/EEG-ET/NDARXB023AMW/NDARXB023AMW_Video-TP_Samples_ET.mat, Present, 60, 4605596330, 4808700731, 203104401
/Volumes/methlab_data/HBN/EEG-ET/NDARXB023AMW/NDARXB023AMW_Video-WK_Samples_ET.mat, Diary, 60, 3111080294, 3228476189, 117395895
/Volumes/methlab_data/HBN/EEG-ET/NDARXB286YBR/NDARXB286YBR_Video-DM_Samples_ET.mat, Despicable, 120, 3998468032, 4169014324, 170546292
/Volumes/methlab_data/HBN/EEG-ET/NDARXB286YBR/NDARXB286YBR_Video-FF_Samples_ET.mat, Fractals, 120, 3280821190, 3443808741, 162987551
/Volumes/methlab_data/HBN/EEG-ET/NDARXB286YBR/NDARXB286YBR_Video-TP_Samples_ET.mat, Present, 120, 5053431317, 5256509455, 203078138
/Volumes/methlab_data/HBN/EEG-ET/NDARXB286YBR/NDARXB286YBR_Video-WK_Samples_ET.mat, Diary, 120, 4445524684, 4562922674, 117397990
/Volumes/methlab_data/HBN/EEG-ET/NDARXB692PXC/NDARXB692PXC_Video1_Samples_ET.mat, Diary, 60, 3019377127, 3136765953, 117388826
/Volumes/methlab_data/HBN/EEG-ET/NDARXB692PXC/NDARXB692PXC_Video2_Samples_ET.mat, Fractals, 60, 3181516512, 3344507548, 162991036
/Volumes/methlab_data/HBN/EEG-ET/NDARXB692PXC/NDARXB692PXC_Video3_Samples_ET.mat, Despicable, 60, 2799956267, 2970505641, 170549374
/Volumes/methlab_data/HBN/EEG-ET/NDARXB692PXC/NDARXB692PXC_Video4_Samples_ET.mat, Present, 60, 3408440591, 3611499918, 203059327
/Volumes/methlab_data/HBN/EEG-ET/NDARXB704HFD/NDARXB704HFD_Video1_Samples_ET.mat, Diary, 60, 5647047565, 5764434562, 117386997
/Volumes/methlab_data/HBN/EEG-ET/NDARXB704HFD/NDARXB704HFD_Video3_Samples_ET.mat, Despicable, 60, 5201196501, 5371732027, 170535526
/Volumes/methlab_data/HBN/EEG-ET/NDARXB889WUB/NDARXB889WUB_Video1_Samples_ET.mat, Diary, 60, 22618710952, 22736107949, 117396997
/Volumes/methlab_data/HBN/EEG-ET/NDARXB889WUB/NDARXB889WUB_Video3_Samples_ET.mat, Despicable, 60, 22259392077, 22429935593, 170543516
/Volumes/methlab_data/HBN/EEG-ET/NDARXB992KA7/NDARXB992KA7_Video-DM_Samples_ET.mat, Despicable, 60, 19460776826, 19631312221, 170535395
/Volumes/methlab_data/HBN/EEG-ET/NDARXB992KA7/NDARXB992KA7_Video-TP_Samples_ET.mat, Present, 60, 20405242563, 20608508067, 203265504
/Volumes/methlab_data/HBN/EEG-ET/NDARXB992KA7/NDARXB992KA7_Video-WK_Samples_ET.mat, Diary, 60, 20229043168, 20346434069, 117390901
/Volumes/methlab_data/HBN/EEG-ET/NDARXC055JGA/NDARXC055JGA_Video-DM_Samples_ET.mat, Despicable, 30, 2393472914, 2564013436, 170540522
/Volumes/methlab_data/HBN/EEG-ET/NDARXC055JGA/NDARXC055JGA_Video-TP_Samples_ET.mat, Present, 30, 4065960762, 4269228424, 203267662
/Volumes/methlab_data/HBN/EEG-ET/NDARXC055JGA/NDARXC055JGA_Video-WK_Samples_ET.mat, Diary, 30, 3069746809, 3187144773, 117397964
/Volumes/methlab_data/HBN/EEG-ET/NDARXC418YG7/NDARXC418YG7_Video1_Samples_ET.mat, Diary, 60, 3412089606, 3529482654, 117393048
/Volumes/methlab_data/HBN/EEG-ET/NDARXC418YG7/NDARXC418YG7_Video3_Samples_ET.mat, Despicable, 60, 3822993256, 3993535867, 170542611
/Volumes/methlab_data/HBN/EEG-ET/NDARXC534KT4/NDARXC534KT4_Video1_Samples_ET.mat, Diary, 60, 4619196791, 4736587661, 117390870
/Volumes/methlab_data/HBN/EEG-ET/NDARXC534KT4/NDARXC534KT4_Video3_Samples_ET.mat, Despicable, 60, 4065734098, 4236284494, 170550396
/Volumes/methlab_data/HBN/EEG-ET/NDARXC826NW7/NDARXC826NW7_Video1_Samples_ET.mat, Diary, 60, 1898711415, 2016107418, 117396003
/Volumes/methlab_data/HBN/EEG-ET/NDARXC826NW7/NDARXC826NW7_Video3_Samples_ET.mat, Despicable, 60, 3199898901, 3370444473, 170545572
/Volumes/methlab_data/HBN/EEG-ET/NDARXC828NXQ/NDARXC828NXQ_Video-DM_Samples_ET.mat, Despicable, 60, 5189479443, 5360027163, 170547720
/Volumes/methlab_data/HBN/EEG-ET/NDARXC828NXQ/NDARXC828NXQ_Video-FF_Samples_ET.mat, Fractals, 60, 5649813194, 5812801537, 162988343
/Volumes/methlab_data/HBN/EEG-ET/NDARXC828NXQ/NDARXC828NXQ_Video-TP_Samples_ET.mat, Present, 60, 6216075883, 6419147631, 203071748
/Volumes/methlab_data/HBN/EEG-ET/NDARXC828NXQ/NDARXC828NXQ_Video-WK_Samples_ET.mat, Diary, 60, 4448832329, 4566222422, 117390093
/Volumes/methlab_data/HBN/EEG-ET/NDARXC878WB2/NDARXC878WB2_Video1_Samples_ET.mat, Diary, 120, 3774810539, 3892207964, 117397425
/Volumes/methlab_data/HBN/EEG-ET/NDARXC878WB2/NDARXC878WB2_Video2_Samples_ET.mat, Despicable, 120, 5520767652, 5691315325, 170547673
/Volumes/methlab_data/HBN/EEG-ET/NDARXC878WB2/NDARXC878WB2_Video3_Samples_ET.mat, Fractals, 120, 6057458517, 6220444209, 162985692
/Volumes/methlab_data/HBN/EEG-ET/NDARXC878WB2/NDARXC878WB2_Video4_Samples_ET.mat, Present, 120, 6728000105, 6931067483, 203067378
/Volumes/methlab_data/HBN/EEG-ET/NDARXD325BGG/NDARXD325BGG_Video3_Samples_ET.mat, Despicable, 60, 888001856, 1058547489, 170545633
/Volumes/methlab_data/HBN/EEG-ET/NDARXD388TTE/NDARXD388TTE_Video1_Samples_ET.mat, Despicable, 120, 3159759673, 3330301156, 170541483
/Volumes/methlab_data/HBN/EEG-ET/NDARXD388TTE/NDARXD388TTE_Video2_Samples_ET.mat, Diary, 120, 3355748599, 3473137067, 117388468
/Volumes/methlab_data/HBN/EEG-ET/NDARXD388TTE/NDARXD388TTE_Video3_Samples_ET.mat, Fractals, 120, 3491185224, 3654172806, 162987582
/Volumes/methlab_data/HBN/EEG-ET/NDARXD388TTE/NDARXD388TTE_Video4_Samples_ET.mat, Present, 120, 3675213948, 3878281436, 203067488
/Volumes/methlab_data/HBN/EEG-ET/NDARXD710RLN/NDARXD710RLN_Video1_Samples_ET.mat, Diary, 60, 2049122667, 2166516511, 117393844
/Volumes/methlab_data/HBN/EEG-ET/NDARXD710RLN/NDARXD710RLN_Video2_Samples_ET.mat, Fractals, 60, 2651273550, 2814266560, 162993010
/Volumes/methlab_data/HBN/EEG-ET/NDARXD710RLN/NDARXD710RLN_Video3_Samples_ET.mat, Despicable, 60, 3088069758, 3258610075, 170540317
/Volumes/methlab_data/HBN/EEG-ET/NDARXD710RLN/NDARXD710RLN_Video4_Samples_ET.mat, Present, 60, 3577814267, 3781153762, 203339495
/Volumes/methlab_data/HBN/EEG-ET/NDARXD907ZJL/NDARXD907ZJL_Video-DM_Samples_ET.mat, Despicable, 60, 4266103283, 4436645869, 170542586
/Volumes/methlab_data/HBN/EEG-ET/NDARXD907ZJL/NDARXD907ZJL_Video-FF_Samples_ET.mat, Fractals, 60, 3837247080, 4000233328, 162986248
/Volumes/methlab_data/HBN/EEG-ET/NDARXD907ZJL/NDARXD907ZJL_Video-TP_Samples_ET.mat, Present, 60, 4742105813, 4945167463, 203061650
/Volumes/methlab_data/HBN/EEG-ET/NDARXD907ZJL/NDARXD907ZJL_Video-WK_Samples_ET.mat, Diary, 60, 3117540249, 3234941258, 117401009
/Volumes/methlab_data/HBN/EEG-ET/NDARXD944ZXV/NDARXD944ZXV_Video1_Samples_ET.mat, Diary, 60, 4420212215, 4537605317, 117393102
/Volumes/methlab_data/HBN/EEG-ET/NDARXD944ZXV/NDARXD944ZXV_Video3_Samples_ET.mat, Despicable, 60, 3951254368, 4121797087, 170542719
/Volumes/methlab_data/HBN/EEG-ET/NDARXE069UU8/NDARXE069UU8_Video-DM_Samples_ET.mat, Despicable, 30, 2973340488, 3143879875, 170539387
/Volumes/methlab_data/HBN/EEG-ET/NDARXE069UU8/NDARXE069UU8_Video-TP_Samples_ET.mat, Present, 30, 3472865090, 3676133615, 203268525
/Volumes/methlab_data/HBN/EEG-ET/NDARXE069UU8/NDARXE069UU8_Video-WK_Samples_ET.mat, Diary, 30, 1852394159, 1969783047, 117388888
/Volumes/methlab_data/HBN/EEG-ET/NDARXE193CZ1/NDARXE193CZ1_Video1_Samples_ET.mat, Fractals, 120, 5685340675, 5848326298, 162985623
/Volumes/methlab_data/HBN/EEG-ET/NDARXE193CZ1/NDARXE193CZ1_Video2_Samples_ET.mat, Despicable, 120, 6653713775, 6824260411, 170546636
/Volumes/methlab_data/HBN/EEG-ET/NDARXE193CZ1/NDARXE193CZ1_Video3_Samples_ET.mat, Diary, 120, 7113280641, 7230678421, 117397780
/Volumes/methlab_data/HBN/EEG-ET/NDARXE193CZ1/NDARXE193CZ1_Video4_Samples_ET.mat, Present, 120, 7710357632, 7913425143, 203067511
/Volumes/methlab_data/HBN/EEG-ET/NDARXE242KMQ/NDARXE242KMQ_Video-DM_Samples_ET.mat, Despicable, 120, 2909120301, 3079665842, 170545541
/Volumes/methlab_data/HBN/EEG-ET/NDARXE242KMQ/NDARXE242KMQ_Video-FF_Samples_ET.mat, Fractals, 120, 3278795534, 3441783082, 162987548
/Volumes/methlab_data/HBN/EEG-ET/NDARXE242KMQ/NDARXE242KMQ_Video-TP_Samples_ET.mat, Present, 120, 3678373768, 3881440940, 203067172
/Volumes/methlab_data/HBN/EEG-ET/NDARXE242KMQ/NDARXE242KMQ_Video-WK_Samples_ET.mat, Diary, 120, 3476205016, 3593602784, 117397768
/Volumes/methlab_data/HBN/EEG-ET/NDARXE854EDK/NDARXE854EDK_Video-DM_Samples_ET.mat, Despicable, 120, 5753645829, 5924193279, 170547450
/Volumes/methlab_data/HBN/EEG-ET/NDARXE854EDK/NDARXE854EDK_Video-FF_Samples_ET.mat, Fractals, 120, 5076661142, 5239647387, 162986245
/Volumes/methlab_data/HBN/EEG-ET/NDARXE854EDK/NDARXE854EDK_Video-TP_Samples_ET.mat, Present, 120, 6759459421, 6962536471, 203077050
/Volumes/methlab_data/HBN/EEG-ET/NDARXE854EDK/NDARXE854EDK_Video-WK_Samples_ET.mat, Diary, 120, 6186764392, 6304161018, 117396626
/Volumes/methlab_data/HBN/EEG-ET/NDARXE912NZP/NDARXE912NZP_Video-DM_Samples_ET.mat, Despicable, 60, 5615249843, 5785793333, 170543490
/Volumes/methlab_data/HBN/EEG-ET/NDARXE912NZP/NDARXE912NZP_Video-FF_Samples_ET.mat, Fractals, 60, 6074874626, 6237858778, 162984152
/Volumes/methlab_data/HBN/EEG-ET/NDARXE912NZP/NDARXE912NZP_Video-TP_Samples_ET.mat, Present, 60, 6590768853, 6793838681, 203069828
/Volumes/methlab_data/HBN/EEG-ET/NDARXE912NZP/NDARXE912NZP_Video-WK_Samples_ET.mat, Diary, 60, 4856547680, 4973942654, 117394974
/Volumes/methlab_data/HBN/EEG-ET/NDARXF203DCD/NDARXF203DCD_Video1_Samples_ET.mat, Diary, 120, 2696488691, 2813884519, 117395828
/Volumes/methlab_data/HBN/EEG-ET/NDARXF203DCD/NDARXF203DCD_Video2_Samples_ET.mat, Fractals, 120, 4201591954, 4364575437, 162983483
/Volumes/methlab_data/HBN/EEG-ET/NDARXF203DCD/NDARXF203DCD_Video3_Samples_ET.mat, Despicable, 120, 4660373692, 4830913889, 170540197
/Volumes/methlab_data/HBN/EEG-ET/NDARXF203DCD/NDARXF203DCD_Video4_Samples_ET.mat, Present, 120, 5317281706, 5520343517, 203061811
/Volumes/methlab_data/HBN/EEG-ET/NDARXF294ME0/NDARXF294ME0_Video-DM_Samples_ET.mat, Despicable, 60, 3672880014, 3843419251, 170539237
/Volumes/methlab_data/HBN/EEG-ET/NDARXF294ME0/NDARXF294ME0_Video-TP_Samples_ET.mat, Present, 60, 4652531641, 4855807959, 203276318
/Volumes/methlab_data/HBN/EEG-ET/NDARXF294ME0/NDARXF294ME0_Video-WK_Samples_ET.mat, Diary, 60, 2727645671, 2845030437, 117384766
/Volumes/methlab_data/HBN/EEG-ET/NDARXF358XGE/NDARXF358XGE_Video1_Samples_ET.mat, Diary, 60, 2686178936, 2803572943, 117394007
/Volumes/methlab_data/HBN/EEG-ET/NDARXF358XGE/NDARXF358XGE_Video3_Samples_ET.mat, Despicable, 60, 2244322720, 2414866236, 170543516
/Volumes/methlab_data/HBN/EEG-ET/NDARXF358XGE/NDARXF358XGE_Video4_Samples_ET.mat, Present, 60, 3107695797, 3310759327, 203063530
/Volumes/methlab_data/HBN/EEG-ET/NDARXF441RHQ/NDARXF441RHQ_Video1_Samples_ET.mat, Diary, 60, 3399718222, 3517114123, 117395901
/Volumes/methlab_data/HBN/EEG-ET/NDARXF441RHQ/NDARXF441RHQ_Video3_Samples_ET.mat, Despicable, 60, 5497049791, 5667593249, 170543458
/Volumes/methlab_data/HBN/EEG-ET/NDARXF497LYF/NDARXF497LYF_Video1_Samples_ET.mat, Fractals, 120, 6949514647, 7112500218, 162985571
/Volumes/methlab_data/HBN/EEG-ET/NDARXF497LYF/NDARXF497LYF_Video2_Samples_ET.mat, Diary, 120, 7822578648, 7939975144, 117396496
/Volumes/methlab_data/HBN/EEG-ET/NDARXF497LYF/NDARXF497LYF_Video3_Samples_ET.mat, Despicable, 120, 8545844132, 8716391458, 170547326
/Volumes/methlab_data/HBN/EEG-ET/NDARXF497LYF/NDARXF497LYF_Video4_Samples_ET.mat, Present, 120, 9295505986, 9498567818, 203061832
/Volumes/methlab_data/HBN/EEG-ET/NDARXF623GEL/NDARXF623GEL_Video1_Samples_ET.mat, Diary, 60, 2363218183, 2480609262, 117391079
/Volumes/methlab_data/HBN/EEG-ET/NDARXF623GEL/NDARXF623GEL_Video3_Samples_ET.mat, Despicable, 60, 3173983890, 3344535610, 170551720
/Volumes/methlab_data/HBN/EEG-ET/NDARXF711LJ9/NDARXF711LJ9_Video-DM_Samples_ET.mat, Despicable, 60, 4416777817, 4587321651, 170543834
/Volumes/methlab_data/HBN/EEG-ET/NDARXF711LJ9/NDARXF711LJ9_Video-TP_Samples_ET.mat, Present, 60, 4912407878, 5115683920, 203276042
/Volumes/methlab_data/HBN/EEG-ET/NDARXF711LJ9/NDARXF711LJ9_Video-WK_Samples_ET.mat, Diary, 60, 3396948434, 3514336621, 117388187
/Volumes/methlab_data/HBN/EEG-ET/NDARXF860CZ7/NDARXF860CZ7_Video-DM_Samples_ET.mat, Despicable, 60, 5515909247, 5686454700, 170545453
/Volumes/methlab_data/HBN/EEG-ET/NDARXF860CZ7/NDARXF860CZ7_Video-FF_Samples_ET.mat, Fractals, 60, 4978381564, 5141361729, 162980165
/Volumes/methlab_data/HBN/EEG-ET/NDARXF860CZ7/NDARXF860CZ7_Video-TP_Samples_ET.mat, Present, 60, 6040832972, 6243892431, 203059459
/Volumes/methlab_data/HBN/EEG-ET/NDARXF860CZ7/NDARXF860CZ7_Video-WK_Samples_ET.mat, Diary, 60, 4417687577, 4535083518, 117395941
/Volumes/methlab_data/HBN/EEG-ET/NDARXF890FLA/NDARXF890FLA_Video-DM_Samples_ET.mat, Despicable, 120, 6954928595, 7125469736, 170541141
/Volumes/methlab_data/HBN/EEG-ET/NDARXF890FLA/NDARXF890FLA_Video-FF_Samples_ET.mat, Fractals, 120, 5654377812, 5817374317, 162996505
/Volumes/methlab_data/HBN/EEG-ET/NDARXF890FLA/NDARXF890FLA_Video-TP_Samples_ET.mat, Present, 120, 7582236026, 7785301889, 203065863
/Volumes/methlab_data/HBN/EEG-ET/NDARXF890FLA/NDARXF890FLA_Video-WK_Samples_ET.mat, Diary, 120, 6574311520, 6691709095, 117397575
/Volumes/methlab_data/HBN/EEG-ET/NDARXF956ZU6/NDARXF956ZU6_Video1_Samples_ET.mat, Diary, 60, 1800383866, 1917779084, 117395218
/Volumes/methlab_data/HBN/EEG-ET/NDARXF956ZU6/NDARXF956ZU6_Video3_Samples_ET.mat, Despicable, 60, 2662040522, 2832582405, 170541883
/Volumes/methlab_data/HBN/EEG-ET/NDARXG035ZVM/NDARXG035ZVM_Video-DM_Samples_ET.mat, Despicable, 60, 2522156805, 2692694558, 170537753
/Volumes/methlab_data/HBN/EEG-ET/NDARXG035ZVM/NDARXG035ZVM_Video-TP_Samples_ET.mat, Present, 60, 4110014985, 4313290917, 203275932
/Volumes/methlab_data/HBN/EEG-ET/NDARXG035ZVM/NDARXG035ZVM_Video-WK_Samples_ET.mat, Diary, 60, 3258690264, 3376080409, 117390145
/Volumes/methlab_data/HBN/EEG-ET/NDARXG108HK2/NDARXG108HK2_Video1_Samples_ET.mat, Diary, 60, 3427986980, 3545373761, 117386781
/Volumes/methlab_data/HBN/EEG-ET/NDARXG108HK2/NDARXG108HK2_Video3_Samples_ET.mat, Despicable, 60, 2594069107, 2764607364, 170538257
/Volumes/methlab_data/HBN/EEG-ET/NDARXG469XGP/NDARXG469XGP_Video1_Samples_ET.mat, Diary, 120, 3270825615, 3388221586, 117395971
/Volumes/methlab_data/HBN/EEG-ET/NDARXG469XGP/NDARXG469XGP_Video2_Samples_ET.mat, Despicable, 120, 4302357859, 4472904620, 170546761
/Volumes/methlab_data/HBN/EEG-ET/NDARXG469XGP/NDARXG469XGP_Video3_Samples_ET.mat, Fractals, 120, 4728574323, 4891562049, 162987726
/Volumes/methlab_data/HBN/EEG-ET/NDARXG469XGP/NDARXG469XGP_Video4_Samples_ET.mat, Present, 120, 5368531104, 5571598218, 203067114
/Volumes/methlab_data/HBN/EEG-ET/NDARXG530ZEL/NDARXG530ZEL_Video-DM_Samples_ET.mat, Despicable, 60, 3417220746, 3587767161, 170546415
/Volumes/methlab_data/HBN/EEG-ET/NDARXG530ZEL/NDARXG530ZEL_Video-TP_Samples_ET.mat, Present, 60, 4299261408, 4502537939, 203276531
/Volumes/methlab_data/HBN/EEG-ET/NDARXG530ZEL/NDARXG530ZEL_Video-WK_Samples_ET.mat, Diary, 60, 3878425326, 3995813216, 117387890
/Volumes/methlab_data/HBN/EEG-ET/NDARXG571WPL/NDARXG571WPL_Video1_Samples_ET.mat, Diary, 60, 4651925596, 4769317541, 117391945
/Volumes/methlab_data/HBN/EEG-ET/NDARXG571WPL/NDARXG571WPL_Video3_Samples_ET.mat, Despicable, 60, 4214202437, 4384748927, 170546490
/Volumes/methlab_data/HBN/EEG-ET/NDARXG646PM9/NDARXG646PM9_Video1_Samples_ET.mat, Diary, 60, 3377771124, 3495154200, 117383076
/Volumes/methlab_data/HBN/EEG-ET/NDARXG670HFE/NDARXG670HFE_Video1_Samples_ET.mat, Diary, 60, 4013471446, 4130864523, 117393077
/Volumes/methlab_data/HBN/EEG-ET/NDARXG670HFE/NDARXG670HFE_Video2_Samples_ET.mat, Fractals, 60, 5009467543, 5172451950, 162984407
/Volumes/methlab_data/HBN/EEG-ET/NDARXG670HFE/NDARXG670HFE_Video3_Samples_ET.mat, Despicable, 60, 4572101889, 4742646659, 170544770
/Volumes/methlab_data/HBN/EEG-ET/NDARXG670HFE/NDARXG670HFE_Video4_Samples_ET.mat, Present, 60, 5472601431, 5675675245, 203073814
/Volumes/methlab_data/HBN/EEG-ET/NDARXG710BVQ/NDARXG710BVQ_Video-DM_Samples_ET.mat, Despicable, 120, 5292942844, 5463490270, 170547426
/Volumes/methlab_data/HBN/EEG-ET/NDARXG710BVQ/NDARXG710BVQ_Video-FF_Samples_ET.mat, Fractals, 120, 4424986649, 4587975061, 162988412
/Volumes/methlab_data/HBN/EEG-ET/NDARXG710BVQ/NDARXG710BVQ_Video-TP_Samples_ET.mat, Present, 120, 6476445704, 6679512280, 203066576
/Volumes/methlab_data/HBN/EEG-ET/NDARXG710BVQ/NDARXG710BVQ_Video-WK_Samples_ET.mat, Diary, 120, 5835360019, 5952757200, 117397181
/Volumes/methlab_data/HBN/EEG-ET/NDARXG736VP9/NDARXG736VP9_Video1_Samples_ET.mat, Diary, 60, 2944989796, 3062382101, 117392305
/Volumes/methlab_data/HBN/EEG-ET/NDARXG736VP9/NDARXG736VP9_Video3_Samples_ET.mat, Despicable, 60, 2706025426, 2876567337, 170541911
/Volumes/methlab_data/HBN/EEG-ET/NDARXG799KWJ/NDARXG799KWJ_Video-DM_Samples_ET.mat, Despicable, 60, 4464346951, 4634895572, 170548621
/Volumes/methlab_data/HBN/EEG-ET/NDARXG799KWJ/NDARXG799KWJ_Video-FF_Samples_ET.mat, Fractals, 60, 4000663997, 4163651292, 162987295
/Volumes/methlab_data/HBN/EEG-ET/NDARXG799KWJ/NDARXG799KWJ_Video-TP_Samples_ET.mat, Present, 60, 4997390969, 5200450585, 203059616
/Volumes/methlab_data/HBN/EEG-ET/NDARXG799KWJ/NDARXG799KWJ_Video-WK_Samples_ET.mat, Diary, 60, 3427188388, 3544585441, 117397053
/Volumes/methlab_data/HBN/EEG-ET/NDARXG961UAB/NDARXG961UAB_Video-DM_Samples_ET.mat, Despicable, 60, 4814679299, 4985218642, 170539343
/Volumes/methlab_data/HBN/EEG-ET/NDARXG961UAB/NDARXG961UAB_Video-TP_Samples_ET.mat, Present, 60, 5307176809, 5510442237, 203265428
/Volumes/methlab_data/HBN/EEG-ET/NDARXG961UAB/NDARXG961UAB_Video-WK_Samples_ET.mat, Diary, 60, 3676733394, 3794121257, 117387863
/Volumes/methlab_data/HBN/EEG-ET/NDARXG995EV6/NDARXG995EV6_Video-DM_Samples_ET.mat, Despicable, 120, 4925689917, 5096236685, 170546768
/Volumes/methlab_data/HBN/EEG-ET/NDARXG995EV6/NDARXG995EV6_Video-FF_Samples_ET.mat, Fractals, 120, 3499218319, 3662205539, 162987220
/Volumes/methlab_data/HBN/EEG-ET/NDARXG995EV6/NDARXG995EV6_Video-TP_Samples_ET.mat, Present, 120, 5680996468, 5884062345, 203065877
/Volumes/methlab_data/HBN/EEG-ET/NDARXG995EV6/NDARXG995EV6_Video-WK_Samples_ET.mat, Diary, 120, 4375312976, 4492711078, 117398102
/Volumes/methlab_data/HBN/EEG-ET/NDARXH017ZLE/NDARXH017ZLE_Video1_Samples_ET.mat, Diary, 60, 2260764889, 2378160916, 117396027
/Volumes/methlab_data/HBN/EEG-ET/NDARXH017ZLE/NDARXH017ZLE_Video3_Samples_ET.mat, Despicable, 60, 2905851980, 3076397570, 170545590
/Volumes/methlab_data/HBN/EEG-ET/NDARXH140YZ0/NDARXH140YZ0_Video-DM_Samples_ET.mat, Despicable, 120, 5882818561, 6053365972, 170547411
/Volumes/methlab_data/HBN/EEG-ET/NDARXH140YZ0/NDARXH140YZ0_Video-FF_Samples_ET.mat, Fractals, 120, 5376241908, 5539239477, 162997569
/Volumes/methlab_data/HBN/EEG-ET/NDARXH140YZ0/NDARXH140YZ0_Video-TP_Samples_ET.mat, Present, 120, 6657814974, 6860881249, 203066275
/Volumes/methlab_data/HBN/EEG-ET/NDARXH140YZ0/NDARXH140YZ0_Video-WK_Samples_ET.mat, Diary, 120, 4067890149, 4185287263, 117397114
/Volumes/methlab_data/HBN/EEG-ET/NDARXH270TJ8/NDARXH270TJ8_Video-DM_Samples_ET.mat, Despicable, 60, 7801702025, 7972246444, 170544419
/Volumes/methlab_data/HBN/EEG-ET/NDARXH270TJ8/NDARXH270TJ8_Video-TP_Samples_ET.mat, Present, 60, 8574758756, 8778037273, 203278517
/Volumes/methlab_data/HBN/EEG-ET/NDARXH270TJ8/NDARXH270TJ8_Video-WK_Samples_ET.mat, Diary, 60, 8012785040, 8130174925, 117389885
/Volumes/methlab_data/HBN/EEG-ET/NDARXH393TMM/NDARXH393TMM_Video1_Samples_ET.mat, Diary, 60, 2484986480, 2602378461, 117391981
/Volumes/methlab_data/HBN/EEG-ET/NDARXH393TMM/NDARXH393TMM_Video2_Samples_ET.mat, Fractals, 60, 2874923028, 3037906228, 162983200
/Volumes/methlab_data/HBN/EEG-ET/NDARXH393TMM/NDARXH393TMM_Video3_Samples_ET.mat, Despicable, 60, 3335246356, 3505789860, 170543504
/Volumes/methlab_data/HBN/EEG-ET/NDARXH393TMM/NDARXH393TMM_Video4_Samples_ET.mat, Present, 60, 3808489729, 4011562271, 203072542
/Volumes/methlab_data/HBN/EEG-ET/NDARXH529MTX/NDARXH529MTX_Video-DM_Samples_ET.mat, Despicable, 120, 1745644099, 1916189905, 170545806
/Volumes/methlab_data/HBN/EEG-ET/NDARXH529MTX/NDARXH529MTX_Video-FF_Samples_ET.mat, Fractals, 120, 2247578707, 2410566312, 162987605
/Volumes/methlab_data/HBN/EEG-ET/NDARXH529MTX/NDARXH529MTX_Video-WK_Samples_ET.mat, Diary, 120, 2465358704, 2582755173, 117396469
/Volumes/methlab_data/HBN/EEG-ET/NDARXH654EPQ/NDARXH654EPQ_Video-DM_Samples_ET.mat, Despicable, 120, 6812286037, 6982832031, 170545994
/Volumes/methlab_data/HBN/EEG-ET/NDARXH654EPQ/NDARXH654EPQ_Video-FF_Samples_ET.mat, Fractals, 120, 6066336388, 6229320472, 162984084
/Volumes/methlab_data/HBN/EEG-ET/NDARXH654EPQ/NDARXH654EPQ_Video-TP_Samples_ET.mat, Present, 120, 7871739886, 8074805819, 203065933
/Volumes/methlab_data/HBN/EEG-ET/NDARXH654EPQ/NDARXH654EPQ_Video-WK_Samples_ET.mat, Diary, 120, 7273172897, 7390570468, 117397571
/Volumes/methlab_data/HBN/EEG-ET/NDARXJ468UGL/NDARXJ468UGL_Video1_Samples_ET.mat, Diary, 60, 3007743595, 3125141629, 117398034
/Volumes/methlab_data/HBN/EEG-ET/NDARXJ468UGL/NDARXJ468UGL_Video3_Samples_ET.mat, Despicable, 60, 4119587976, 4290142630, 170554654
/Volumes/methlab_data/HBN/EEG-ET/NDARXJ624ZF2/NDARXJ624ZF2_Video-DM_Samples_ET.mat, Despicable, 60, 4061393144, 4231933708, 170540564
/Volumes/methlab_data/HBN/EEG-ET/NDARXJ624ZF2/NDARXJ624ZF2_Video-FF_Samples_ET.mat, Fractals, 60, 4529097855, 4692085162, 162987307
/Volumes/methlab_data/HBN/EEG-ET/NDARXJ624ZF2/NDARXJ624ZF2_Video-TP_Samples_ET.mat, Present, 60, 5025400918, 5228468546, 203067628
/Volumes/methlab_data/HBN/EEG-ET/NDARXJ624ZF2/NDARXJ624ZF2_Video-WK_Samples_ET.mat, Diary, 60, 3245046690, 3362437736, 117391046
/Volumes/methlab_data/HBN/EEG-ET/NDARXJ696AMX/NDARXJ696AMX_Video1_Samples_ET.mat, Diary, 60, 3171754113, 3289143106, 117388993
/Volumes/methlab_data/HBN/EEG-ET/NDARXJ696AMX/NDARXJ696AMX_Video3_Samples_ET.mat, Despicable, 60, 2734433106, 2904970634, 170537528
/Volumes/methlab_data/HBN/EEG-ET/NDARXJ973GFA/NDARXJ973GFA_Video-DM_Samples_ET.mat, Despicable, 60, 2785692074, 2956563627, 170871553
/Volumes/methlab_data/HBN/EEG-ET/NDARXJ973GFA/NDARXJ973GFA_Video-TP_Samples_ET.mat, Present, 60, 4540843446, 4749639793, 208796347
/Volumes/methlab_data/HBN/EEG-ET/NDARXJ973GFA/NDARXJ973GFA_Video-WK_Samples_ET.mat, Diary, 60, 3628692873, 3746079714, 117386841
/Volumes/methlab_data/HBN/EEG-ET/NDARXK009VGV/NDARXK009VGV_Video1_Samples_ET.mat, Fractals, 120, 5765725170, 5928712068, 162986898
/Volumes/methlab_data/HBN/EEG-ET/NDARXK009VGV/NDARXK009VGV_Video2_Samples_ET.mat, Despicable, 120, 6916960553, 7087515062, 170554509
/Volumes/methlab_data/HBN/EEG-ET/NDARXK009VGV/NDARXK009VGV_Video3_Samples_ET.mat, Diary, 120, 7409225063, 7526622748, 117397685
/Volumes/methlab_data/HBN/EEG-ET/NDARXK009VGV/NDARXK009VGV_Video4_Samples_ET.mat, Present, 120, 8107059529, 8310120837, 203061308
/Volumes/methlab_data/HBN/EEG-ET/NDARXK076XU8/NDARXK076XU8_Video1_Samples_ET.mat, Diary, 120, 3335184292, 3452580262, 117395970
/Volumes/methlab_data/HBN/EEG-ET/NDARXK076XU8/NDARXK076XU8_Video2_Samples_ET.mat, Fractals, 120, 4754894599, 4917882206, 162987607
/Volumes/methlab_data/HBN/EEG-ET/NDARXK076XU8/NDARXK076XU8_Video3_Samples_ET.mat, Despicable, 120, 5344552010, 5515099140, 170547130
/Volumes/methlab_data/HBN/EEG-ET/NDARXK076XU8/NDARXK076XU8_Video4_Samples_ET.mat, Present, 120, 6082285499, 6285352895, 203067396
/Volumes/methlab_data/HBN/EEG-ET/NDARXK164TNN/NDARXK164TNN_Video1_Samples_ET.mat, Diary, 120, 5110027157, 5227424543, 117397386
/Volumes/methlab_data/HBN/EEG-ET/NDARXK164TNN/NDARXK164TNN_Video2_Samples_ET.mat, Fractals, 120, 7413891440, 7576879541, 162988101
/Volumes/methlab_data/HBN/EEG-ET/NDARXK164TNN/NDARXK164TNN_Video3_Samples_ET.mat, Despicable, 120, 8051828077, 8222374453, 170546376
/Volumes/methlab_data/HBN/EEG-ET/NDARXK303DDB/NDARXK303DDB_Video-DM_Samples_ET.mat, Despicable, 120, 2202902840, 2373450095, 170547255
/Volumes/methlab_data/HBN/EEG-ET/NDARXK303DDB/NDARXK303DDB_Video-FF_Samples_ET.mat, Fractals, 120, 2612709332, 2775707063, 162997731
/Volumes/methlab_data/HBN/EEG-ET/NDARXK303DDB/NDARXK303DDB_Video-TP_Samples_ET.mat, Present, 120, 3098373648, 3301444066, 203070418
/Volumes/methlab_data/HBN/EEG-ET/NDARXK303DDB/NDARXK303DDB_Video-WK_Samples_ET.mat, Diary, 120, 2851997529, 2969395360, 117397831
/Volumes/methlab_data/HBN/EEG-ET/NDARXK462WRZ/NDARXK462WRZ_Video1_Samples_ET.mat, Diary, 60, 4069565803, 4186958818, 117393015
/Volumes/methlab_data/HBN/EEG-ET/NDARXK462WRZ/NDARXK462WRZ_Video3_Samples_ET.mat, Despicable, 60, 3846831361, 4017383921, 170552560
/Volumes/methlab_data/HBN/EEG-ET/NDARXK893KLX/NDARXK893KLX_Video-DM_Samples_ET.mat, Despicable, 30, 4191802157, 4362338758, 170536601
/Volumes/methlab_data/HBN/EEG-ET/NDARXK893KLX/NDARXK893KLX_Video-TP_Samples_ET.mat, Present, 30, 5102922318, 5306205077, 203282759
/Volumes/methlab_data/HBN/EEG-ET/NDARXK893KLX/NDARXK893KLX_Video-WK_Samples_ET.mat, Diary, 30, 3426767276, 3544155282, 117388006
/Volumes/methlab_data/HBN/EEG-ET/NDARXK986EK6/NDARXK986EK6_Video1_Samples_ET.mat, Diary, 60, 5212016064, 5329408922, 117392858
/Volumes/methlab_data/HBN/EEG-ET/NDARXK986EK6/NDARXK986EK6_Video2_Samples_ET.mat, Fractals, 60, 3810383120, 3973369122, 162986002
/Volumes/methlab_data/HBN/EEG-ET/NDARXK986EK6/NDARXK986EK6_Video3_Samples_ET.mat, Despicable, 60, 4737104016, 4907643313, 170539297
/Volumes/methlab_data/HBN/EEG-ET/NDARXK986EK6/NDARXK986EK6_Video4_Samples_ET.mat, Present, 60, 5729125919, 5932196224, 203070305
/Volumes/methlab_data/HBN/EEG-ET/NDARXL023GFG/NDARXL023GFG_Video1_Samples_ET.mat, Diary, 120, 2858243247, 2975639992, 117396745
/Volumes/methlab_data/HBN/EEG-ET/NDARXL023GFG/NDARXL023GFG_Video2_Samples_ET.mat, Fractals, 120, 3523468992, 3686455733, 162986741
/Volumes/methlab_data/HBN/EEG-ET/NDARXL023GFG/NDARXL023GFG_Video3_Samples_ET.mat, Despicable, 120, 3991841575, 4162385502, 170543927
/Volumes/methlab_data/HBN/EEG-ET/NDARXL023GFG/NDARXL023GFG_Video4_Samples_ET.mat, Present, 120, 4771857684, 4934840302, 162982618
/Volumes/methlab_data/HBN/EEG-ET/NDARXL023NG9/NDARXL023NG9_Video1_Samples_ET.mat, Diary, 60, 4578408967, 4695798995, 117390028
/Volumes/methlab_data/HBN/EEG-ET/NDARXL023NG9/NDARXL023NG9_Video3_Samples_ET.mat, Despicable, 60, 3978783034, 4149324638, 170541604
/Volumes/methlab_data/HBN/EEG-ET/NDARXL023NG9/NDARXL023NG9_Video4_Samples_ET.mat, Present, 60, 5042501117, 5245559683, 203058566
/Volumes/methlab_data/HBN/EEG-ET/NDARXL523GHX/NDARXL523GHX_Video1_Samples_ET.mat, Fractals, 120, 3354261721, 3819515200, 3982499045
6.282373e+08, 1.629838e+08, /Volumes/methlab_data/HBN/EEG-ET/NDARXL523GHX/NDARXL523GHX_Video2_Samples_ET.mat, Despicable, 120, 5383028984, 5553586248, 170557264
/Volumes/methlab_data/HBN/EEG-ET/NDARXL523GHX/NDARXL523GHX_Video3_Samples_ET.mat, Diary, 120, 5846907373, 5964299222, 117391849
/Volumes/methlab_data/HBN/EEG-ET/NDARXL534AZA/NDARXL534AZA_Video-DM_Samples_ET.mat, Despicable, 60, 5200112693, 5370650117, 170537424
/Volumes/methlab_data/HBN/EEG-ET/NDARXL534AZA/NDARXL534AZA_Video-TP_Samples_ET.mat, Present, 60, 6064774089, 6268055596, 203281507
/Volumes/methlab_data/HBN/EEG-ET/NDARXL534AZA/NDARXL534AZA_Video-WK_Samples_ET.mat, Diary, 60, 4215824828, 4333213745, 117388917
/Volumes/methlab_data/HBN/EEG-ET/NDARXL801JVG/NDARXL801JVG_Video-DM_Samples_ET.mat, Despicable, 30, 4122463609, 4293004752, 170541143
/Volumes/methlab_data/HBN/EEG-ET/NDARXL801JVG/NDARXL801JVG_Video-TP_Samples_ET.mat, Present, 30, 4659209714, 4862487067, 203277353
/Volumes/methlab_data/HBN/EEG-ET/NDARXL801JVG/NDARXL801JVG_Video-WK_Samples_ET.mat, Diary, 30, 2898844805, 3016238174, 117393369
/Volumes/methlab_data/HBN/EEG-ET/NDARXM200CFE/NDARXM200CFE_Video-DM_Samples_ET.mat, Despicable, 120, 5547096738, 5717652373, 170555635
/Volumes/methlab_data/HBN/EEG-ET/NDARXM200CFE/NDARXM200CFE_Video-FF_Samples_ET.mat, Fractals, 120, 4551692870, 4714679332, 162986462
/Volumes/methlab_data/HBN/EEG-ET/NDARXM200CFE/NDARXM200CFE_Video-TP_Samples_ET.mat, Present, 120, 6843634664, 7046697553, 203062889
/Volumes/methlab_data/HBN/EEG-ET/NDARXM200CFE/NDARXM200CFE_Video-WK_Samples_ET.mat, Diary, 120, 6139533628, 6256930540, 117396912
/Volumes/methlab_data/HBN/EEG-ET/NDARXM398VU8/NDARXM398VU8_Video1_Samples_ET.mat, Diary, 60, 2630987200, 2748344168, 117356968
/Volumes/methlab_data/HBN/EEG-ET/NDARXM398VU8/NDARXM398VU8_Video3_Samples_ET.mat, Despicable, 60, 3350867896, 3521406755, 170538859
/Volumes/methlab_data/HBN/EEG-ET/NDARXM571XCC/NDARXM571XCC_Video1_Samples_ET.mat, Diary, 60, 1576775785, 1694166838, 117391053
/Volumes/methlab_data/HBN/EEG-ET/NDARXM571XCC/NDARXM571XCC_Video3_Samples_ET.mat, Despicable, 60, 2818361332, 2988906036, 170544704
/Volumes/methlab_data/HBN/EEG-ET/NDARXM571XCC/NDARXM571XCC_Video4_Samples_ET.mat, Present, 60, 3286536615, 3489606336, 203069721
/Volumes/methlab_data/HBN/EEG-ET/NDARXN047RUT/NDARXN047RUT_Video1_Samples_ET.mat, Despicable, 120, 7254848681, 7425393834, 170545153
/Volumes/methlab_data/HBN/EEG-ET/NDARXN047RUT/NDARXN047RUT_Video2_Samples_ET.mat, Diary, 120, 7889083700, 8006480254, 117396554
/Volumes/methlab_data/HBN/EEG-ET/NDARXN047RUT/NDARXN047RUT_Video3_Samples_ET.mat, Fractals, 120, 8089261896, 8252245905, 162984009
/Volumes/methlab_data/HBN/EEG-ET/NDARXN140AZE/NDARXN140AZE_Video1_Samples_ET.mat, Diary, 60, 3031810464, 3149199432, 117388968
/Volumes/methlab_data/HBN/EEG-ET/NDARXN719LXU/NDARXN719LXU_Video1_Samples_ET.mat, Diary, 60, 2418891305, 2536283142, 117391837
/Volumes/methlab_data/HBN/EEG-ET/NDARXN719LXU/NDARXN719LXU_Video3_Samples_ET.mat, Despicable, 60, 3618679839, 3789219188, 170539349
/Volumes/methlab_data/HBN/EEG-ET/NDARXN764AC7/NDARXN764AC7_Video1_Samples_ET.mat, Diary, 60, 2890589762, 3007983736, 117393974
/Volumes/methlab_data/HBN/EEG-ET/NDARXN764AC7/NDARXN764AC7_Video2_Samples_ET.mat, Fractals, 60, 3696562286, 3859555473, 162993187
/Volumes/methlab_data/HBN/EEG-ET/NDARXN764AC7/NDARXN764AC7_Video3_Samples_ET.mat, Despicable, 60, 4115870586, 4286411134, 170540548
/Volumes/methlab_data/HBN/EEG-ET/NDARXN764AC7/NDARXN764AC7_Video4_Samples_ET.mat, Present, 60, 4585651546, 4788723072, 203071526
/Volumes/methlab_data/HBN/EEG-ET/NDARXN893UEZ/NDARXN893UEZ_Video-DM_Samples_ET.mat, Despicable, 120, 2362339553, 2532894942, 170555389
/Volumes/methlab_data/HBN/EEG-ET/NDARXN893UEZ/NDARXN893UEZ_Video-FF_Samples_ET.mat, Fractals, 120, 2803294878, 2966281708, 162986830
/Volumes/methlab_data/HBN/EEG-ET/NDARXN893UEZ/NDARXN893UEZ_Video-TP_Samples_ET.mat, Present, 120, 3003833367, 3206900406, 203067039
/Volumes/methlab_data/HBN/EEG-ET/NDARXN893UEZ/NDARXN893UEZ_Video-WK_Samples_ET.mat, Diary, 120, 2611546311, 2728943477, 117397166
/Volumes/methlab_data/HBN/EEG-ET/NDARXP021FZ5/NDARXP021FZ5_Video-DM_Samples_ET.mat, Despicable, 60, 21722133766, 21892668946, 170535180
/Volumes/methlab_data/HBN/EEG-ET/NDARXP021FZ5/NDARXP021FZ5_Video-TP_Samples_ET.mat, Present, 60, 22269608511, 22472884767, 203276256
/Volumes/methlab_data/HBN/EEG-ET/NDARXP021FZ5/NDARXP021FZ5_Video-WK_Samples_ET.mat, Diary, 60, 20602845117, 20720232838, 117387721
/Volumes/methlab_data/HBN/EEG-ET/NDARXP557DLJ/NDARXP557DLJ_Video1_Samples_ET.mat, Diary, 60, 6388956062, 6506350754, 117394692
/Volumes/methlab_data/HBN/EEG-ET/NDARXP557DLJ/NDARXP557DLJ_Video2_Samples_ET.mat, Fractals, 60, 6908093254, 7071086491, 162993237
/Volumes/methlab_data/HBN/EEG-ET/NDARXP557DLJ/NDARXP557DLJ_Video3_Samples_ET.mat, Despicable, 60, 7333381531, 7503924176, 170542645
/Volumes/methlab_data/HBN/EEG-ET/NDARXP557DLJ/NDARXP557DLJ_Video4_Samples_ET.mat, Present, 60, 7970972235, 8174048080, 203075845
/Volumes/methlab_data/HBN/EEG-ET/NDARXP717YMH/NDARXP717YMH_Video1_Samples_ET.mat, Fractals, 120, 6465891257, 6628877444, 162986187
/Volumes/methlab_data/HBN/EEG-ET/NDARXP717YMH/NDARXP717YMH_Video2_Samples_ET.mat, Despicable, 120, 7167178241, 7337724936, 170546695
/Volumes/methlab_data/HBN/EEG-ET/NDARXP717YMH/NDARXP717YMH_Video3_Samples_ET.mat, Diary, 120, 7689542553, 7806939926, 117397373
/Volumes/methlab_data/HBN/EEG-ET/NDARXP717YMH/NDARXP717YMH_Video4_Samples_ET.mat, Present, 120, 8346488176, 8549555488, 203067312
/Volumes/methlab_data/HBN/EEG-ET/NDARXR123PFR/NDARXR123PFR_Video1_Samples_ET.mat, Diary, 120, 4442920970, 4560311324, 117390354
/Volumes/methlab_data/HBN/EEG-ET/NDARXR123PFR/NDARXR123PFR_Video2_Samples_ET.mat, Despicable, 120, 5443856753, 5614400952, 170544199
/Volumes/methlab_data/HBN/EEG-ET/NDARXR123PFR/NDARXR123PFR_Video3_Samples_ET.mat, Fractals, 120, 6064478722, 6227466056, 162987334
/Volumes/methlab_data/HBN/EEG-ET/NDARXR123PFR/NDARXR123PFR_Video4_Samples_ET.mat, Present, 120, 6706264910, 6909332899, 203067989
/Volumes/methlab_data/HBN/EEG-ET/NDARXR250LW3/NDARXR250LW3_Video-FF_Samples_ET.mat, Fractals, 60, 3906182286, 4069174474, 162992188
/Volumes/methlab_data/HBN/EEG-ET/NDARXR250LW3/NDARXR250LW3_Video-TP_Samples_ET.mat, Present, 60, 6358174991, 6561238496, 203063505
/Volumes/methlab_data/HBN/EEG-ET/NDARXR389XA1/NDARXR389XA1_Video-DM_Samples_ET.mat, Despicable, 120, 19082502045, 19253049192, 170547147
/Volumes/methlab_data/HBN/EEG-ET/NDARXR389XA1/NDARXR389XA1_Video-FF_Samples_ET.mat, Fractals, 120, 18641932927, 18804916525, 162983598
/Volumes/methlab_data/HBN/EEG-ET/NDARXR389XA1/NDARXR389XA1_Video-TP_Samples_ET.mat, Present, 120, 19797289729, 20000350953, 203061224
/Volumes/methlab_data/HBN/EEG-ET/NDARXR389XA1/NDARXR389XA1_Video-WK_Samples_ET.mat, Diary, 120, 17640511867, 17757900345, 117388478
/Volumes/methlab_data/HBN/EEG-ET/NDARXR637JER/NDARXR637JER_Video1_Samples_ET.mat, Fractals, 120, 3390694239, 3553679484, 162985245
/Volumes/methlab_data/HBN/EEG-ET/NDARXR637JER/NDARXR637JER_Video2_Samples_ET.mat, Despicable, 120, 4089698722, 4260239973, 170541251
/Volumes/methlab_data/HBN/EEG-ET/NDARXR637JER/NDARXR637JER_Video3_Samples_ET.mat, Diary, 120, 4882023488, 4999415167, 117391679
/Volumes/methlab_data/HBN/EEG-ET/NDARXR637JER/NDARXR637JER_Video4_Samples_ET.mat, Present, 120, 6081095679, 6284162363, 203066684
/Volumes/methlab_data/HBN/EEG-ET/NDARXR965TFK/NDARXR965TFK_Video1_Samples_ET.mat, Diary, 120, 3091814160, 3209201588, 117387428
/Volumes/methlab_data/HBN/EEG-ET/NDARXR965TFK/NDARXR965TFK_Video2_Samples_ET.mat, Fractals, 120, 4012386568, 4175374592, 162988024
/Volumes/methlab_data/HBN/EEG-ET/NDARXR965TFK/NDARXR965TFK_Video3_Samples_ET.mat, Despicable, 120, 4537574093, 4708131162, 170557069
/Volumes/methlab_data/HBN/EEG-ET/NDARXR965TFK/NDARXR965TFK_Video4_Samples_ET.mat, Present, 120, 5190419677, 5393486995, 203067318
/Volumes/methlab_data/HBN/EEG-ET/NDARXT196WPG/NDARXT196WPG_Video-DM_Samples_ET.mat, Despicable, 30, 8455034509, 8625574114, 170539605
/Volumes/methlab_data/HBN/EEG-ET/NDARXT196WPG/NDARXT196WPG_Video-WK_Samples_ET.mat, Diary, 30, 7175540515, 7292928583, 117388068
/Volumes/methlab_data/HBN/EEG-ET/NDARXT222XYH/NDARXT222XYH_Video1_Samples_ET.mat, Diary, 60, 4876759177, 4994156257, 117397080
/Volumes/methlab_data/HBN/EEG-ET/NDARXT222XYH/NDARXT222XYH_Video2_Samples_ET.mat, Fractals, 60, 3788835775, 3951820024, 162984249
/Volumes/methlab_data/HBN/EEG-ET/NDARXT222XYH/NDARXT222XYH_Video3_Samples_ET.mat, Despicable, 60, 4426597809, 4597145456, 170547647
/Volumes/methlab_data/HBN/EEG-ET/NDARXT222XYH/NDARXT222XYH_Video4_Samples_ET.mat, Present, 60, 5336903630, 5539964271, 203060641
/Volumes/methlab_data/HBN/EEG-ET/NDARXT256RNV/NDARXT256RNV_Video1_Samples_ET.mat, Diary, 60, 2827663256, 2945057336, 117394080
/Volumes/methlab_data/HBN/EEG-ET/NDARXT256RNV/NDARXT256RNV_Video3_Samples_ET.mat, Despicable, 60, 2560392126, 2730939857, 170547731
/Volumes/methlab_data/HBN/EEG-ET/NDARXT256RNV/NDARXT256RNV_Video4_Samples_ET.mat, Present, 60, 3279630101, 3482690799, 203060698
/Volumes/methlab_data/HBN/EEG-ET/NDARXT325FV6/NDARXT325FV6_Video1_Samples_ET.mat, Diary, 60, 972810481, 1090206556, 117396075
/Volumes/methlab_data/HBN/EEG-ET/NDARXT325FV6/NDARXT325FV6_Video3_Samples_ET.mat, Despicable, 60, 519719016, 690261680, 170542664
/Volumes/methlab_data/HBN/EEG-ET/NDARXT792GY8/NDARXT792GY8_Video1_Samples_ET.mat, Diary, 60, 6462280325, 6579677222, 117396897
/Volumes/methlab_data/HBN/EEG-ET/NDARXT792GY8/NDARXT792GY8_Video3_Samples_ET.mat, Despicable, 60, 6848748239, 7019301749, 170553510
/Volumes/methlab_data/HBN/EEG-ET/NDARXU018RGY/NDARXU018RGY_Video1_Samples_ET.mat, Diary, 60, 4372809723, 4490208845, 117399122
/Volumes/methlab_data/HBN/EEG-ET/NDARXU018RGY/NDARXU018RGY_Video3_Samples_ET.mat, Despicable, 60, 3777696394, 3948243172, 170546778
/Volumes/methlab_data/HBN/EEG-ET/NDARXU253JHC/NDARXU253JHC_Video1_Samples_ET.mat, Diary, 60, 4058890786, 4176275713, 117384927
/Volumes/methlab_data/HBN/EEG-ET/NDARXU253JHC/NDARXU253JHC_Video3_Samples_ET.mat, Despicable, 60, 3642056397, 3812606011, 170549614
/Volumes/methlab_data/HBN/EEG-ET/NDARXU376FDN/NDARXU376FDN_Video-DM_Samples_ET.mat, Despicable, 120, 4657736171, 4828292451, 170556280
/Volumes/methlab_data/HBN/EEG-ET/NDARXU376FDN/NDARXU376FDN_Video-FF_Samples_ET.mat, Fractals, 120, 4885362751, 5048360605, 162997854
/Volumes/methlab_data/HBN/EEG-ET/NDARXU376FDN/NDARXU376FDN_Video-TP_Samples_ET.mat, Present, 120, 5287120608, 5490187645, 203067037
/Volumes/methlab_data/HBN/EEG-ET/NDARXU376FDN/NDARXU376FDN_Video-WK_Samples_ET.mat, Diary, 120, 5124136270, 5241526844, 117390574
/Volumes/methlab_data/HBN/EEG-ET/NDARXU679ZE8/NDARXU679ZE8_Video1_Samples_ET.mat, Diary, 60, 2724970355, 2842359483, 117389128
/Volumes/methlab_data/HBN/EEG-ET/NDARXU679ZE8/NDARXU679ZE8_Video3_Samples_ET.mat, Despicable, 60, 4346388304, 4516925057, 170536753
/Volumes/methlab_data/HBN/EEG-ET/NDARXU715EGL/NDARXU715EGL_Video1_Samples_ET.mat, Diary, 60, 2660809770, 2778187646, 117377876
/Volumes/methlab_data/HBN/EEG-ET/NDARXU715EGL/NDARXU715EGL_Video3_Samples_ET.mat, Despicable, 60, 2192519533, 2363062152, 170542619
/Volumes/methlab_data/HBN/EEG-ET/NDARXU883NMY/NDARXU883NMY_Video-DM_Samples_ET.mat, Despicable, 60, 4842956831, 5013497372, 170540541
/Volumes/methlab_data/HBN/EEG-ET/NDARXU883NMY/NDARXU883NMY_Video-FF_Samples_ET.mat, Fractals, 60, 4032966461, 4195952655, 162986194
/Volumes/methlab_data/HBN/EEG-ET/NDARXU883NMY/NDARXU883NMY_Video-TP_Samples_ET.mat, Present, 60, 5966874056, 6169945589, 203071533
/Volumes/methlab_data/HBN/EEG-ET/NDARXU883NMY/NDARXU883NMY_Video-WK_Samples_ET.mat, Diary, 60, 5406472075, 5523863017, 117390942
/Volumes/methlab_data/HBN/EEG-ET/NDARXU902BRT/NDARXU902BRT_Video1_Samples_ET.mat, Diary, 60, 3492028519, 3609420309, 117391790
/Volumes/methlab_data/HBN/EEG-ET/NDARXU902BRT/NDARXU902BRT_Video3_Samples_ET.mat, Despicable, 60, 3040964553, 3211504789, 170540236
/Volumes/methlab_data/HBN/EEG-ET/NDARXU995GAJ/NDARXU995GAJ_Video-DM_Samples_ET.mat, Despicable, 120, 5907964074, 6078511187, 170547113
/Volumes/methlab_data/HBN/EEG-ET/NDARXU995GAJ/NDARXU995GAJ_Video-FF_Samples_ET.mat, Fractals, 120, 5478482592, 5641468667, 162986075
/Volumes/methlab_data/HBN/EEG-ET/NDARXU995GAJ/NDARXU995GAJ_Video-TP_Samples_ET.mat, Present, 120, 6537350767, 6740426485, 203075718
/Volumes/methlab_data/HBN/EEG-ET/NDARXU995GAJ/NDARXU995GAJ_Video-WK_Samples_ET.mat, Diary, 120, 4718804812, 4836192695, 117387883
/Volumes/methlab_data/HBN/EEG-ET/NDARXV034WE0/NDARXV034WE0_Video1_Samples_ET.mat, Fractals, 120, 3439387189, 3602373730, 162986541
/Volumes/methlab_data/HBN/EEG-ET/NDARXV034WE0/NDARXV034WE0_Video2_Samples_ET.mat, Despicable, 120, 4236060578, 4406607943, 170547365
/Volumes/methlab_data/HBN/EEG-ET/NDARXV034WE0/NDARXV034WE0_Video3_Samples_ET.mat, Diary, 120, 4769868461, 4887264998, 117396537
/Volumes/methlab_data/HBN/EEG-ET/NDARXV034WE0/NDARXV034WE0_Video4_Samples_ET.mat, Present, 120, 5440564568, 5643630980, 203066412
/Volumes/methlab_data/HBN/EEG-ET/NDARXV094ZHH/NDARXV094ZHH_Video1_Samples_ET.mat, Fractals, 120, 4673709299, 4836706130, 162996831
/Volumes/methlab_data/HBN/EEG-ET/NDARXV094ZHH/NDARXV094ZHH_Video2_Samples_ET.mat, Diary, 120, 5514199887, 5631590700, 117390813
/Volumes/methlab_data/HBN/EEG-ET/NDARXV094ZHH/NDARXV094ZHH_Video3_Samples_ET.mat, Despicable, 120, 6022239317, 6192787151, 170547834
/Volumes/methlab_data/HBN/EEG-ET/NDARXV094ZHH/NDARXV094ZHH_Video4_Samples_ET.mat, Present, 120, 6837175041, 7040242376, 203067335
/Volumes/methlab_data/HBN/EEG-ET/NDARXV209WYA/NDARXV209WYA_Video-DM_Samples_ET.mat, Despicable, 60, 3308711415, 3479280939, 170569524
/Volumes/methlab_data/HBN/EEG-ET/NDARXV209WYA/NDARXV209WYA_Video-FF_Samples_ET.mat, Fractals, 60, 2493202441, 2656192564, 162990123
/Volumes/methlab_data/HBN/EEG-ET/NDARXV209WYA/NDARXV209WYA_Video-TP_Samples_ET.mat, Present, 60, 3933160455, 4136221905, 203061450
/Volumes/methlab_data/HBN/EEG-ET/NDARXV209WYA/NDARXV209WYA_Video-WK_Samples_ET.mat, Diary, 60, 1838517037, 1955907964, 117390927
/Volumes/methlab_data/HBN/EEG-ET/NDARXV291ATY/NDARXV291ATY_Video-DM_Samples_ET.mat, Despicable, 30, 5903690164, 6074231760, 170541596
/Volumes/methlab_data/HBN/EEG-ET/NDARXV291ATY/NDARXV291ATY_Video-TP_Samples_ET.mat, Present, 30, 6436915150, 6640191885, 203276735
/Volumes/methlab_data/HBN/EEG-ET/NDARXV291ATY/NDARXV291ATY_Video-WK_Samples_ET.mat, Diary, 30, 4461502536, 4578965595, 117463059
/Volumes/methlab_data/HBN/EEG-ET/NDARXV294YRJ/NDARXV294YRJ_Video1_Samples_ET.mat, Fractals, 120, 23844190179, 24007175292, 162985113
/Volumes/methlab_data/HBN/EEG-ET/NDARXV294YRJ/NDARXV294YRJ_Video2_Samples_ET.mat, Despicable, 120, 24603744107, 24774291412, 170547305
/Volumes/methlab_data/HBN/EEG-ET/NDARXV294YRJ/NDARXV294YRJ_Video3_Samples_ET.mat, Diary, 120, 25065951612, 25183349273, 117397661
/Volumes/methlab_data/HBN/EEG-ET/NDARXV294YRJ/NDARXV294YRJ_Video4_Samples_ET.mat, Present, 120, 25645618488, 25848685620, 203067132
/Volumes/methlab_data/HBN/EEG-ET/NDARXV445NYZ/NDARXV445NYZ_Video1_Samples_ET.mat, Diary, 60, 4615091448, 4732486386, 117394938
/Volumes/methlab_data/HBN/EEG-ET/NDARXV445NYZ/NDARXV445NYZ_Video3_Samples_ET.mat, Despicable, 60, 4176156433, 4346705899, 170549466
/Volumes/methlab_data/HBN/EEG-ET/NDARXV702MYC/NDARXV702MYC_Video-DM_Samples_ET.mat, Despicable, 60, 7752735979, 7923283466, 170547487
/Volumes/methlab_data/HBN/EEG-ET/NDARXV702MYC/NDARXV702MYC_Video-TP_Samples_ET.mat, Present, 60, 8676666832, 8879945513, 203278681
/Volumes/methlab_data/HBN/EEG-ET/NDARXV702MYC/NDARXV702MYC_Video-WK_Samples_ET.mat, Diary, 60, 7093140837, 7210528816, 117387979
/Volumes/methlab_data/HBN/EEG-ET/NDARXW045HPY/NDARXW045HPY_Video-DM_Samples_ET.mat, Despicable, 120, 4206012125, 4376559795, 170547670
/Volumes/methlab_data/HBN/EEG-ET/NDARXW045HPY/NDARXW045HPY_Video-FF_Samples_ET.mat, Fractals, 120, 3672276237, 3835262824, 162986587
/Volumes/methlab_data/HBN/EEG-ET/NDARXW045HPY/NDARXW045HPY_Video-TP_Samples_ET.mat, Present, 120, 4986287320, 5189354751, 203067431
/Volumes/methlab_data/HBN/EEG-ET/NDARXW045HPY/NDARXW045HPY_Video-WK_Samples_ET.mat, Diary, 120, 3278639230, 3396035443, 117396213
/Volumes/methlab_data/HBN/EEG-ET/NDARXW276NXN/NDARXW276NXN_Video-DM_Samples_ET.mat, Despicable, 60, 1321115379, 1491652901, 170537522
/Volumes/methlab_data/HBN/EEG-ET/NDARXW276NXN/NDARXW276NXN_Video-FF_Samples_ET.mat, Fractals, 60, 849750283, 1012730484, 162980201
/Volumes/methlab_data/HBN/EEG-ET/NDARXW276NXN/NDARXW276NXN_Video-TP_Samples_ET.mat, Present, 60, 1852744040, 2055806561, 203062521
/Volumes/methlab_data/HBN/EEG-ET/NDARXW276NXN/NDARXW276NXN_Video-WK_Samples_ET.mat, Diary, 60, 184189044, 301584952, 117395908
/Volumes/methlab_data/HBN/EEG-ET/NDARXW330ZJT/NDARXW330ZJT_Video-DM_Samples_ET.mat, Despicable, 120, 5579858727, 5750404085, 170545358
/Volumes/methlab_data/HBN/EEG-ET/NDARXW330ZJT/NDARXW330ZJT_Video-FF_Samples_ET.mat, Fractals, 120, 4891242868, 5054238794, 162995926
/Volumes/methlab_data/HBN/EEG-ET/NDARXW330ZJT/NDARXW330ZJT_Video-TP_Samples_ET.mat, Present, 120, 6702549828, 6905616937, 203067109
/Volumes/methlab_data/HBN/EEG-ET/NDARXW330ZJT/NDARXW330ZJT_Video-WK_Samples_ET.mat, Diary, 120, 6045017263, 6162404300, 117387037
/Volumes/methlab_data/HBN/EEG-ET/NDARXW933TUJ/NDARXW933TUJ_Video1_Samples_ET.mat, Diary, 60, 2959049660, 3076445752, 117396092
/Volumes/methlab_data/HBN/EEG-ET/NDARXW933TUJ/NDARXW933TUJ_Video3_Samples_ET.mat, Despicable, 60, 2523842695, 2694388395, 170545700
/Volumes/methlab_data/HBN/EEG-ET/NDARXX895FNJ/NDARXX895FNJ_Video1_Samples_ET.mat, Diary, 60, 3139727640, 3257120480, 117392840
/Volumes/methlab_data/HBN/EEG-ET/NDARXX895FNJ/NDARXX895FNJ_Video3_Samples_ET.mat, Despicable, 60, 2720963172, 2891507527, 170544355
/Volumes/methlab_data/HBN/EEG-ET/NDARXX939FFN/NDARXX939FFN_Video-DM_Samples_ET.mat, Despicable, 60, 3495107111, 3665649763, 170542652
/Volumes/methlab_data/HBN/EEG-ET/NDARXX939FFN/NDARXX939FFN_Video-FF_Samples_ET.mat, Fractals, 60, 3935005231, 4097993542, 162988311
/Volumes/methlab_data/HBN/EEG-ET/NDARXX939FFN/NDARXX939FFN_Video-TP_Samples_ET.mat, Present, 60, 4430775875, 4633837571, 203061696
/Volumes/methlab_data/HBN/EEG-ET/NDARXX939FFN/NDARXX939FFN_Video-WK_Samples_ET.mat, Diary, 60, 3044503408, 3161895468, 117392060
/Volumes/methlab_data/HBN/EEG-ET/NDARXY162ERA/NDARXY162ERA_Video1_Samples_ET.mat, Diary, 60, 5473539970, 5590927764, 117387794
/Volumes/methlab_data/HBN/EEG-ET/NDARXY162ERA/NDARXY162ERA_Video3_Samples_ET.mat, Despicable, 60, 5896532263, 6067082567, 170550304
/Volumes/methlab_data/HBN/EEG-ET/NDARXY199VDP/NDARXY199VDP_Video-DM_Samples_ET.mat, Despicable, 120, 3781447134, 3951994664, 170547530
/Volumes/methlab_data/HBN/EEG-ET/NDARXY199VDP/NDARXY199VDP_Video-FF_Samples_ET.mat, Fractals, 120, 2873828833, 3036819824, 162990991
/Volumes/methlab_data/HBN/EEG-ET/NDARXY199VDP/NDARXY199VDP_Video-TP_Samples_ET.mat, Present, 120, 4928819455, 5131886507, 203067052
/Volumes/methlab_data/HBN/EEG-ET/NDARXY199VDP/NDARXY199VDP_Video-WK_Samples_ET.mat, Diary, 120, 4293843460, 4411251393, 117407933
/Volumes/methlab_data/HBN/EEG-ET/NDARXY240WJC/NDARXY240WJC_Video1_Samples_ET.mat, Diary, 60, 3028921911, 3146321246, 117399335
/Volumes/methlab_data/HBN/EEG-ET/NDARXY240WJC/NDARXY240WJC_Video3_Samples_ET.mat, Despicable, 60, 2507615951, 2678159006, 170543055
/Volumes/methlab_data/HBN/EEG-ET/NDARXY337ZH9/NDARXY337ZH9_Video1_Samples_ET.mat, Diary, 60, 1875625337, 1993023292, 117397955
/Volumes/methlab_data/HBN/EEG-ET/NDARXY337ZH9/NDARXY337ZH9_Video3_Samples_ET.mat, Despicable, 60, 2978120016, 3148673488, 170553472
/Volumes/methlab_data/HBN/EEG-ET/NDARXY532ZTT/NDARXY532ZTT_Video1_Samples_ET.mat, Fractals, 120, 4085458840, 4248455255, 162996415
/Volumes/methlab_data/HBN/EEG-ET/NDARXY532ZTT/NDARXY532ZTT_Video2_Samples_ET.mat, Diary, 120, 4916612328, 5034010632, 117398304
/Volumes/methlab_data/HBN/EEG-ET/NDARXY532ZTT/NDARXY532ZTT_Video3_Samples_ET.mat, Despicable, 120, 5388431233, 5558977923, 170546690
/Volumes/methlab_data/HBN/EEG-ET/NDARXY532ZTT/NDARXY532ZTT_Video4_Samples_ET.mat, Present, 120, 6035167114, 6238234672, 203067558
/Volumes/methlab_data/HBN/EEG-ET/NDARXY745NXJ/NDARXY745NXJ_Video1_Samples_ET.mat, Diary, 60, 3719116710, 3836512744, 117396034
/Volumes/methlab_data/HBN/EEG-ET/NDARXY745NXJ/NDARXY745NXJ_Video3_Samples_ET.mat, Despicable, 60, 3180134668, 3350681249, 170546581
/Volumes/methlab_data/HBN/EEG-ET/NDARXY938XY7/NDARXY938XY7_Video1_Samples_ET.mat, Diary, 60, 2270683554, 2388078465, 117394911
/Volumes/methlab_data/HBN/EEG-ET/NDARXY938XY7/NDARXY938XY7_Video3_Samples_ET.mat, Despicable, 60, 1764702379, 1935244774, 170542395
/Volumes/methlab_data/HBN/EEG-ET/NDARXZ685TU4/NDARXZ685TU4_Video1_Samples_ET.mat, Diary, 60, 3745139640, 3862524769, 117385129
/Volumes/methlab_data/HBN/EEG-ET/NDARXZ685TU4/NDARXZ685TU4_Video3_Samples_ET.mat, Despicable, 60, 3328341367, 3498881182, 170539815
/Volumes/methlab_data/HBN/EEG-ET/NDARXZ692ULW/NDARXZ692ULW_Video-DM_Samples_ET.mat, Despicable, 60, 5707582075, 5878130795, 170548720
/Volumes/methlab_data/HBN/EEG-ET/NDARXZ692ULW/NDARXZ692ULW_Video-FF_Samples_ET.mat, Fractals, 60, 5256249702, 5419239085, 162989383
/Volumes/methlab_data/HBN/EEG-ET/NDARXZ692ULW/NDARXZ692ULW_Video-TP_Samples_ET.mat, Present, 60, 6185477247, 6388534966, 203057719
/Volumes/methlab_data/HBN/EEG-ET/NDARXZ692ULW/NDARXZ692ULW_Video-WK_Samples_ET.mat, Diary, 60, 4627097523, 4744492593, 117395070
/Volumes/methlab_data/HBN/EEG-ET/NDARXZ710ZJ8/NDARXZ710ZJ8_Video-DM_Samples_ET.mat, Despicable, 60, 839878047, 1010416331, 170538284
/Volumes/methlab_data/HBN/EEG-ET/NDARXZ710ZJ8/NDARXZ710ZJ8_Video-TP_Samples_ET.mat, Present, 60, 1289943436, 1493222808, 203279372
/Volumes/methlab_data/HBN/EEG-ET/NDARXZ710ZJ8/NDARXZ710ZJ8_Video-WK_Samples_ET.mat, Diary, 60, 496426837, 613811642, 117384805
/Volumes/methlab_data/HBN/EEG-ET/NDARXZ850KHQ/NDARXZ850KHQ_Video-WK_Samples_ET.mat, Diary, 30, 2234035939, 2351422669, 117386730
/Volumes/methlab_data/HBN/EEG-ET/NDARYA030ZG7/NDARYA030ZG7_Video1_Samples_ET.mat, Diary, 60, 19771719301, 19889112307, 117393006
/Volumes/methlab_data/HBN/EEG-ET/NDARYA030ZG7/NDARYA030ZG7_Video2_Samples_ET.mat, Fractals, 60, 20661678496, 20824662764, 162984268
/Volumes/methlab_data/HBN/EEG-ET/NDARYA030ZG7/NDARYA030ZG7_Video3_Samples_ET.mat, Despicable, 60, 21131213455, 21301756062, 170542607
/Volumes/methlab_data/HBN/EEG-ET/NDARYA030ZG7/NDARYA030ZG7_Video4_Samples_ET.mat, Present, 60, 21684425575, 21887488189, 203062614
/Volumes/methlab_data/HBN/EEG-ET/NDARYA379LKT/NDARYA379LKT_Video-DM_Samples_ET.mat, Despicable, 60, 2866048470, 3036590263, 170541793
/Volumes/methlab_data/HBN/EEG-ET/NDARYA379LKT/NDARYA379LKT_Video-FF_Samples_ET.mat, Fractals, 60, 2386186738, 2549166136, 162979398
/Volumes/methlab_data/HBN/EEG-ET/NDARYA379LKT/NDARYA379LKT_Video-TP_Samples_ET.mat, Present, 60, 173254031, 376316835, 203062804
/Volumes/methlab_data/HBN/EEG-ET/NDARYA379LKT/NDARYA379LKT_Video-WK_Samples_ET.mat, Diary, 60, 1883923159, 2001314276, 117391117
/Volumes/methlab_data/HBN/EEG-ET/NDARYA496WZD/NDARYA496WZD_Video1_Samples_ET.mat, Diary, 60, 2988920870, 3106314789, 117393919
/Volumes/methlab_data/HBN/EEG-ET/NDARYA496WZD/NDARYA496WZD_Video3_Samples_ET.mat, Despicable, 60, 2553649668, 2724199040, 170549372
/Volumes/methlab_data/HBN/EEG-ET/NDARYA503XVQ/NDARYA503XVQ_Video1_Samples_ET.mat, Diary, 120, 2939914564, 3057312283, 117397719
/Volumes/methlab_data/HBN/EEG-ET/NDARYA503XVQ/NDARYA503XVQ_Video2_Samples_ET.mat, Despicable, 120, 4397685303, 4568232615, 170547312
/Volumes/methlab_data/HBN/EEG-ET/NDARYA503XVQ/NDARYA503XVQ_Video3_Samples_ET.mat, Fractals, 120, 4807412395, 4970399299, 162986904
/Volumes/methlab_data/HBN/EEG-ET/NDARYA503XVQ/NDARYA503XVQ_Video4_Samples_ET.mat, Present, 120, 5470847344, 5673915174, 203067830
/Volumes/methlab_data/HBN/EEG-ET/NDARYA675XXA/NDARYA675XXA_Video-FF_Samples_ET.mat, Fractals, 60, 1296640179, 1459617293, 162977114
/Volumes/methlab_data/HBN/EEG-ET/NDARYA675XXA/NDARYA675XXA_Video-WK_Samples_ET.mat, Diary, 60, 2081736368, 2199129349, 117392981
/Volumes/methlab_data/HBN/EEG-ET/NDARYA776KBK/NDARYA776KBK_Video-DM_Samples_ET.mat, Despicable, 60, 6055478374, 6226027861, 170549487
/Volumes/methlab_data/HBN/EEG-ET/NDARYA776KBK/NDARYA776KBK_Video-FF_Samples_ET.mat, Fractals, 60, 5843218457, 6006205576, 162987119
/Volumes/methlab_data/HBN/EEG-ET/NDARYA776KBK/NDARYA776KBK_Video-TP_Samples_ET.mat, Present, 60, 6541583713, 6744658156, 203074443
/Volumes/methlab_data/HBN/EEG-ET/NDARYA776KBK/NDARYA776KBK_Video-WK_Samples_ET.mat, Diary, 60, 5675016684, 5792415615, 117398931
/Volumes/methlab_data/HBN/EEG-ET/NDARYA807PVN/NDARYA807PVN_Video-DM_Samples_ET.mat, Despicable, 120, 6178745701, 6349289785, 170544084
/Volumes/methlab_data/HBN/EEG-ET/NDARYA807PVN/NDARYA807PVN_Video-FF_Samples_ET.mat, Fractals, 120, 6760523462, 6923508590, 162985128
/Volumes/methlab_data/HBN/EEG-ET/NDARYA807PVN/NDARYA807PVN_Video-TP_Samples_ET.mat, Present, 120, 7487955957, 7691017648, 203061691
/Volumes/methlab_data/HBN/EEG-ET/NDARYA807PVN/NDARYA807PVN_Video-WK_Samples_ET.mat, Diary, 120, 5463822349, 5581219442, 117397093
/Volumes/methlab_data/HBN/EEG-ET/NDARYA851GL6/NDARYA851GL6_Video-DM_Samples_ET.mat, Despicable, 120, 7395563796, 7566121617, 170557821
/Volumes/methlab_data/HBN/EEG-ET/NDARYA851GL6/NDARYA851GL6_Video-FF_Samples_ET.mat, Fractals, 120, 6090712648, 6253698327, 162985679
/Volumes/methlab_data/HBN/EEG-ET/NDARYA851GL6/NDARYA851GL6_Video-TP_Samples_ET.mat, Present, 120, 9126883375, 9329950181, 203066806
/Volumes/methlab_data/HBN/EEG-ET/NDARYA851GL6/NDARYA851GL6_Video-WK_Samples_ET.mat, Diary, 120, 8508936346, 8626334288, 117397942
/Volumes/methlab_data/HBN/EEG-ET/NDARYA877HN5/NDARYA877HN5_Video-DM_Samples_ET.mat, Despicable, 60, 4209566746, 4380107337, 170540591
/Volumes/methlab_data/HBN/EEG-ET/NDARYA877HN5/NDARYA877HN5_Video-FF_Samples_ET.mat, Fractals, 60, 3713592113, 3876575347, 162983234
/Volumes/methlab_data/HBN/EEG-ET/NDARYA877HN5/NDARYA877HN5_Video-TP_Samples_ET.mat, Present, 60, 4703290820, 4906362420, 203071600
/Volumes/methlab_data/HBN/EEG-ET/NDARYA877HN5/NDARYA877HN5_Video-WK_Samples_ET.mat, Diary, 60, 3049495609, 3166890607, 117394998
/Volumes/methlab_data/HBN/EEG-ET/NDARYA952GA1/NDARYA952GA1_Video-DM_Samples_ET.mat, Despicable, 60, 4869619693, 5040159065, 170539372
/Volumes/methlab_data/HBN/EEG-ET/NDARYA952GA1/NDARYA952GA1_Video-FF_Samples_ET.mat, Fractals, 60, 4380803799, 4543791819, 162988020
/Volumes/methlab_data/HBN/EEG-ET/NDARYA952GA1/NDARYA952GA1_Video-TP_Samples_ET.mat, Present, 60, 5415536874, 5618611189, 203074315
/Volumes/methlab_data/HBN/EEG-ET/NDARYA952GA1/NDARYA952GA1_Video-WK_Samples_ET.mat, Diary, 60, 3605524775, 3722915634, 117390859
/Volumes/methlab_data/HBN/EEG-ET/NDARYB204HKD/NDARYB204HKD_Video1_Samples_ET.mat, Diary, 60, 88175636212, 88293032151, 117395939
/Volumes/methlab_data/HBN/EEG-ET/NDARYB414NGM/NDARYB414NGM_Video-DM_Samples_ET.mat, Despicable, 60, 6895791200, 7066339812, 170548612
/Volumes/methlab_data/HBN/EEG-ET/NDARYB414NGM/NDARYB414NGM_Video-TP_Samples_ET.mat, Present, 60, 7102719432, 7305989109, 203269677
/Volumes/methlab_data/HBN/EEG-ET/NDARYB414NGM/NDARYB414NGM_Video-WK_Samples_ET.mat, Diary, 60, 3159383887, 3276770862, 117386975
/Volumes/methlab_data/HBN/EEG-ET/NDARYB432MB5/NDARYB432MB5_Video1_Samples_ET.mat, Diary, 60, 8981114113, 9098507444, 117393331
/Volumes/methlab_data/HBN/EEG-ET/NDARYB432MB5/NDARYB432MB5_Video3_Samples_ET.mat, Despicable, 60, 8756759909, 8927303943, 170544034
/Volumes/methlab_data/HBN/EEG-ET/NDARYB743WWX/NDARYB743WWX_Video-DM_Samples_ET.mat, Despicable, 60, 8007919740, 8178459268, 170539528
/Volumes/methlab_data/HBN/EEG-ET/NDARYB743WWX/NDARYB743WWX_Video-FF_Samples_ET.mat, Fractals, 60, 7577910910, 7740899137, 162988227
/Volumes/methlab_data/HBN/EEG-ET/NDARYB743WWX/NDARYB743WWX_Video-WK_Samples_ET.mat, Diary, 60, 6953416581, 7070815575, 117398994
/Volumes/methlab_data/HBN/EEG-ET/NDARYC243UW5/NDARYC243UW5_Video-DM_Samples_ET.mat, Despicable, 60, 5341552704, 5512096095, 170543391
/Volumes/methlab_data/HBN/EEG-ET/NDARYC243UW5/NDARYC243UW5_Video-FF_Samples_ET.mat, Fractals, 60, 4872835815, 5035832891, 162997076
/Volumes/methlab_data/HBN/EEG-ET/NDARYC243UW5/NDARYC243UW5_Video-TP_Samples_ET.mat, Present, 60, 5845395364, 6048465746, 203070382
/Volumes/methlab_data/HBN/EEG-ET/NDARYC243UW5/NDARYC243UW5_Video-WK_Samples_ET.mat, Diary, 60, 4268670307, 4386061197, 117390890
/Volumes/methlab_data/HBN/EEG-ET/NDARYC466ER1/NDARYC466ER1_Video1_Samples_ET.mat, Diary, 120, 3119385634, 3236783152, 117397518
/Volumes/methlab_data/HBN/EEG-ET/NDARYC466ER1/NDARYC466ER1_Video2_Samples_ET.mat, Fractals, 120, 3687801152, 3850798926, 162997774
/Volumes/methlab_data/HBN/EEG-ET/NDARYC466ER1/NDARYC466ER1_Video3_Samples_ET.mat, Despicable, 120, 4082569711, 4253113930, 170544219
/Volumes/methlab_data/HBN/EEG-ET/NDARYC466ER1/NDARYC466ER1_Video4_Samples_ET.mat, Present, 120, 4594793239, 4797857637, 203064398
/Volumes/methlab_data/HBN/EEG-ET/NDARYD071TYL/NDARYD071TYL_Video1_Samples_ET.mat, Diary, 120, 3209548111, 3326945414, 117397303
/Volumes/methlab_data/HBN/EEG-ET/NDARYD071TYL/NDARYD071TYL_Video2_Samples_ET.mat, Fractals, 120, 4457969985, 4620954185, 162984200
/Volumes/methlab_data/HBN/EEG-ET/NDARYD071TYL/NDARYD071TYL_Video3_Samples_ET.mat, Despicable, 120, 5113675598, 5284223104, 170547506
/Volumes/methlab_data/HBN/EEG-ET/NDARYD071TYL/NDARYD071TYL_Video4_Samples_ET.mat, Present, 120, 5816672628, 6019749382, 203076754
/Volumes/methlab_data/HBN/EEG-ET/NDARYD195BDH/NDARYD195BDH_Video1_Samples_ET.mat, Fractals, 120, 4642423102, 4805409708, 162986606
/Volumes/methlab_data/HBN/EEG-ET/NDARYD195BDH/NDARYD195BDH_Video2_Samples_ET.mat, Diary, 120, 5655135571, 5772532710, 117397139
/Volumes/methlab_data/HBN/EEG-ET/NDARYD195BDH/NDARYD195BDH_Video3_Samples_ET.mat, Despicable, 120, 6161562959, 6332108891, 170545932
/Volumes/methlab_data/HBN/EEG-ET/NDARYD195BDH/NDARYD195BDH_Video4_Samples_ET.mat, Present, 120, 6839177428, 7042244801, 203067373
/Volumes/methlab_data/HBN/EEG-ET/NDARYD546HCB/NDARYD546HCB_Video1_Samples_ET.mat, Despicable, 120, 3755436264, 3874004216, 4044551932
2.891157e+08, 1.705477e+08, /Volumes/methlab_data/HBN/EEG-ET/NDARYD546HCB/NDARYD546HCB_Video2_Samples_ET.mat, Fractals, 120, 4106262258, 4269249868, 162987610
/Volumes/methlab_data/HBN/EEG-ET/NDARYD546HCB/NDARYD546HCB_Video3_Samples_ET.mat, Diary, 120, 4319402192, 4436799490, 117397298
/Volumes/methlab_data/HBN/EEG-ET/NDARYD546HCB/NDARYD546HCB_Video4_Samples_ET.mat, Present, 120, 4526710072, 4729787248, 203077176
/Volumes/methlab_data/HBN/EEG-ET/NDARYD585PXP/NDARYD585PXP_Video-DM_Samples_ET.mat, Despicable, 30, 4591918582, 4762454874, 170536292
/Volumes/methlab_data/HBN/EEG-ET/NDARYD585PXP/NDARYD585PXP_Video-TP_Samples_ET.mat, Present, 30, 5075412565, 5278678939, 203266374
/Volumes/methlab_data/HBN/EEG-ET/NDARYD585PXP/NDARYD585PXP_Video-WK_Samples_ET.mat, Diary, 30, 3361706020, 3479092824, 117386804
/Volumes/methlab_data/HBN/EEG-ET/NDARYD666FL0/NDARYD666FL0_Video-DM_Samples_ET.mat, Despicable, 60, 5134521893, 5305060410, 170538517
/Volumes/methlab_data/HBN/EEG-ET/NDARYD666FL0/NDARYD666FL0_Video-FF_Samples_ET.mat, Fractals, 60, 4700258022, 4863249230, 162991208
/Volumes/methlab_data/HBN/EEG-ET/NDARYD666FL0/NDARYD666FL0_Video-TP_Samples_ET.mat, Present, 60, 5679593068, 5882661578, 203068510
/Volumes/methlab_data/HBN/EEG-ET/NDARYD666FL0/NDARYD666FL0_Video-WK_Samples_ET.mat, Diary, 60, 3980454370, 4097847350, 117392980
/Volumes/methlab_data/HBN/EEG-ET/NDARYE017HZA/NDARYE017HZA_Video-DM_Samples_ET.mat, Despicable, 60, 1034635953, 1205173472, 170537519
/Volumes/methlab_data/HBN/EEG-ET/NDARYE017HZA/NDARYE017HZA_Video-TP_Samples_ET.mat, Present, 60, 2073778264, 2277045914, 203267650
/Volumes/methlab_data/HBN/EEG-ET/NDARYE017HZA/NDARYE017HZA_Video-WK_Samples_ET.mat, Diary, 60, 44388236, 161778194, 117389958
/Volumes/methlab_data/HBN/EEG-ET/NDARYE155BLQ/NDARYE155BLQ_Video-DM_Samples_ET.mat, Despicable, 30, 4074696267, 4245231661, 170535394
/Volumes/methlab_data/HBN/EEG-ET/NDARYE155BLQ/NDARYE155BLQ_Video-TP_Samples_ET.mat, Present, 30, 4589778867, 4793046361, 203267494
/Volumes/methlab_data/HBN/EEG-ET/NDARYE155BLQ/NDARYE155BLQ_Video-WK_Samples_ET.mat, Diary, 30, 2844417752, 2961802631, 117384879
/Volumes/methlab_data/HBN/EEG-ET/NDARYE221LZB/NDARYE221LZB_Video1_Samples_ET.mat, Fractals, 120, 2864146482, 3027132928, 162986446
/Volumes/methlab_data/HBN/EEG-ET/NDARYE221LZB/NDARYE221LZB_Video2_Samples_ET.mat, Despicable, 120, 3522737637, 3693281594, 170543957
/Volumes/methlab_data/HBN/EEG-ET/NDARYE221LZB/NDARYE221LZB_Video3_Samples_ET.mat, Diary, 120, 3911330014, 4028727914, 117397900
/Volumes/methlab_data/HBN/EEG-ET/NDARYE221LZB/NDARYE221LZB_Video4_Samples_ET.mat, Present, 120, 4494127478, 4697194368, 203066890
/Volumes/methlab_data/HBN/EEG-ET/NDARYE379GGT/NDARYE379GGT_Video1_Samples_ET.mat, Despicable, 120, 5940574662, 6111121968, 170547306
/Volumes/methlab_data/HBN/EEG-ET/NDARYE379GGT/NDARYE379GGT_Video2_Samples_ET.mat, Diary, 120, 6421861526, 6539258903, 117397377
/Volumes/methlab_data/HBN/EEG-ET/NDARYE379GGT/NDARYE379GGT_Video3_Samples_ET.mat, Fractals, 120, 6566419898, 6729408164, 162988266
/Volumes/methlab_data/HBN/EEG-ET/NDARYE379GGT/NDARYE379GGT_Video4_Samples_ET.mat, Present, 120, 7231567443, 7434634004, 203066561
/Volumes/methlab_data/HBN/EEG-ET/NDARYE576WR6/NDARYE576WR6_Video-DM_Samples_ET.mat, Despicable, 30, 4241232973, 4411773569, 170540596
/Volumes/methlab_data/HBN/EEG-ET/NDARYE576WR6/NDARYE576WR6_Video-TP_Samples_ET.mat, Present, 30, 5201795097, 5405061816, 203266719
/Volumes/methlab_data/HBN/EEG-ET/NDARYE576WR6/NDARYE576WR6_Video-WK_Samples_ET.mat, Diary, 30, 4740838208, 4858226209, 117388001
/Volumes/methlab_data/HBN/EEG-ET/NDARYE822ZTD/NDARYE822ZTD_Video-DM_Samples_ET.mat, Despicable, 60, 2969118552, 3139668031, 170549479
/Volumes/methlab_data/HBN/EEG-ET/NDARYE822ZTD/NDARYE822ZTD_Video-FF_Samples_ET.mat, Fractals, 60, 3442378827, 3605368941, 162990114
/Volumes/methlab_data/HBN/EEG-ET/NDARYE822ZTD/NDARYE822ZTD_Video-TP_Samples_ET.mat, Present, 60, 3940971969, 4144035491, 203063522
/Volumes/methlab_data/HBN/EEG-ET/NDARYE822ZTD/NDARYE822ZTD_Video-WK_Samples_ET.mat, Diary, 60, 2315581965, 2432973900, 117391935
/Volumes/methlab_data/HBN/EEG-ET/NDARYE850ZVD/NDARYE850ZVD_Video1_Samples_ET.mat, Diary, 120, 4264033692, 4381429626, 117395934
/Volumes/methlab_data/HBN/EEG-ET/NDARYE850ZVD/NDARYE850ZVD_Video2_Samples_ET.mat, Fractals, 120, 5541488270, 5704473976, 162985706
/Volumes/methlab_data/HBN/EEG-ET/NDARYE850ZVD/NDARYE850ZVD_Video3_Samples_ET.mat, Despicable, 120, 6042763494, 6213306613, 170543119
/Volumes/methlab_data/HBN/EEG-ET/NDARYE850ZVD/NDARYE850ZVD_Video4_Samples_ET.mat, Present, 120, 6725677688, 6928745767, 203068079
/Volumes/methlab_data/HBN/EEG-ET/NDARYF085LZQ/NDARYF085LZQ_Video1_Samples_ET.mat, Diary, 60, 3722146410, 3839542761, 117396351
/Volumes/methlab_data/HBN/EEG-ET/NDARYF085LZQ/NDARYF085LZQ_Video3_Samples_ET.mat, Despicable, 60, 3279951626, 3450494665, 170543039
/Volumes/methlab_data/HBN/EEG-ET/NDARYF085LZQ/NDARYF085LZQ_Video4_Samples_ET.mat, Present, 60, 4133777558, 4336838669, 203061111
/Volumes/methlab_data/HBN/EEG-ET/NDARYF135ZHU/NDARYF135ZHU_Video1_Samples_ET.mat, Diary, 60, 5649578643, 5766972777, 117394134
/Volumes/methlab_data/HBN/EEG-ET/NDARYF135ZHU/NDARYF135ZHU_Video3_Samples_ET.mat, Despicable, 60, 5074709631, 5245250383, 170540752
/Volumes/methlab_data/HBN/EEG-ET/NDARYF272EDC/NDARYF272EDC_Video1_Samples_ET.mat, Despicable, 120, 8655119228, 8825666691, 170547463
/Volumes/methlab_data/HBN/EEG-ET/NDARYF272EDC/NDARYF272EDC_Video2_Samples_ET.mat, Diary, 120, 8901357291, 9018748346, 117391055
/Volumes/methlab_data/HBN/EEG-ET/NDARYF272EDC/NDARYF272EDC_Video3_Samples_ET.mat, Fractals, 120, 9099076455, 9262063417, 162986962
/Volumes/methlab_data/HBN/EEG-ET/NDARYF272EDC/NDARYF272EDC_Video4_Samples_ET.mat, Present, 120, 9337565384, 9540631925, 203066541
/Volumes/methlab_data/HBN/EEG-ET/NDARYF338WW1/NDARYF338WW1_Video1_Samples_ET.mat, Diary, 60, 2836657431, 2954052569, 117395138
/Volumes/methlab_data/HBN/EEG-ET/NDARYF338WW1/NDARYF338WW1_Video2_Samples_ET.mat, Fractals, 60, 1574368778, 1737355441, 162986663
/Volumes/methlab_data/HBN/EEG-ET/NDARYF338WW1/NDARYF338WW1_Video3_Samples_ET.mat, Despicable, 60, 2371752291, 2542302066, 170549775
/Volumes/methlab_data/HBN/EEG-ET/NDARYF338WW1/NDARYF338WW1_Video4_Samples_ET.mat, Present, 60, 3265737231, 3468807031, 203069800
/Volumes/methlab_data/HBN/EEG-ET/NDARYF368WEA/NDARYF368WEA_Video1_Samples_ET.mat, Diary, 60, 3118109859, 3235508830, 117398971
/Volumes/methlab_data/HBN/EEG-ET/NDARYF368WEA/NDARYF368WEA_Video3_Samples_ET.mat, Despicable, 60, 3542765925, 3713309465, 170543540
/Volumes/methlab_data/HBN/EEG-ET/NDARYF699FW0/NDARYF699FW0_Video-DM_Samples_ET.mat, Despicable, 120, 4613147141, 4783694776, 170547635
/Volumes/methlab_data/HBN/EEG-ET/NDARYF699FW0/NDARYF699FW0_Video-FF_Samples_ET.mat, Fractals, 120, 3753144002, 3916129935, 162985933
/Volumes/methlab_data/HBN/EEG-ET/NDARYF699FW0/NDARYF699FW0_Video-TP_Samples_ET.mat, Present, 120, 5701850280, 5904917553, 203067273
/Volumes/methlab_data/HBN/EEG-ET/NDARYF699FW0/NDARYF699FW0_Video-WK_Samples_ET.mat, Diary, 120, 5058475384, 5175872039, 117396655
/Volumes/methlab_data/HBN/EEG-ET/NDARYF728BEP/NDARYF728BEP_Video1_Samples_ET.mat, Diary, 120, 2803630082, 2921018111, 117388029
/Volumes/methlab_data/HBN/EEG-ET/NDARYF728BEP/NDARYF728BEP_Video2_Samples_ET.mat, Fractals, 120, 3561445432, 3724432985, 162987553
/Volumes/methlab_data/HBN/EEG-ET/NDARYF728BEP/NDARYF728BEP_Video3_Samples_ET.mat, Despicable, 120, 3953243159, 4123790540, 170547381
/Volumes/methlab_data/HBN/EEG-ET/NDARYF728BEP/NDARYF728BEP_Video4_Samples_ET.mat, Present, 120, 4805528795, 5008596010, 203067215
/Volumes/methlab_data/HBN/EEG-ET/NDARYG172DBJ/NDARYG172DBJ_Video-DM_Samples_ET.mat, Despicable, 60, 5426936892, 5597477388, 170540496
/Volumes/methlab_data/HBN/EEG-ET/NDARYG172DBJ/NDARYG172DBJ_Video-FF_Samples_ET.mat, Fractals, 60, 4990069343, 5153057467, 162988124
/Volumes/methlab_data/HBN/EEG-ET/NDARYG172DBJ/NDARYG172DBJ_Video-TP_Samples_ET.mat, Present, 60, 5955311057, 6158381517, 203070460
/Volumes/methlab_data/HBN/EEG-ET/NDARYG172DBJ/NDARYG172DBJ_Video-WK_Samples_ET.mat, Diary, 60, 4396414034, 4513804156, 117390122
/Volumes/methlab_data/HBN/EEG-ET/NDARYG331FLY/NDARYG331FLY_Video-DM_Samples_ET.mat, Despicable, 120, 7100919498, 7271466778, 170547280
/Volumes/methlab_data/HBN/EEG-ET/NDARYG331FLY/NDARYG331FLY_Video-FF_Samples_ET.mat, Fractals, 120, 6506127164, 6669119352, 162992188
/Volumes/methlab_data/HBN/EEG-ET/NDARYG331FLY/NDARYG331FLY_Video-TP_Samples_ET.mat, Present, 120, 7863524888, 8066591845, 203066957
/Volumes/methlab_data/HBN/EEG-ET/NDARYG331FLY/NDARYG331FLY_Video-WK_Samples_ET.mat, Diary, 120, 5606298208, 5723686078, 117387870
/Volumes/methlab_data/HBN/EEG-ET/NDARYG419DKQ/NDARYG419DKQ_Video-DM_Samples_ET.mat, Despicable, 30, 3779523950, 3950064420, 170540470
/Volumes/methlab_data/HBN/EEG-ET/NDARYG419DKQ/NDARYG419DKQ_Video-TP_Samples_ET.mat, Present, 30, 4748640044, 4951906793, 203266749
/Volumes/methlab_data/HBN/EEG-ET/NDARYG419DKQ/NDARYG419DKQ_Video-WK_Samples_ET.mat, Diary, 30, 2862347848, 2979737462, 117389614
/Volumes/methlab_data/HBN/EEG-ET/NDARYG546ZFF/NDARYG546ZFF_Video1_Samples_ET.mat, Diary, 60, 1897784562, 2015175367, 117390805
/Volumes/methlab_data/HBN/EEG-ET/NDARYG546ZFF/NDARYG546ZFF_Video3_Samples_ET.mat, Despicable, 60, 3139233194, 3309784543, 170551349
/Volumes/methlab_data/HBN/EEG-ET/NDARYG665JUD/NDARYG665JUD_Video1_Samples_ET.mat, Diary, 60, 3998097427, 4115486432, 117389005
/Volumes/methlab_data/HBN/EEG-ET/NDARYG665JUD/NDARYG665JUD_Video2_Samples_ET.mat, Fractals, 60, 4669599184, 4832592454, 162993270
/Volumes/methlab_data/HBN/EEG-ET/NDARYG665JUD/NDARYG665JUD_Video3_Samples_ET.mat, Despicable, 60, 5120125726, 5290668289, 170542563
/Volumes/methlab_data/HBN/EEG-ET/NDARYG665JUD/NDARYG665JUD_Video4_Samples_ET.mat, Present, 60, 5597560244, 5800622854, 203062610
/Volumes/methlab_data/HBN/EEG-ET/NDARYG819TE6/NDARYG819TE6_Video-DM_Samples_ET.mat, Despicable, 60, 5048712708, 5219249333, 170536625
/Volumes/methlab_data/HBN/EEG-ET/NDARYG819TE6/NDARYG819TE6_Video-TP_Samples_ET.mat, Present, 60, 5886934351, 6090204078, 203269727
/Volumes/methlab_data/HBN/EEG-ET/NDARYG819TE6/NDARYG819TE6_Video-WK_Samples_ET.mat, Diary, 60, 5477390782, 5594774881, 117384099
/Volumes/methlab_data/HBN/EEG-ET/NDARYG874KEA/NDARYG874KEA_Video1_Samples_ET.mat, Diary, 60, 1936087125, 2053480297, 117393172
/Volumes/methlab_data/HBN/EEG-ET/NDARYG874KEA/NDARYG874KEA_Video3_Samples_ET.mat, Despicable, 60, 1516129666, 1686681477, 170551811
/Volumes/methlab_data/HBN/EEG-ET/NDARYG988PUQ/NDARYG988PUQ_Video1_Samples_ET.mat, Diary, 120, 4607584792, 4724981178, 117396386
/Volumes/methlab_data/HBN/EEG-ET/NDARYG988PUQ/NDARYG988PUQ_Video2_Samples_ET.mat, Fractals, 120, 5359048703, 5522046787, 162998084
/Volumes/methlab_data/HBN/EEG-ET/NDARYG988PUQ/NDARYG988PUQ_Video3_Samples_ET.mat, Despicable, 120, 5796337860, 5966884800, 170546940
/Volumes/methlab_data/HBN/EEG-ET/NDARYG988PUQ/NDARYG988PUQ_Video4_Samples_ET.mat, Present, 120, 6433853262, 6636921443, 203068181
/Volumes/methlab_data/HBN/EEG-ET/NDARYH110YV9/NDARYH110YV9_Video1_Samples_ET.mat, Diary, 60, 2145524002, 2262912947, 117388945
/Volumes/methlab_data/HBN/EEG-ET/NDARYH110YV9/NDARYH110YV9_Video3_Samples_ET.mat, Despicable, 60, 3292504106, 3463052616, 170548510
/Volumes/methlab_data/HBN/EEG-ET/NDARYH182BBV/NDARYH182BBV_Video1_Samples_ET.mat, Diary, 60, 78850840376, 78968236222, 117395846
/Volumes/methlab_data/HBN/EEG-ET/NDARYH182BBV/NDARYH182BBV_Video3_Samples_ET.mat, Despicable, 60, 78351757226, 78522301571, 170544345
/Volumes/methlab_data/HBN/EEG-ET/NDARYH182BBV/NDARYH182BBV_Video4_Samples_ET.mat, Present, 60, 79265467910, 79468529243, 203061333
/Volumes/methlab_data/HBN/EEG-ET/NDARYH480GTD/NDARYH480GTD_Video1_Samples_ET.mat, Diary, 60, 2064511229, 2181904311, 117393082
/Volumes/methlab_data/HBN/EEG-ET/NDARYH480GTD/NDARYH480GTD_Video3_Samples_ET.mat, Despicable, 60, 2977295160, 3147833829, 170538669
/Volumes/methlab_data/HBN/EEG-ET/NDARYH697TPA/NDARYH697TPA_Video1_Samples_ET.mat, Diary, 60, 3630370232, 3747764179, 117393947
/Volumes/methlab_data/HBN/EEG-ET/NDARYH697TPA/NDARYH697TPA_Video2_Samples_ET.mat, Fractals, 60, 4284557829, 4447541214, 162983385
/Volumes/methlab_data/HBN/EEG-ET/NDARYH697TPA/NDARYH697TPA_Video3_Samples_ET.mat, Despicable, 60, 5062270871, 5232814535, 170543664
/Volumes/methlab_data/HBN/EEG-ET/NDARYH697TPA/NDARYH697TPA_Video4_Samples_ET.mat, Present, 60, 5561125714, 5764191358, 203065644
/Volumes/methlab_data/HBN/EEG-ET/NDARYH951HH5/NDARYH951HH5_Video-DM_Samples_ET.mat, Despicable, 60, 5789308487, 5959848916, 170540429
/Volumes/methlab_data/HBN/EEG-ET/NDARYH951HH5/NDARYH951HH5_Video-FF_Samples_ET.mat, Fractals, 60, 5360749963, 5523743042, 162993079
/Volumes/methlab_data/HBN/EEG-ET/NDARYH951HH5/NDARYH951HH5_Video-TP_Samples_ET.mat, Present, 60, 6265761831, 6468821207, 203059376
/Volumes/methlab_data/HBN/EEG-ET/NDARYH951HH5/NDARYH951HH5_Video-WK_Samples_ET.mat, Diary, 60, 4725300364, 4842700265, 117399901
/Volumes/methlab_data/HBN/EEG-ET/NDARYH996DA9/NDARYH996DA9_Video1_Samples_ET.mat, Diary, 60, 2003077056, 2120471072, 117394016
/Volumes/methlab_data/HBN/EEG-ET/NDARYH996DA9/NDARYH996DA9_Video3_Samples_ET.mat, Despicable, 60, 2901697395, 3072239980, 170542585
/Volumes/methlab_data/HBN/EEG-ET/NDARYJ245AAD/NDARYJ245AAD_Video-DM_Samples_ET.mat, Despicable, 30, 2630197720, 2800750009, 170552289
/Volumes/methlab_data/HBN/EEG-ET/NDARYJ245AAD/NDARYJ245AAD_Video-FF_Samples_ET.mat, Fractals, 30, 3106190391, 3269173346, 162982955
/Volumes/methlab_data/HBN/EEG-ET/NDARYJ245AAD/NDARYJ245AAD_Video-TP_Samples_ET.mat, Present, 30, 3574202444, 3777269679, 203067235
/Volumes/methlab_data/HBN/EEG-ET/NDARYJ245AAD/NDARYJ245AAD_Video-WK_Samples_ET.mat, Diary, 30, 2072707562, 2190103419, 117395857
/Volumes/methlab_data/HBN/EEG-ET/NDARYJ301DYN/NDARYJ301DYN_Video1_Samples_ET.mat, Diary, 60, 3414397038, 3531791063, 117394025
/Volumes/methlab_data/HBN/EEG-ET/NDARYJ301DYN/NDARYJ301DYN_Video2_Samples_ET.mat, Fractals, 60, 4050026421, 4213008705, 162982284
/Volumes/methlab_data/HBN/EEG-ET/NDARYJ301DYN/NDARYJ301DYN_Video3_Samples_ET.mat, Despicable, 60, 4496168852, 4666712452, 170543600
/Volumes/methlab_data/HBN/EEG-ET/NDARYJ301DYN/NDARYJ301DYN_Video4_Samples_ET.mat, Present, 60, 4985874090, 5188944669, 203070579
/Volumes/methlab_data/HBN/EEG-ET/NDARYJ334EHH/NDARYJ334EHH_Video-DM_Samples_ET.mat, Despicable, 60, 3789459417, 3960000992, 170541575
/Volumes/methlab_data/HBN/EEG-ET/NDARYJ334EHH/NDARYJ334EHH_Video-FF_Samples_ET.mat, Fractals, 60, 3260613509, 3423597750, 162984241
/Volumes/methlab_data/HBN/EEG-ET/NDARYJ334EHH/NDARYJ334EHH_Video-TP_Samples_ET.mat, Present, 60, 4420925879, 4623998440, 203072561
/Volumes/methlab_data/HBN/EEG-ET/NDARYJ334EHH/NDARYJ334EHH_Video-WK_Samples_ET.mat, Diary, 60, 2529021261, 2646416298, 117395037
/Volumes/methlab_data/HBN/EEG-ET/NDARYJ389DWX/NDARYJ389DWX_Video2_Samples_ET.mat, Despicable, 120, 4998098869, 5168655812, 170556943
/Volumes/methlab_data/HBN/EEG-ET/NDARYJ389DWX/NDARYJ389DWX_Video3_Samples_ET.mat, Diary, 120, 5507115113, 5624512710, 117397597
/Volumes/methlab_data/HBN/EEG-ET/NDARYJ536MCR/NDARYJ536MCR_Video1_Samples_ET.mat, Diary, 60, 4293181990, 4410574056, 117392066
/Volumes/methlab_data/HBN/EEG-ET/NDARYJ536MCR/NDARYJ536MCR_Video3_Samples_ET.mat, Despicable, 60, 3525334617, 3695878320, 170543703
/Volumes/methlab_data/HBN/EEG-ET/NDARYJ583ZMJ/NDARYJ583ZMJ_Video1_Samples_ET.mat, Diary, 60, 2718524156, 2835913087, 117388931
/Volumes/methlab_data/HBN/EEG-ET/NDARYJ583ZMJ/NDARYJ583ZMJ_Video2_Samples_ET.mat, Fractals, 60, 2891805548, 3054792694, 162987146
/Volumes/methlab_data/HBN/EEG-ET/NDARYJ583ZMJ/NDARYJ583ZMJ_Video3_Samples_ET.mat, Despicable, 60, 2497482041, 2668029520, 170547479
/Volumes/methlab_data/HBN/EEG-ET/NDARYJ583ZMJ/NDARYJ583ZMJ_Video4_Samples_ET.mat, Present, 60, 3137838295, 3340905743, 203067448
/Volumes/methlab_data/HBN/EEG-ET/NDARYJ638RTN/NDARYJ638RTN_Video1_Samples_ET.mat, Diary, 60, 95417509254, 95534904271, 117395017
/Volumes/methlab_data/HBN/EEG-ET/NDARYJ638RTN/NDARYJ638RTN_Video3_Samples_ET.mat, Despicable, 60, 94987645337, 95158187955, 170542618
/Volumes/methlab_data/HBN/EEG-ET/NDARYJ638RTN/NDARYJ638RTN_Video4_Samples_ET.mat, Present, 60, 95848177741, 96051239343, 203061602
/Volumes/methlab_data/HBN/EEG-ET/NDARYJ694EU0/NDARYJ694EU0_Video-DM_Samples_ET.mat, Despicable, 60, 4317398533, 4487942260, 170543727
/Volumes/methlab_data/HBN/EEG-ET/NDARYJ694EU0/NDARYJ694EU0_Video-FF_Samples_ET.mat, Fractals, 60, 3894963833, 4057951077, 162987244
/Volumes/methlab_data/HBN/EEG-ET/NDARYJ694EU0/NDARYJ694EU0_Video-TP_Samples_ET.mat, Present, 60, 4794487802, 4997557396, 203069594
/Volumes/methlab_data/HBN/EEG-ET/NDARYJ694EU0/NDARYJ694EU0_Video-WK_Samples_ET.mat, Diary, 60, 3100196911, 3217585927, 117389016
/Volumes/methlab_data/HBN/EEG-ET/NDARYJ735XPK/NDARYJ735XPK_Video1_Samples_ET.mat, Diary, 60, 4633922846, 4751312998, 117390152
/Volumes/methlab_data/HBN/EEG-ET/NDARYJ735XPK/NDARYJ735XPK_Video2_Samples_ET.mat, Fractals, 60, 3434374598, 3597363008, 162988410
/Volumes/methlab_data/HBN/EEG-ET/NDARYJ735XPK/NDARYJ735XPK_Video3_Samples_ET.mat, Despicable, 60, 4154790623, 4325329388, 170538765
/Volumes/methlab_data/HBN/EEG-ET/NDARYJ735XPK/NDARYJ735XPK_Video4_Samples_ET.mat, Present, 60, 5095879904, 5298946725, 203066821
/Volumes/methlab_data/HBN/EEG-ET/NDARYK042VMG/NDARYK042VMG_Video-DM_Samples_ET.mat, Despicable, 30, 3643233673, 3813769440, 170535767
/Volumes/methlab_data/HBN/EEG-ET/NDARYK042VMG/NDARYK042VMG_Video-TP_Samples_ET.mat, Present, 30, 4475027597, 4678303518, 203275921
/Volumes/methlab_data/HBN/EEG-ET/NDARYK042VMG/NDARYK042VMG_Video-WK_Samples_ET.mat, Diary, 30, 4066030007, 4183418137, 117388130
/Volumes/methlab_data/HBN/EEG-ET/NDARYK772JH8/NDARYK772JH8_Video-DM_Samples_ET.mat, Despicable, 30, 3643252043, 3813789462, 170537419
/Volumes/methlab_data/HBN/EEG-ET/NDARYK772JH8/NDARYK772JH8_Video-WK_Samples_ET.mat, Diary, 30, 4168848083, 4286236973, 117388890
/Volumes/methlab_data/HBN/EEG-ET/NDARYK942YHY/NDARYK942YHY_Video1_Samples_ET.mat, Diary, 60, 5947956373, 6065350405, 117394032
/Volumes/methlab_data/HBN/EEG-ET/NDARYK942YHY/NDARYK942YHY_Video3_Samples_ET.mat, Despicable, 60, 5444830671, 5615373267, 170542596
/Volumes/methlab_data/HBN/EEG-ET/NDARYL124VM6/NDARYL124VM6_Video1_Samples_ET.mat, Diary, 60, 379007304, 496410021, 117402717
/Volumes/methlab_data/HBN/EEG-ET/NDARYL124VM6/NDARYL124VM6_Video3_Samples_ET.mat, Despicable, 60, 414529510, 585076560, 170547050
/Volumes/methlab_data/HBN/EEG-ET/NDARYL268BVG/NDARYL268BVG_Video-DM_Samples_ET.mat, Despicable, 60, 5647640512, 5818178863, 170538351
/Volumes/methlab_data/HBN/EEG-ET/NDARYL268BVG/NDARYL268BVG_Video-FF_Samples_ET.mat, Fractals, 60, 5164576719, 5327565892, 162989173
/Volumes/methlab_data/HBN/EEG-ET/NDARYL268BVG/NDARYL268BVG_Video-TP_Samples_ET.mat, Present, 60, 6232033850, 6435103148, 203069298
/Volumes/methlab_data/HBN/EEG-ET/NDARYL272HDW/NDARYL272HDW_Video1_Samples_ET.mat, Diary, 60, 1907927224, 2025323410, 117396186
/Volumes/methlab_data/HBN/EEG-ET/NDARYL272HDW/NDARYL272HDW_Video3_Samples_ET.mat, Despicable, 60, 3340162753, 3510705556, 170542803
/Volumes/methlab_data/HBN/EEG-ET/NDARYL284NDM/NDARYL284NDM_Video-DM_Samples_ET.mat, Despicable, 30, 2847127991, 3017665459, 170537468
/Volumes/methlab_data/HBN/EEG-ET/NDARYL284NDM/NDARYL284NDM_Video-TP_Samples_ET.mat, Present, 30, 3339212547, 3542481131, 203268584
/Volumes/methlab_data/HBN/EEG-ET/NDARYL284NDM/NDARYL284NDM_Video-WK_Samples_ET.mat, Diary, 30, 1666987470, 1784381409, 117393939
/Volumes/methlab_data/HBN/EEG-ET/NDARYL438DCK/NDARYL438DCK_Video1_Samples_ET.mat, Diary, 60, 1787733579, 1905128633, 117395054
/Volumes/methlab_data/HBN/EEG-ET/NDARYL438DCK/NDARYL438DCK_Video3_Samples_ET.mat, Despicable, 60, 1374997705, 1545541301, 170543596
/Volumes/methlab_data/HBN/EEG-ET/NDARYL758JGG/NDARYL758JGG_Video1_Samples_ET.mat, Diary, 120, 3369966174, 3487362468, 117396294
/Volumes/methlab_data/HBN/EEG-ET/NDARYL758JGG/NDARYL758JGG_Video2_Samples_ET.mat, Fractals, 120, 4534268341, 4697264203, 162995862
/Volumes/methlab_data/HBN/EEG-ET/NDARYL758JGG/NDARYL758JGG_Video3_Samples_ET.mat, Despicable, 120, 5162032996, 5332580416, 170547420
/Volumes/methlab_data/HBN/EEG-ET/NDARYL758JGG/NDARYL758JGG_Video4_Samples_ET.mat, Present, 120, 5875098826, 6078166507, 203067681
/Volumes/methlab_data/HBN/EEG-ET/NDARYL771XDP/NDARYL771XDP_Video1_Samples_ET.mat, Diary, 60, 1731831644, 1849226529, 117394885
/Volumes/methlab_data/HBN/EEG-ET/NDARYL771XDP/NDARYL771XDP_Video3_Samples_ET.mat, Despicable, 60, 2832398572, 3002938986, 170540414
/Volumes/methlab_data/HBN/EEG-ET/NDARYL771XDP/NDARYL771XDP_Video4_Samples_ET.mat, Present, 60, 3311619868, 3514680236, 203060368
/Volumes/methlab_data/HBN/EEG-ET/NDARYL915MB0/NDARYL915MB0_Video-DM_Samples_ET.mat, Despicable, 30, 2807890378, 2978427893, 170537515
/Volumes/methlab_data/HBN/EEG-ET/NDARYL915MB0/NDARYL915MB0_Video-TP_Samples_ET.mat, Present, 30, 4362504936, 4565771586, 203266650
/Volumes/methlab_data/HBN/EEG-ET/NDARYL915MB0/NDARYL915MB0_Video-WK_Samples_ET.mat, Diary, 30, 3892477784, 4009866762, 117388978
/Volumes/methlab_data/HBN/EEG-ET/NDARYM063XB8/NDARYM063XB8_Video-DM_Samples_ET.mat, Despicable, 120, 10364521658, 10638657840, 274136182
/Volumes/methlab_data/HBN/EEG-ET/NDARYM063XB8/NDARYM063XB8_Video-FF_Samples_ET.mat, Fractals, 120, 10852298237, 10942016999, 89718762
/Volumes/methlab_data/HBN/EEG-ET/NDARYM063XB8/NDARYM063XB8_Video-WK_Samples_ET.mat, Diary, 120, 11425815541, 11543213261, 117397720
/Volumes/methlab_data/HBN/EEG-ET/NDARYM257RR6/NDARYM257RR6_Video1_Samples_ET.mat, Diary, 60, 4931688165, 5049083128, 117394963
/Volumes/methlab_data/HBN/EEG-ET/NDARYM257RR6/NDARYM257RR6_Video3_Samples_ET.mat, Despicable, 60, 4494367116, 4664916644, 170549528
/Volumes/methlab_data/HBN/EEG-ET/NDARYM277DEA/NDARYM277DEA_Video1_Samples_ET.mat, Diary, 60, 2946131722, 3063520804, 117389082
/Volumes/methlab_data/HBN/EEG-ET/NDARYM277DEA/NDARYM277DEA_Video2_Samples_ET.mat, Fractals, 60, 2032344450, 2195324728, 162980278
/Volumes/methlab_data/HBN/EEG-ET/NDARYM277DEA/NDARYM277DEA_Video3_Samples_ET.mat, Despicable, 60, 3357642777, 3528196451, 170553674
/Volumes/methlab_data/HBN/EEG-ET/NDARYM277DEA/NDARYM277DEA_Video4_Samples_ET.mat, Present, 60, 3874309207, 4077376850, 203067643
/Volumes/methlab_data/HBN/EEG-ET/NDARYM334BZ5/NDARYM334BZ5_Video1_Samples_ET.mat, Fractals, 120, 2539910639, 2702896099, 162985460
/Volumes/methlab_data/HBN/EEG-ET/NDARYM334BZ5/NDARYM334BZ5_Video2_Samples_ET.mat, Despicable, 120, 3107105429, 3277652894, 170547465
/Volumes/methlab_data/HBN/EEG-ET/NDARYM334BZ5/NDARYM334BZ5_Video3_Samples_ET.mat, Diary, 120, 3547643769, 3665040824, 117397055
/Volumes/methlab_data/HBN/EEG-ET/NDARYM334BZ5/NDARYM334BZ5_Video4_Samples_ET.mat, Present, 120, 4162160429, 4365226676, 203066247
/Volumes/methlab_data/HBN/EEG-ET/NDARYM586MYN/NDARYM586MYN_Video1_Samples_ET.mat, Despicable, 120, 1926940382, 2097487381, 170546999
/Volumes/methlab_data/HBN/EEG-ET/NDARYM586MYN/NDARYM586MYN_Video2_Samples_ET.mat, Fractals, 120, 2146287990, 2309275350, 162987360
/Volumes/methlab_data/HBN/EEG-ET/NDARYM586MYN/NDARYM586MYN_Video3_Samples_ET.mat, Diary, 120, 2384347096, 2501743944, 117396848
/Volumes/methlab_data/HBN/EEG-ET/NDARYM586MYN/NDARYM586MYN_Video4_Samples_ET.mat, Present, 120, 2551976866, 2755042708, 203065842
/Volumes/methlab_data/HBN/EEG-ET/NDARYM832PX3/NDARYM832PX3_Video1_Samples_ET.mat, Diary, 30, 1095651763, 1213045665, 117393902
/Volumes/methlab_data/HBN/EEG-ET/NDARYM832PX3/NDARYM832PX3_Video3_Samples_ET.mat, Despicable, 30, 2496516695, 2667058095, 170541400
/Volumes/methlab_data/HBN/EEG-ET/NDARYM994YF0/NDARYM994YF0_Video1_Samples_ET.mat, Fractals, 120, 7437616029, 7600603045, 162987016
/Volumes/methlab_data/HBN/EEG-ET/NDARYM994YF0/NDARYM994YF0_Video2_Samples_ET.mat, Despicable, 120, 8237092221, 8407634889, 170542668
/Volumes/methlab_data/HBN/EEG-ET/NDARYM994YF0/NDARYM994YF0_Video3_Samples_ET.mat, Diary, 120, 8801228337, 8918625519, 117397182
/Volumes/methlab_data/HBN/EEG-ET/NDARYM994YF0/NDARYM994YF0_Video4_Samples_ET.mat, Present, 120, 9434073804, 9637141595, 203067791
/Volumes/methlab_data/HBN/EEG-ET/NDARYN174NPH/NDARYN174NPH_Video1_Samples_ET.mat, Despicable, 120, 7022743486, 7193289008, 170545522
/Volumes/methlab_data/HBN/EEG-ET/NDARYN174NPH/NDARYN174NPH_Video2_Samples_ET.mat, Diary, 120, 7581417728, 7698815298, 117397570
/Volumes/methlab_data/HBN/EEG-ET/NDARYN174NPH/NDARYN174NPH_Video3_Samples_ET.mat, Fractals, 120, 7738576213, 7901563931, 162987718
/Volumes/methlab_data/HBN/EEG-ET/NDARYN174NPH/NDARYN174NPH_Video4_Samples_ET.mat, Present, 120, 7942891177, 8145953592, 203062415
/Volumes/methlab_data/HBN/EEG-ET/NDARYN254VW6/NDARYN254VW6_Video1_Samples_ET.mat, Despicable, 120, 8836477773, 9007023977, 170546204
/Volumes/methlab_data/HBN/EEG-ET/NDARYN254VW6/NDARYN254VW6_Video2_Samples_ET.mat, Diary, 120, 9980028936, 10097420820, 117391884
/Volumes/methlab_data/HBN/EEG-ET/NDARYN254VW6/NDARYN254VW6_Video3_Samples_ET.mat, Fractals, 120, 10522847735, 10685835572, 162987837
/Volumes/methlab_data/HBN/EEG-ET/NDARYN254VW6/NDARYN254VW6_Video4_Samples_ET.mat, Present, 120, 11289054187, 11492121491, 203067304
/Volumes/methlab_data/HBN/EEG-ET/NDARYN484LLR/NDARYN484LLR_Video1_Samples_ET.mat, Diary, 60, 2256355081, 2373745893, 117390812
/Volumes/methlab_data/HBN/EEG-ET/NDARYN484LLR/NDARYN484LLR_Video3_Samples_ET.mat, Despicable, 60, 3509788035, 3680331335, 170543300
/Volumes/methlab_data/HBN/EEG-ET/NDARYN595JMA/NDARYN595JMA_Video1_Samples_ET.mat, Diary, 60, 1805898200, 1923288166, 117389966
/Volumes/methlab_data/HBN/EEG-ET/NDARYN595JMA/NDARYN595JMA_Video2_Samples_ET.mat, Fractals, 60, 1970249319, 2133238525, 162989206
/Volumes/methlab_data/HBN/EEG-ET/NDARYN595JMA/NDARYN595JMA_Video3_Samples_ET.mat, Despicable, 60, 1586927464, 1757467999, 170540535
/Volumes/methlab_data/HBN/EEG-ET/NDARYN595JMA/NDARYN595JMA_Video4_Samples_ET.mat, Present, 60, 2171970876, 2375063407, 203092531
/Volumes/methlab_data/HBN/EEG-ET/NDARYN857XMX/NDARYN857XMX_Video-DM_Samples_ET.mat, Despicable, 60, 5172830954, 5343372345, 170541391
/Volumes/methlab_data/HBN/EEG-ET/NDARYN857XMX/NDARYN857XMX_Video-FF_Samples_ET.mat, Fractals, 60, 4708288998, 4871270072, 162981074
/Volumes/methlab_data/HBN/EEG-ET/NDARYN857XMX/NDARYN857XMX_Video-TP_Samples_ET.mat, Present, 60, 5662074312, 5865134677, 203060365
/Volumes/methlab_data/HBN/EEG-ET/NDARYN857XMX/NDARYN857XMX_Video-WK_Samples_ET.mat, Diary, 60, 4156408403, 4273801305, 117392902
/Volumes/methlab_data/HBN/EEG-ET/NDARYP863PZ4/NDARYP863PZ4_Video-DM_Samples_ET.mat, Despicable, 30, 7782964430, 7953500188, 170535758
/Volumes/methlab_data/HBN/EEG-ET/NDARYP863PZ4/NDARYP863PZ4_Video-TP_Samples_ET.mat, Present, 30, 8293956200, 8497235148, 203278948
/Volumes/methlab_data/HBN/EEG-ET/NDARYP863PZ4/NDARYP863PZ4_Video-WK_Samples_ET.mat, Diary, 30, 5448155433, 5565552553, 117397120
/Volumes/methlab_data/HBN/EEG-ET/NDARYR150UDP/NDARYR150UDP_Video1_Samples_ET.mat, Diary, 60, 3395986054, 3513389543, 117403489
/Volumes/methlab_data/HBN/EEG-ET/NDARYR150UDP/NDARYR150UDP_Video3_Samples_ET.mat, Despicable, 60, 850045832, 1020627668, 170581836
/Volumes/methlab_data/HBN/EEG-ET/NDARYR771VED/NDARYR771VED_Video1_Samples_ET.mat, Diary, 60, 2971759927, 3089149175, 117389248
/Volumes/methlab_data/HBN/EEG-ET/NDARYR771VED/NDARYR771VED_Video3_Samples_ET.mat, Despicable, 60, 3509563175, 3680112769, 170549594
/Volumes/methlab_data/HBN/EEG-ET/NDARYT155NHX/NDARYT155NHX_Video1_Samples_ET.mat, Diary, 60, 4049969754, 4167360728, 117390974
/Volumes/methlab_data/HBN/EEG-ET/NDARYT155NHX/NDARYT155NHX_Video3_Samples_ET.mat, Despicable, 60, 4418184940, 4588727464, 170542524
/Volumes/methlab_data/HBN/EEG-ET/NDARYT269WAP/NDARYT269WAP_Video-DM_Samples_ET.mat, Despicable, 60, 2529200105, 2699741456, 170541351
/Volumes/methlab_data/HBN/EEG-ET/NDARYT269WAP/NDARYT269WAP_Video-FF_Samples_ET.mat, Fractals, 60, 1861891268, 2024875283, 162984015
/Volumes/methlab_data/HBN/EEG-ET/NDARYT269WAP/NDARYT269WAP_Video-TP_Samples_ET.mat, Present, 60, 3473926687, 3676988995, 203062308
/Volumes/methlab_data/HBN/EEG-ET/NDARYT269WAP/NDARYT269WAP_Video-WK_Samples_ET.mat, Diary, 60, 2992903295, 3110297140, 117393845
/Volumes/methlab_data/HBN/EEG-ET/NDARYT332LMM/NDARYT332LMM_Video1_Samples_ET.mat, Diary, 60, 4212668346, 4330064280, 117395934
/Volumes/methlab_data/HBN/EEG-ET/NDARYT332LMM/NDARYT332LMM_Video2_Samples_ET.mat, Fractals, 60, 3545321005, 3708306137, 162985132
/Volumes/methlab_data/HBN/EEG-ET/NDARYT332LMM/NDARYT332LMM_Video3_Samples_ET.mat, Despicable, 60, 4618876249, 4789419708, 170543459
/Volumes/methlab_data/HBN/EEG-ET/NDARYT405NET/NDARYT405NET_Video1_Samples_ET.mat, Diary, 120, 2886658965, 3004056325, 117397360
/Volumes/methlab_data/HBN/EEG-ET/NDARYT405NET/NDARYT405NET_Video2_Samples_ET.mat, Fractals, 120, 4087130479, 4250128654, 162998175
/Volumes/methlab_data/HBN/EEG-ET/NDARYT405NET/NDARYT405NET_Video3_Samples_ET.mat, Despicable, 120, 4589057440, 4759614778, 170557338
/Volumes/methlab_data/HBN/EEG-ET/NDARYT405NET/NDARYT405NET_Video4_Samples_ET.mat, Present, 120, 5275483953, 5478551515, 203067562
/Volumes/methlab_data/HBN/EEG-ET/NDARYU120NDA/NDARYU120NDA_Video1_Samples_ET.mat, Diary, 60, 2473233783, 2590627809, 117394026
/Volumes/methlab_data/HBN/EEG-ET/NDARYU120NDA/NDARYU120NDA_Video3_Samples_ET.mat, Despicable, 60, 3512992931, 3683536501, 170543570
/Volumes/methlab_data/HBN/EEG-ET/NDARYU120NDA/NDARYU120NDA_Video4_Samples_ET.mat, Present, 60, 3974318069, 4177447700, 203129631
/Volumes/methlab_data/HBN/EEG-ET/NDARYU575CE2/NDARYU575CE2_Video1_Samples_ET.mat, Diary, 60, 8289399179, 8406795151, 117395972
/Volumes/methlab_data/HBN/EEG-ET/NDARYU575CE2/NDARYU575CE2_Video3_Samples_ET.mat, Despicable, 60, 9589027552, 9759571074, 170543522
/Volumes/methlab_data/HBN/EEG-ET/NDARYU575CE2/NDARYU575CE2_Video4_Samples_ET.mat, Present, 60, 10109682462, 10312749963, 203067501
/Volumes/methlab_data/HBN/EEG-ET/NDARYU620RH9/NDARYU620RH9_Video1_Samples_ET.mat, Diary, 60, 2753250836, 2870641809, 117390973
/Volumes/methlab_data/HBN/EEG-ET/NDARYU620RH9/NDARYU620RH9_Video3_Samples_ET.mat, Despicable, 60, 4028142736, 4198691264, 170548528
/Volumes/methlab_data/HBN/EEG-ET/NDARYU719EPL/NDARYU719EPL_Video-DM_Samples_ET.mat, Despicable, 30, 3895170051, 4065706636, 170536585
/Volumes/methlab_data/HBN/EEG-ET/NDARYU719EPL/NDARYU719EPL_Video-TP_Samples_ET.mat, Present, 30, 4396274321, 4599549052, 203274731
/Volumes/methlab_data/HBN/EEG-ET/NDARYU719EPL/NDARYU719EPL_Video-WK_Samples_ET.mat, Diary, 30, 2691304908, 2808690920, 117386012
/Volumes/methlab_data/HBN/EEG-ET/NDARYV120ZLG/NDARYV120ZLG_Video1_Samples_ET.mat, Diary, 60, 7408731595, 7526119574, 117387979
/Volumes/methlab_data/HBN/EEG-ET/NDARYV120ZLG/NDARYV120ZLG_Video3_Samples_ET.mat, Despicable, 60, 7786762724, 7957311264, 170548540
/Volumes/methlab_data/HBN/EEG-ET/NDARYW170CAA/NDARYW170CAA_Video-DM_Samples_ET.mat, Despicable, 30, 1122644107, 1293180655, 170536548
/Volumes/methlab_data/HBN/EEG-ET/NDARYW170CAA/NDARYW170CAA_Video-TP_Samples_ET.mat, Present, 30, 1768196285, 1971476954, 203280669
/Volumes/methlab_data/HBN/EEG-ET/NDARYW170CAA/NDARYW170CAA_Video-WK_Samples_ET.mat, Diary, 30, 1333461081, 1450849047, 117387966
/Volumes/methlab_data/HBN/EEG-ET/NDARYW514CH2/NDARYW514CH2_Video-DM_Samples_ET.mat, Despicable, 120, 4559667521, 4730214386, 170546865
/Volumes/methlab_data/HBN/EEG-ET/NDARYW514CH2/NDARYW514CH2_Video-FF_Samples_ET.mat, Fractals, 120, 3875101283, 4038088022, 162986739
/Volumes/methlab_data/HBN/EEG-ET/NDARYW514CH2/NDARYW514CH2_Video-TP_Samples_ET.mat, Present, 120, 4995194647, 5198261390, 203066743
/Volumes/methlab_data/HBN/EEG-ET/NDARYW514CH2/NDARYW514CH2_Video-WK_Samples_ET.mat, Diary, 120, 4779186227, 4896582968, 117396741
/Volumes/methlab_data/HBN/EEG-ET/NDARYW789GNP/NDARYW789GNP_Video-DM_Samples_ET.mat, Despicable, 60, 4059802673, 4230340257, 170537584
/Volumes/methlab_data/HBN/EEG-ET/NDARYW789GNP/NDARYW789GNP_Video-TP_Samples_ET.mat, Present, 60, 5031856901, 5235123640, 203266739
/Volumes/methlab_data/HBN/EEG-ET/NDARYW789GNP/NDARYW789GNP_Video-WK_Samples_ET.mat, Diary, 60, 4546358659, 4663746673, 117388014
/Volumes/methlab_data/HBN/EEG-ET/NDARYW903VN8/NDARYW903VN8_Video1_Samples_ET.mat, Diary, 60, 1756869717, 1874254742, 117385025
/Volumes/methlab_data/HBN/EEG-ET/NDARYW903VN8/NDARYW903VN8_Video3_Samples_ET.mat, Despicable, 60, 1338612024, 1509160594, 170548570
/Volumes/methlab_data/HBN/EEG-ET/NDARYW945PJU/NDARYW945PJU_Video-DM_Samples_ET.mat, Despicable, 120, 9416840868, 9587386609, 170545741
/Volumes/methlab_data/HBN/EEG-ET/NDARYW945PJU/NDARYW945PJU_Video-FF_Samples_ET.mat, Fractals, 120, 8483061814, 8646048219, 162986405
/Volumes/methlab_data/HBN/EEG-ET/NDARYW945PJU/NDARYW945PJU_Video-TP_Samples_ET.mat, Present, 120, 10445974121, 10649041366, 203067245
/Volumes/methlab_data/HBN/EEG-ET/NDARYW945PJU/NDARYW945PJU_Video-WK_Samples_ET.mat, Diary, 120, 9860700749, 9978091188, 117390439
/Volumes/methlab_data/HBN/EEG-ET/NDARYW946VTC/NDARYW946VTC_Video-DM_Samples_ET.mat, Despicable, 30, 1557716580, 1611136322, 1781672855
2.239563e+08, 1.705365e+08, /Volumes/methlab_data/HBN/EEG-ET/NDARYX008UCU/NDARYX008UCU_Video1_Samples_ET.mat, Fractals, 120, 2872929077, 3035915925, 162986848
/Volumes/methlab_data/HBN/EEG-ET/NDARYX008UCU/NDARYX008UCU_Video2_Samples_ET.mat, Despicable, 120, 3746376766, 3916920712, 170543946
/Volumes/methlab_data/HBN/EEG-ET/NDARYX008UCU/NDARYX008UCU_Video3_Samples_ET.mat, Diary, 120, 4211076218, 4328468579, 117392361
/Volumes/methlab_data/HBN/EEG-ET/NDARYX008UCU/NDARYX008UCU_Video4_Samples_ET.mat, Present, 120, 4787897452, 4990958061, 203060609
/Volumes/methlab_data/HBN/EEG-ET/NDARYX133FFQ/NDARYX133FFQ_Video-DM_Samples_ET.mat, Despicable, 30, 3840940495, 4011485374, 170544879
/Volumes/methlab_data/HBN/EEG-ET/NDARYX133FFQ/NDARYX133FFQ_Video-TP_Samples_ET.mat, Present, 30, 4324193969, 4527472085, 203278116
/Volumes/methlab_data/HBN/EEG-ET/NDARYX133FFQ/NDARYX133FFQ_Video-WK_Samples_ET.mat, Diary, 30, 3263732434, 3381121646, 117389212
/Volumes/methlab_data/HBN/EEG-ET/NDARYX551LBY/NDARYX551LBY_Video1_Samples_ET.mat, Diary, 60, 1959284475, 2076681452, 117396977
/Volumes/methlab_data/HBN/EEG-ET/NDARYX551LBY/NDARYX551LBY_Video3_Samples_ET.mat, Despicable, 60, 3090557261, 3261101855, 170544594
/Volumes/methlab_data/HBN/EEG-ET/NDARYX572VEW/NDARYX572VEW_Video-DM_Samples_ET.mat, Despicable, 60, 871639884, 1042187315, 170547431
/Volumes/methlab_data/HBN/EEG-ET/NDARYX572VEW/NDARYX572VEW_Video-TP_Samples_ET.mat, Present, 60, 1506212867, 1709482372, 203269505
/Volumes/methlab_data/HBN/EEG-ET/NDARYX572VEW/NDARYX572VEW_Video-WK_Samples_ET.mat, Diary, 60, 428414984, 545812901, 117397917
/Volumes/methlab_data/HBN/EEG-ET/NDARYX592YYR/NDARYX592YYR_Video1_Samples_ET.mat, Despicable, 120, 3691346034, 3861893294, 170547260
/Volumes/methlab_data/HBN/EEG-ET/NDARYX592YYR/NDARYX592YYR_Video2_Samples_ET.mat, Diary, 120, 3949753913, 4067152165, 117398252
/Volumes/methlab_data/HBN/EEG-ET/NDARYX592YYR/NDARYX592YYR_Video3_Samples_ET.mat, Fractals, 120, 4161473152, 4324469908, 162996756
/Volumes/methlab_data/HBN/EEG-ET/NDARYX592YYR/NDARYX592YYR_Video4_Samples_ET.mat, Present, 120, 4434551004, 4637629008, 203078004
/Volumes/methlab_data/HBN/EEG-ET/NDARYX806FL1/NDARYX806FL1_Video1_Samples_ET.mat, Diary, 60, 3429918393, 3547312486, 117394093
/Volumes/methlab_data/HBN/EEG-ET/NDARYX806FL1/NDARYX806FL1_Video2_Samples_ET.mat, Fractals, 60, 2283927468, 2446920822, 162993354
/Volumes/methlab_data/HBN/EEG-ET/NDARYX806FL1/NDARYX806FL1_Video3_Samples_ET.mat, Despicable, 60, 2974793328, 3145344058, 170550730
/Volumes/methlab_data/HBN/EEG-ET/NDARYX806FL1/NDARYX806FL1_Video4_Samples_ET.mat, Present, 60, 3866427297, 4069486037, 203058740
/Volumes/methlab_data/HBN/EEG-ET/NDARYX853TAX/NDARYX853TAX_Video-DM_Samples_ET.mat, Despicable, 30, 4799419129, 4969954892, 170535763
/Volumes/methlab_data/HBN/EEG-ET/NDARYX853TAX/NDARYX853TAX_Video-TP_Samples_ET.mat, Present, 30, 5311493670, 5514771611, 203277941
/Volumes/methlab_data/HBN/EEG-ET/NDARYX853TAX/NDARYX853TAX_Video-WK_Samples_ET.mat, Diary, 30, 2551733845, 2669119934, 117386089
/Volumes/methlab_data/HBN/EEG-ET/NDARYY022HBW/NDARYY022HBW_Video1_Samples_ET.mat, Diary, 120, 3129471619, 3246868766, 117397147
/Volumes/methlab_data/HBN/EEG-ET/NDARYY022HBW/NDARYY022HBW_Video2_Samples_ET.mat, Fractals, 120, 3729608238, 3892595613, 162987375
/Volumes/methlab_data/HBN/EEG-ET/NDARYY022HBW/NDARYY022HBW_Video3_Samples_ET.mat, Despicable, 120, 4278465946, 4449012974, 170547028
/Volumes/methlab_data/HBN/EEG-ET/NDARYY022HBW/NDARYY022HBW_Video4_Samples_ET.mat, Present, 120, 4972601866, 5175679558, 203077692
/Volumes/methlab_data/HBN/EEG-ET/NDARYY218AGA/NDARYY218AGA_Video1_Samples_ET.mat, Diary, 60, 2090644455, 2208038349, 117393894
/Volumes/methlab_data/HBN/EEG-ET/NDARYY218AGA/NDARYY218AGA_Video3_Samples_ET.mat, Despicable, 60, 1671876825, 1842422479, 170545654
/Volumes/methlab_data/HBN/EEG-ET/NDARYY218LU2/NDARYY218LU2_Video1_Samples_ET.mat, Despicable, 120, 1617558478, 1704118302, 1874659115
2.571006e+08, 1.705408e+08, /Volumes/methlab_data/HBN/EEG-ET/NDARYY218LU2/NDARYY218LU2_Video2_Samples_ET.mat, Fractals, 120, 1933925320, 2096912628, 162987308
/Volumes/methlab_data/HBN/EEG-ET/NDARYY218LU2/NDARYY218LU2_Video3_Samples_ET.mat, Diary, 120, 2222183674, 2339581203, 117397529
/Volumes/methlab_data/HBN/EEG-ET/NDARYY218LU2/NDARYY218LU2_Video4_Samples_ET.mat, Present, 120, 2403402805, 2606479698, 203076893
/Volumes/methlab_data/HBN/EEG-ET/NDARYY664KHF/NDARYY664KHF_Video1_Samples_ET.mat, Diary, 60, 2588940112, 2706334339, 117394227
/Volumes/methlab_data/HBN/EEG-ET/NDARYY664KHF/NDARYY664KHF_Video3_Samples_ET.mat, Despicable, 60, 3161291751, 3331833623, 170541872
/Volumes/methlab_data/HBN/EEG-ET/NDARYY664KHF/NDARYY664KHF_Video4_Samples_ET.mat, Present, 60, 4101665188, 4304726110, 203060922
/Volumes/methlab_data/HBN/EEG-ET/NDARYY670UC8/NDARYY670UC8_Video-DM_Samples_ET.mat, Despicable, 60, 4702822778, 4873370595, 170547817
/Volumes/methlab_data/HBN/EEG-ET/NDARYY670UC8/NDARYY670UC8_Video-TP_Samples_ET.mat, Present, 60, 5226168295, 5429436252, 203267957
/Volumes/methlab_data/HBN/EEG-ET/NDARYY670UC8/NDARYY670UC8_Video-WK_Samples_ET.mat, Diary, 60, 3293090717, 3410482884, 117392167
/Volumes/methlab_data/HBN/EEG-ET/NDARYY694NE7/NDARYY694NE7_Video1_Samples_ET.mat, Fractals, 120, 4457991747, 4620978178, 162986431
/Volumes/methlab_data/HBN/EEG-ET/NDARYY694NE7/NDARYY694NE7_Video2_Samples_ET.mat, Despicable, 120, 5168618322, 5339162003, 170543681
/Volumes/methlab_data/HBN/EEG-ET/NDARYY694NE7/NDARYY694NE7_Video3_Samples_ET.mat, Diary, 120, 5672021783, 5789409952, 117388169
/Volumes/methlab_data/HBN/EEG-ET/NDARYY694NE7/NDARYY694NE7_Video4_Samples_ET.mat, Present, 120, 6341950631, 6545017357, 203066726
/Volumes/methlab_data/HBN/EEG-ET/NDARYY793DXM/NDARYY793DXM_Video-DM_Samples_ET.mat, Despicable, 60, 3131805595, 3302346066, 170540471
/Volumes/methlab_data/HBN/EEG-ET/NDARYY793DXM/NDARYY793DXM_Video-FF_Samples_ET.mat, Fractals, 60, 2703470198, 2866449289, 162979091
/Volumes/methlab_data/HBN/EEG-ET/NDARYY793DXM/NDARYY793DXM_Video-TP_Samples_ET.mat, Present, 60, 3662285067, 3865344432, 203059365
/Volumes/methlab_data/HBN/EEG-ET/NDARYY793DXM/NDARYY793DXM_Video-WK_Samples_ET.mat, Diary, 60, 2058891173, 2176284070, 117392897
/Volumes/methlab_data/HBN/EEG-ET/NDARYZ363HP4/NDARYZ363HP4_Video1_Samples_ET.mat, Despicable, 120, 2526294857, 2580662931, 2751210703
2.249158e+08, 1.705478e+08, /Volumes/methlab_data/HBN/EEG-ET/NDARYZ363HP4/NDARYZ363HP4_Video2_Samples_ET.mat, Fractals, 120, 2778261070, 2941259356, 162998286
/Volumes/methlab_data/HBN/EEG-ET/NDARYZ363HP4/NDARYZ363HP4_Video3_Samples_ET.mat, Diary, 120, 2963270995, 3080668644, 117397649
/Volumes/methlab_data/HBN/EEG-ET/NDARYZ363HP4/NDARYZ363HP4_Video4_Samples_ET.mat, Present, 120, 3100470950, 3303546930, 203075980
/Volumes/methlab_data/HBN/EEG-ET/NDARYZ408VWW/NDARYZ408VWW_Video2_Samples_ET.mat, Despicable, 120, 2651708892, 2822256293, 170547401
/Volumes/methlab_data/HBN/EEG-ET/NDARYZ408VWW/NDARYZ408VWW_Video3_Samples_ET.mat, Diary, 120, 3058896340, 3176293494, 117397154
/Volumes/methlab_data/HBN/EEG-ET/NDARYZ489EHH/NDARYZ489EHH_Video-DM_Samples_ET.mat, Despicable, 60, 3260216170, 3430758516, 170542346
/Volumes/methlab_data/HBN/EEG-ET/NDARYZ489EHH/NDARYZ489EHH_Video-FF_Samples_ET.mat, Fractals, 60, 3762028834, 3925025692, 162996858
/Volumes/methlab_data/HBN/EEG-ET/NDARYZ489EHH/NDARYZ489EHH_Video-TP_Samples_ET.mat, Present, 60, 4440260886, 4643322223, 203061337
/Volumes/methlab_data/HBN/EEG-ET/NDARYZ489EHH/NDARYZ489EHH_Video-WK_Samples_ET.mat, Diary, 60, 3976354164, 4093749618, 117395454
/Volumes/methlab_data/HBN/EEG-ET/NDARYZ637LK4/NDARYZ637LK4_Video-DM_Samples_ET.mat, Despicable, 60, 2488755855, 2659302356, 170546501
/Volumes/methlab_data/HBN/EEG-ET/NDARYZ637LK4/NDARYZ637LK4_Video-FF_Samples_ET.mat, Fractals, 60, 2007771133, 2170754267, 162983134
/Volumes/methlab_data/HBN/EEG-ET/NDARYZ637LK4/NDARYZ637LK4_Video-TP_Samples_ET.mat, Present, 60, 3541930731, 3744987136, 203056405
/Volumes/methlab_data/HBN/EEG-ET/NDARYZ637LK4/NDARYZ637LK4_Video-WK_Samples_ET.mat, Diary, 60, 3016903902, 3134299816, 117395914
/Volumes/methlab_data/HBN/EEG-ET/NDARYZ693DE2/NDARYZ693DE2_Video1_Samples_ET.mat, Diary, 60, 4515643879, 4633034872, 117390993
/Volumes/methlab_data/HBN/EEG-ET/NDARYZ693DE2/NDARYZ693DE2_Video2_Samples_ET.mat, Fractals, 60, 3253987875, 3416975132, 162987257
/Volumes/methlab_data/HBN/EEG-ET/NDARYZ693DE2/NDARYZ693DE2_Video3_Samples_ET.mat, Despicable, 60, 3973960897, 4144510494, 170549597
/Volumes/methlab_data/HBN/EEG-ET/NDARYZ693DE2/NDARYZ693DE2_Video4_Samples_ET.mat, Present, 60, 5006328783, 5209397376, 203068593
/Volumes/methlab_data/HBN/EEG-ET/NDARYZ770NA1/NDARYZ770NA1_Video1_Samples_ET.mat, Diary, 60, 8101442953, 8218838836, 117395883
/Volumes/methlab_data/HBN/EEG-ET/NDARYZ770NA1/NDARYZ770NA1_Video3_Samples_ET.mat, Despicable, 60, 7636893997, 7807432407, 170538410
/Volumes/methlab_data/HBN/EEG-ET/NDARYZ909VND/NDARYZ909VND_Video1_Samples_ET.mat, Diary, 60, 624868854, 742260552, 117391698
/Volumes/methlab_data/HBN/EEG-ET/NDARYZ909VND/NDARYZ909VND_Video3_Samples_ET.mat, Despicable, 60, 174233560, 344781534, 170547974
/Volumes/methlab_data/HBN/EEG-ET/NDARZ6064CX2/NDARZ6064CX2_Video-DM_Samples_ET.mat, Despicable, 60, 5102522307, 5273075952, 170553645
/Volumes/methlab_data/HBN/EEG-ET/NDARZ6064CX2/NDARZ6064CX2_Video-FF_Samples_ET.mat, Fractals, 60, 4647217285, 4810201575, 162984290
/Volumes/methlab_data/HBN/EEG-ET/NDARZ6064CX2/NDARZ6064CX2_Video-TP_Samples_ET.mat, Present, 60, 5656144871, 5859205601, 203060730
/Volumes/methlab_data/HBN/EEG-ET/NDARZ6064CX2/NDARZ6064CX2_Video-WK_Samples_ET.mat, Diary, 60, 4116715092, 4234110135, 117395043
/Volumes/methlab_data/HBN/EEG-ET/NDARZA183DDY/NDARZA183DDY_Video-DM_Samples_ET.mat, Despicable, 60, 7077097883, 7247640482, 170542599
/Volumes/methlab_data/HBN/EEG-ET/NDARZA183DDY/NDARZA183DDY_Video-FF_Samples_ET.mat, Fractals, 60, 6650211088, 6813205332, 162994244
/Volumes/methlab_data/HBN/EEG-ET/NDARZA183DDY/NDARZA183DDY_Video-TP_Samples_ET.mat, Present, 60, 7579759277, 7782822855, 203063578
/Volumes/methlab_data/HBN/EEG-ET/NDARZA183DDY/NDARZA183DDY_Video-WK_Samples_ET.mat, Diary, 60, 5978935472, 6096329503, 117394031
/Volumes/methlab_data/HBN/EEG-ET/NDARZA511FYF/NDARZA511FYF_Video1_Samples_ET.mat, Diary, 60, 2714967244, 2832358287, 117391043
/Volumes/methlab_data/HBN/EEG-ET/NDARZA511FYF/NDARZA511FYF_Video2_Samples_ET.mat, Fractals, 60, 3928612297, 4091599551, 162987254
/Volumes/methlab_data/HBN/EEG-ET/NDARZA511FYF/NDARZA511FYF_Video3_Samples_ET.mat, Despicable, 60, 3498959527, 3669503123, 170543596
/Volumes/methlab_data/HBN/EEG-ET/NDARZA511FYF/NDARZA511FYF_Video4_Samples_ET.mat, Present, 60, 4452047380, 4655118968, 203071588
/Volumes/methlab_data/HBN/EEG-ET/NDARZA694WHF/NDARZA694WHF_Video1_Samples_ET.mat, Diary, 60, 2167080993, 2284464960, 117383967
/Volumes/methlab_data/HBN/EEG-ET/NDARZA694WHF/NDARZA694WHF_Video3_Samples_ET.mat, Despicable, 60, 2778045316, 2948583716, 170538400
/Volumes/methlab_data/HBN/EEG-ET/NDARZA982YTP/NDARZA982YTP_Video-DM_Samples_ET.mat, Despicable, 30, 64559125156, 64729821859, 170696703
/Volumes/methlab_data/HBN/EEG-ET/NDARZA982YTP/NDARZA982YTP_Video-TP_Samples_ET.mat, Present, 30, 65045958345, 65249237117, 203278772
/Volumes/methlab_data/HBN/EEG-ET/NDARZA982YTP/NDARZA982YTP_Video-WK_Samples_ET.mat, Diary, 30, 63651431418, 63768821433, 117390015
/Volumes/methlab_data/HBN/EEG-ET/NDARZB128KCF/NDARZB128KCF_Video-DM_Samples_ET.mat, Despicable, 120, 3597040880, 3767588018, 170547138
/Volumes/methlab_data/HBN/EEG-ET/NDARZB128KCF/NDARZB128KCF_Video-FF_Samples_ET.mat, Fractals, 120, 3084463441, 3247451374, 162987933
/Volumes/methlab_data/HBN/EEG-ET/NDARZB128KCF/NDARZB128KCF_Video-TP_Samples_ET.mat, Present, 120, 4322974790, 4526035660, 203060870
/Volumes/methlab_data/HBN/EEG-ET/NDARZB128KCF/NDARZB128KCF_Video-WK_Samples_ET.mat, Diary, 120, 2239419251, 2356816072, 117396821
/Volumes/methlab_data/HBN/EEG-ET/NDARZB323LHZ/NDARZB323LHZ_Video1_Samples_ET.mat, Diary, 60, 4226994225, 4344388406, 117394181
/Volumes/methlab_data/HBN/EEG-ET/NDARZB323LHZ/NDARZB323LHZ_Video3_Samples_ET.mat, Despicable, 60, 3785809919, 3956352674, 170542755
/Volumes/methlab_data/HBN/EEG-ET/NDARZB345GKD/NDARZB345GKD_Video-DM_Samples_ET.mat, Despicable, 60, 3756243926, 3926789609, 170545683
/Volumes/methlab_data/HBN/EEG-ET/NDARZB345GKD/NDARZB345GKD_Video-FF_Samples_ET.mat, Fractals, 60, 3316258732, 3479243025, 162984293
/Volumes/methlab_data/HBN/EEG-ET/NDARZB345GKD/NDARZB345GKD_Video-TP_Samples_ET.mat, Present, 60, 4240887692, 4443952331, 203064639
/Volumes/methlab_data/HBN/EEG-ET/NDARZB345GKD/NDARZB345GKD_Video-WK_Samples_ET.mat, Diary, 60, 2608932460, 2726327507, 117395047
/Volumes/methlab_data/HBN/EEG-ET/NDARZB377WZJ/NDARZB377WZJ_Video1_Samples_ET.mat, Diary, 60, 2230292179, 2347686580, 117394401
/Volumes/methlab_data/HBN/EEG-ET/NDARZB377WZJ/NDARZB377WZJ_Video3_Samples_ET.mat, Despicable, 60, 1739062207, 1909601383, 170539176
/Volumes/methlab_data/HBN/EEG-ET/NDARZB799GAK/NDARZB799GAK_Video-DM_Samples_ET.mat, Despicable, 30, 79863808210, 80034343900, 170535690
/Volumes/methlab_data/HBN/EEG-ET/NDARZB799GAK/NDARZB799GAK_Video-TP_Samples_ET.mat, Present, 30, 80734008991, 80937280847, 203271856
/Volumes/methlab_data/HBN/EEG-ET/NDARZB799GAK/NDARZB799GAK_Video-WK_Samples_ET.mat, Diary, 30, 80301230754, 80418620830, 117390076
/Volumes/methlab_data/HBN/EEG-ET/NDARZC021TF4/NDARZC021TF4_Video-DM_Samples_ET.mat, Despicable, 30, 1406911452, 1577449910, 170538458
/Volumes/methlab_data/HBN/EEG-ET/NDARZC344VH2/NDARZC344VH2_Video1_Samples_ET.mat, Diary, 60, 9453556899, 9570952932, 117396033
/Volumes/methlab_data/HBN/EEG-ET/NDARZC344VH2/NDARZC344VH2_Video3_Samples_ET.mat, Despicable, 60, 9858747389, 10029298954, 170551565
/Volumes/methlab_data/HBN/EEG-ET/NDARZC344VH2/NDARZC344VH2_Video4_Samples_ET.mat, Present, 60, 10344813024, 10547885669, 203072645
/Volumes/methlab_data/HBN/EEG-ET/NDARZC499NVX/NDARZC499NVX_Video1_Samples_ET.mat, Diary, 60, 6367664119, 6485057192, 117393073
/Volumes/methlab_data/HBN/EEG-ET/NDARZC499NVX/NDARZC499NVX_Video3_Samples_ET.mat, Despicable, 60, 5591099882, 5761640665, 170540783
/Volumes/methlab_data/HBN/EEG-ET/NDARZD099KWW/NDARZD099KWW_Video1_Samples_ET.mat, Diary, 60, 1837762436, 1955169356, 117406920
/Volumes/methlab_data/HBN/EEG-ET/NDARZD099KWW/NDARZD099KWW_Video3_Samples_ET.mat, Despicable, 60, 540642384, 711192196, 170549812
/Volumes/methlab_data/HBN/EEG-ET/NDARZD415ZZ1/NDARZD415ZZ1_Video1_Samples_ET.mat, Diary, 120, 3908743634, 4026140985, 117397351
/Volumes/methlab_data/HBN/EEG-ET/NDARZD415ZZ1/NDARZD415ZZ1_Video2_Samples_ET.mat, Fractals, 120, 5469343304, 5632329709, 162986405
/Volumes/methlab_data/HBN/EEG-ET/NDARZD415ZZ1/NDARZD415ZZ1_Video3_Samples_ET.mat, Despicable, 120, 5919639789, 6090186698, 170546909
/Volumes/methlab_data/HBN/EEG-ET/NDARZD415ZZ1/NDARZD415ZZ1_Video4_Samples_ET.mat, Present, 120, 6710225215, 6913291934, 203066719
/Volumes/methlab_data/HBN/EEG-ET/NDARZD985LU8/NDARZD985LU8_Video-DM_Samples_ET.mat, Despicable, 120, 13939928485, 14110474955, 170546470
/Volumes/methlab_data/HBN/EEG-ET/NDARZD985LU8/NDARZD985LU8_Video-FF_Samples_ET.mat, Fractals, 120, 13136913462, 13299910462, 162997000
/Volumes/methlab_data/HBN/EEG-ET/NDARZD985LU8/NDARZD985LU8_Video-TP_Samples_ET.mat, Present, 120, 15144420845, 15347488652, 203067807
/Volumes/methlab_data/HBN/EEG-ET/NDARZD985LU8/NDARZD985LU8_Video-WK_Samples_ET.mat, Diary, 120, 14504568100, 14621957791, 117389691
/Volumes/methlab_data/HBN/EEG-ET/NDARZD991YLG/NDARZD991YLG_Video1_Samples_ET.mat, Diary, 60, 2661798728, 2779188677, 117389949
/Volumes/methlab_data/HBN/EEG-ET/NDARZD991YLG/NDARZD991YLG_Video3_Samples_ET.mat, Despicable, 60, 3516727566, 3687265042, 170537476
/Volumes/methlab_data/HBN/EEG-ET/NDARZE389XF0/NDARZE389XF0_Video-DM_Samples_ET.mat, Despicable, 60, 5119600780, 5290153426, 170552646
/Volumes/methlab_data/HBN/EEG-ET/NDARZE389XF0/NDARZE389XF0_Video-WK_Samples_ET.mat, Diary, 60, 4358205251, 4475593324, 117388073
/Volumes/methlab_data/HBN/EEG-ET/NDARZE542ZVH/NDARZE542ZVH_Video1_Samples_ET.mat, Diary, 60, 2861955271, 2979350339, 117395068
/Volumes/methlab_data/HBN/EEG-ET/NDARZE542ZVH/NDARZE542ZVH_Video3_Samples_ET.mat, Despicable, 60, 4063836725, 4234381435, 170544710
/Volumes/methlab_data/HBN/EEG-ET/NDARZE685UJ5/NDARZE685UJ5_Video-DM_Samples_ET.mat, Despicable, 120, 5662756291, 5833300694, 170544403
/Volumes/methlab_data/HBN/EEG-ET/NDARZE685UJ5/NDARZE685UJ5_Video-FF_Samples_ET.mat, Fractals, 120, 5291028736, 5454022924, 162994188
/Volumes/methlab_data/HBN/EEG-ET/NDARZE685UJ5/NDARZE685UJ5_Video-TP_Samples_ET.mat, Present, 120, 6344988612, 6548055805, 203067193
/Volumes/methlab_data/HBN/EEG-ET/NDARZE685UJ5/NDARZE685UJ5_Video-WK_Samples_ET.mat, Diary, 120, 3679777172, 3797172985, 117395813
/Volumes/methlab_data/HBN/EEG-ET/NDARZE831DKC/NDARZE831DKC_Video1_Samples_ET.mat, Fractals, 120, 3910766534, 4073752400, 162985866
/Volumes/methlab_data/HBN/EEG-ET/NDARZE831DKC/NDARZE831DKC_Video2_Samples_ET.mat, Despicable, 120, 5761122837, 5931666504, 170543667
/Volumes/methlab_data/HBN/EEG-ET/NDARZE831DKC/NDARZE831DKC_Video3_Samples_ET.mat, Diary, 120, 6304760399, 6422157380, 117396981
/Volumes/methlab_data/HBN/EEG-ET/NDARZE831DKC/NDARZE831DKC_Video4_Samples_ET.mat, Present, 120, 7019105173, 7222173023, 203067850
/Volumes/methlab_data/HBN/EEG-ET/NDARZE850WXD/NDARZE850WXD_Video1_Samples_ET.mat, Diary, 60, 3494955764, 3612349741, 117393977
/Volumes/methlab_data/HBN/EEG-ET/NDARZE850WXD/NDARZE850WXD_Video3_Samples_ET.mat, Despicable, 60, 3060282617, 3230824126, 170541509
/Volumes/methlab_data/HBN/EEG-ET/NDARZE923ZKG/NDARZE923ZKG_Video-DM_Samples_ET.mat, Despicable, 30, 4397425429, 4567964111, 170538682
/Volumes/methlab_data/HBN/EEG-ET/NDARZE923ZKG/NDARZE923ZKG_Video-WK_Samples_ET.mat, Diary, 30, 5271286794, 5388676874, 117390080
/Volumes/methlab_data/HBN/EEG-ET/NDARZE963MEU/NDARZE963MEU_Video1_Samples_ET.mat, Diary, 120, 2163723467, 2281120450, 117396983
/Volumes/methlab_data/HBN/EEG-ET/NDARZE963MEU/NDARZE963MEU_Video2_Samples_ET.mat, Fractals, 120, 2901248070, 3064235571, 162987501
/Volumes/methlab_data/HBN/EEG-ET/NDARZE963MEU/NDARZE963MEU_Video3_Samples_ET.mat, Despicable, 120, 3332675911, 3503223078, 170547167
/Volumes/methlab_data/HBN/EEG-ET/NDARZE963MEU/NDARZE963MEU_Video4_Samples_ET.mat, Present, 120, 3875562906, 4078629615, 203066709
/Volumes/methlab_data/HBN/EEG-ET/NDARZF170TZ0/NDARZF170TZ0_Video1_Samples_ET.mat, Fractals, 120, 5161537820, 5324521919, 162984099
/Volumes/methlab_data/HBN/EEG-ET/NDARZF170TZ0/NDARZF170TZ0_Video2_Samples_ET.mat, Diary, 120, 5924318213, 6041707152, 117388939
/Volumes/methlab_data/HBN/EEG-ET/NDARZF170TZ0/NDARZF170TZ0_Video3_Samples_ET.mat, Despicable, 120, 6322901506, 6493447759, 170546253
/Volumes/methlab_data/HBN/EEG-ET/NDARZF170TZ0/NDARZF170TZ0_Video4_Samples_ET.mat, Present, 120, 6983257524, 7186323792, 203066268
/Volumes/methlab_data/HBN/EEG-ET/NDARZF216KYX/NDARZF216KYX_Video-DM_Samples_ET.mat, Despicable, 60, 2946499194, 3117037482, 170538288
/Volumes/methlab_data/HBN/EEG-ET/NDARZF216KYX/NDARZF216KYX_Video-TP_Samples_ET.mat, Present, 60, 3799758953, 4003025302, 203266349
/Volumes/methlab_data/HBN/EEG-ET/NDARZF216KYX/NDARZF216KYX_Video-WK_Samples_ET.mat, Diary, 60, 3372923935, 3490312734, 117388799
/Volumes/methlab_data/HBN/EEG-ET/NDARZF292VZA/NDARZF292VZA_Video-DM_Samples_ET.mat, Despicable, 60, 5570524240, 5741072902, 170548662
/Volumes/methlab_data/HBN/EEG-ET/NDARZF292VZA/NDARZF292VZA_Video-FF_Samples_ET.mat, Fractals, 60, 4373945936, 4536935243, 162989307
/Volumes/methlab_data/HBN/EEG-ET/NDARZF292VZA/NDARZF292VZA_Video-TP_Samples_ET.mat, Present, 60, 6161220016, 6364288686, 203068670
/Volumes/methlab_data/HBN/EEG-ET/NDARZF292VZA/NDARZF292VZA_Video-WK_Samples_ET.mat, Diary, 60, 5083039461, 5200430500, 117391039
/Volumes/methlab_data/HBN/EEG-ET/NDARZF602KU6/NDARZF602KU6_Video1_Samples_ET.mat, Diary, 60, 6868098202, 6985493294, 117395092
/Volumes/methlab_data/HBN/EEG-ET/NDARZF602KU6/NDARZF602KU6_Video3_Samples_ET.mat, Despicable, 60, 6407570334, 6578117052, 170546718
/Volumes/methlab_data/HBN/EEG-ET/NDARZF615DC0/NDARZF615DC0_Video-DM_Samples_ET.mat, Despicable, 120, 6737204509, 6907751818, 170547309
/Volumes/methlab_data/HBN/EEG-ET/NDARZF615DC0/NDARZF615DC0_Video-FF_Samples_ET.mat, Fractals, 120, 5898180120, 6061166754, 162986634
/Volumes/methlab_data/HBN/EEG-ET/NDARZF615DC0/NDARZF615DC0_Video-TP_Samples_ET.mat, Present, 120, 7855718325, 8058785895, 203067570
/Volumes/methlab_data/HBN/EEG-ET/NDARZF615DC0/NDARZF615DC0_Video-WK_Samples_ET.mat, Diary, 120, 7271492947, 7388889787, 117396840
/Volumes/methlab_data/HBN/EEG-ET/NDARZF625MH8/NDARZF625MH8_Video-FF_Samples_ET.mat, Fractals, 60, 3377151608, 3540135534, 162983926
/Volumes/methlab_data/HBN/EEG-ET/NDARZF949WTW/NDARZF949WTW_Video1_Samples_ET.mat, Diary, 60, 4686233664, 4803623724, 117390060
/Volumes/methlab_data/HBN/EEG-ET/NDARZF949WTW/NDARZF949WTW_Video3_Samples_ET.mat, Despicable, 60, 4244510282, 4415060911, 170550629
/Volumes/methlab_data/HBN/EEG-ET/NDARZG236AUT/NDARZG236AUT_Video1_Samples_ET.mat, Diary, 60, 4062853816, 4180234898, 117381082
/Volumes/methlab_data/HBN/EEG-ET/NDARZG236AUT/NDARZG236AUT_Video3_Samples_ET.mat, Despicable, 60, 4497186161, 4667729875, 170543714
/Volumes/methlab_data/HBN/EEG-ET/NDARZG236AUT/NDARZG236AUT_Video4_Samples_ET.mat, Present, 60, 5127876468, 5330937177, 203060709
/Volumes/methlab_data/HBN/EEG-ET/NDARZG263HRK/NDARZG263HRK_Video1_Samples_ET.mat, Diary, 60, 3140976980, 3258369728, 117392748
/Volumes/methlab_data/HBN/EEG-ET/NDARZG263HRK/NDARZG263HRK_Video3_Samples_ET.mat, Despicable, 60, 2697340392, 2867881588, 170541196
/Volumes/methlab_data/HBN/EEG-ET/NDARZG623FYX/NDARZG623FYX_Video1_Samples_ET.mat, Diary, 60, 3944904035, 4062297916, 117393881
/Volumes/methlab_data/HBN/EEG-ET/NDARZG623FYX/NDARZG623FYX_Video3_Samples_ET.mat, Despicable, 60, 3455322391, 3625865799, 170543408
/Volumes/methlab_data/HBN/EEG-ET/NDARZG671PT1/NDARZG671PT1_Video-DM_Samples_ET.mat, Despicable, 30, 5955436865, 6125972027, 170535162
/Volumes/methlab_data/HBN/EEG-ET/NDARZG671PT1/NDARZG671PT1_Video-TP_Samples_ET.mat, Present, 30, 6171256816, 6374519895, 203263079
/Volumes/methlab_data/HBN/EEG-ET/NDARZG671PT1/NDARZG671PT1_Video-WK_Samples_ET.mat, Diary, 30, 4852415170, 4969802375, 117387205
/Volumes/methlab_data/HBN/EEG-ET/NDARZG690NHH/NDARZG690NHH_Video1_Samples_ET.mat, Diary, 60, 7129321128, 7246712121, 117390993
/Volumes/methlab_data/HBN/EEG-ET/NDARZG690NHH/NDARZG690NHH_Video2_Samples_ET.mat, Fractals, 60, 7310406128, 7473386384, 162980256
/Volumes/methlab_data/HBN/EEG-ET/NDARZG690NHH/NDARZG690NHH_Video3_Samples_ET.mat, Despicable, 60, 6911164853, 7081710450, 170545597
/Volumes/methlab_data/HBN/EEG-ET/NDARZG690NHH/NDARZG690NHH_Video4_Samples_ET.mat, Present, 60, 7528126054, 7731195636, 203069582
/Volumes/methlab_data/HBN/EEG-ET/NDARZG861CXJ/NDARZG861CXJ_Video1_Samples_ET.mat, Despicable, 120, 5931917624, 6102464482, 170546858
/Volumes/methlab_data/HBN/EEG-ET/NDARZG861CXJ/NDARZG861CXJ_Video2_Samples_ET.mat, Diary, 120, 6465124625, 6582521084, 117396459
/Volumes/methlab_data/HBN/EEG-ET/NDARZG861CXJ/NDARZG861CXJ_Video3_Samples_ET.mat, Fractals, 120, 6683651787, 6846636031, 162984244
/Volumes/methlab_data/HBN/EEG-ET/NDARZG861CXJ/NDARZG861CXJ_Video4_Samples_ET.mat, Present, 120, 6939442526, 7142508528, 203066002
/Volumes/methlab_data/HBN/EEG-ET/NDARZH366BF8/NDARZH366BF8_Video1_Samples_ET.mat, Diary, 60, 3014555143, 3131947396, 117392253
/Volumes/methlab_data/HBN/EEG-ET/NDARZH366BF8/NDARZH366BF8_Video2_Samples_ET.mat, Fractals, 60, 3718405370, 3881391998, 162986628
/Volumes/methlab_data/HBN/EEG-ET/NDARZH366BF8/NDARZH366BF8_Video3_Samples_ET.mat, Despicable, 60, 4166360113, 4336901117, 170541004
/Volumes/methlab_data/HBN/EEG-ET/NDARZH366BF8/NDARZH366BF8_Video4_Samples_ET.mat, Present, 60, 4642421922, 4845483854, 203061932
/Volumes/methlab_data/HBN/EEG-ET/NDARZH451LRZ/NDARZH451LRZ_Video1_Samples_ET.mat, Diary, 60, 2867539429, 2984933478, 117394049
/Volumes/methlab_data/HBN/EEG-ET/NDARZH451LRZ/NDARZH451LRZ_Video3_Samples_ET.mat, Despicable, 60, 3538284843, 3708826489, 170541646
/Volumes/methlab_data/HBN/EEG-ET/NDARZH517ZVK/NDARZH517ZVK_Video1_Samples_ET.mat, Diary, 60, 3044463018, 3161857958, 117394940
/Volumes/methlab_data/HBN/EEG-ET/NDARZH517ZVK/NDARZH517ZVK_Video3_Samples_ET.mat, Despicable, 60, 2804850790, 2975394253, 170543463
/Volumes/methlab_data/HBN/EEG-ET/NDARZH521MMD/NDARZH521MMD_Video1_Samples_ET.mat, Diary, 120, 4680990941, 4798388200, 117397259
/Volumes/methlab_data/HBN/EEG-ET/NDARZH521MMD/NDARZH521MMD_Video2_Samples_ET.mat, Fractals, 120, 5159478770, 5322474881, 162996111
/Volumes/methlab_data/HBN/EEG-ET/NDARZH521MMD/NDARZH521MMD_Video3_Samples_ET.mat, Despicable, 120, 5702699321, 5873252090, 170552769
/Volumes/methlab_data/HBN/EEG-ET/NDARZH521MMD/NDARZH521MMD_Video4_Samples_ET.mat, Present, 120, 6343616208, 6546678603, 203062395
/Volumes/methlab_data/HBN/EEG-ET/NDARZH629NVF/NDARZH629NVF_Video1_Samples_ET.mat, Diary, 60, 4617375109, 4734770100, 117394991
/Volumes/methlab_data/HBN/EEG-ET/NDARZH629NVF/NDARZH629NVF_Video3_Samples_ET.mat, Despicable, 60, 4392975427, 4563517012, 170541585
/Volumes/methlab_data/HBN/EEG-ET/NDARZH699ZET/NDARZH699ZET_Video-DM_Samples_ET.mat, Despicable, 60, 2344957625, 2515500995, 170543370
/Volumes/methlab_data/HBN/EEG-ET/NDARZH699ZET/NDARZH699ZET_Video-FF_Samples_ET.mat, Fractals, 60, 2842819915, 3005812938, 162993023
/Volumes/methlab_data/HBN/EEG-ET/NDARZH699ZET/NDARZH699ZET_Video-TP_Samples_ET.mat, Present, 60, 3714078649, 3917142951, 203064302
/Volumes/methlab_data/HBN/EEG-ET/NDARZH699ZET/NDARZH699ZET_Video-WK_Samples_ET.mat, Diary, 60, 1828598298, 1945995171, 117396873
/Volumes/methlab_data/HBN/EEG-ET/NDARZH761YA7/NDARZH761YA7_Video1_Samples_ET.mat, Diary, 120, 4164914061, 4282310172, 117396111
/Volumes/methlab_data/HBN/EEG-ET/NDARZH761YA7/NDARZH761YA7_Video2_Samples_ET.mat, Despicable, 120, 5647873124, 5818429370, 170556246
/Volumes/methlab_data/HBN/EEG-ET/NDARZH761YA7/NDARZH761YA7_Video3_Samples_ET.mat, Fractals, 120, 6167428301, 6330416647, 162988346
/Volumes/methlab_data/HBN/EEG-ET/NDARZH761YA7/NDARZH761YA7_Video4_Samples_ET.mat, Present, 120, 6841752247, 7044816317, 203064070
/Volumes/methlab_data/HBN/EEG-ET/NDARZJ016GL0/NDARZJ016GL0_Video1_Samples_ET.mat, Diary, 60, 4922868899, 5040259843, 117390944
/Volumes/methlab_data/HBN/EEG-ET/NDARZJ016GL0/NDARZJ016GL0_Video3_Samples_ET.mat, Despicable, 60, 4499617960, 4670164452, 170546492
/Volumes/methlab_data/HBN/EEG-ET/NDARZJ460RWZ/NDARZJ460RWZ_Video1_Samples_ET.mat, Diary, 120, 3882191795, 3999589704, 117397909
/Volumes/methlab_data/HBN/EEG-ET/NDARZJ460RWZ/NDARZJ460RWZ_Video2_Samples_ET.mat, Fractals, 120, 4727545774, 4890543834, 162998060
/Volumes/methlab_data/HBN/EEG-ET/NDARZJ460RWZ/NDARZJ460RWZ_Video3_Samples_ET.mat, Despicable, 120, 5187053759, 5357600697, 170546938
/Volumes/methlab_data/HBN/EEG-ET/NDARZJ587UZU/NDARZJ587UZU_Video1_Samples_ET.mat, Diary, 120, 3552867263, 3670263787, 117396524
/Volumes/methlab_data/HBN/EEG-ET/NDARZJ587UZU/NDARZJ587UZU_Video2_Samples_ET.mat, Fractals, 120, 4308891883, 4471879234, 162987351
/Volumes/methlab_data/HBN/EEG-ET/NDARZJ587UZU/NDARZJ587UZU_Video3_Samples_ET.mat, Despicable, 120, 4771370990, 4941913040, 170542050
/Volumes/methlab_data/HBN/EEG-ET/NDARZJ587UZU/NDARZJ587UZU_Video4_Samples_ET.mat, Present, 120, 5489935916, 5693003202, 203067286
/Volumes/methlab_data/HBN/EEG-ET/NDARZJ598BK0/NDARZJ598BK0_Video1_Samples_ET.mat, Diary, 60, 6659467307, 6776855310, 117388003
/Volumes/methlab_data/HBN/EEG-ET/NDARZJ598BK0/NDARZJ598BK0_Video3_Samples_ET.mat, Despicable, 60, 6436067356, 6606603943, 170536587
/Volumes/methlab_data/HBN/EEG-ET/NDARZJ598BK0/NDARZJ598BK0_Video4_Samples_ET.mat, Present, 60, 7122688787, 7325759373, 203070586
/Volumes/methlab_data/HBN/EEG-ET/NDARZJ603JM0/NDARZJ603JM0_Video1_Samples_ET.mat, Diary, 60, 4918556693, 5035952024, 117395331
/Volumes/methlab_data/HBN/EEG-ET/NDARZJ603JM0/NDARZJ603JM0_Video3_Samples_ET.mat, Despicable, 60, 4386226910, 4556767979, 170541069
/Volumes/methlab_data/HBN/EEG-ET/NDARZJ607YLU/NDARZJ607YLU_Video1_Samples_ET.mat, Diary, 60, 2103427745, 2220819719, 117391974
/Volumes/methlab_data/HBN/EEG-ET/NDARZJ607YLU/NDARZJ607YLU_Video3_Samples_ET.mat, Despicable, 60, 2854790452, 3025332879, 170542427
/Volumes/methlab_data/HBN/EEG-ET/NDARZK631UMQ/NDARZK631UMQ_Video-WK_Samples_ET.mat, Diary, 60, 3449364793, 3566751878, 117387085
/Volumes/methlab_data/HBN/EEG-ET/NDARZK709KEY/NDARZK709KEY_Video-DM_Samples_ET.mat, Despicable, 60, 4062500825, 4233040710, 170539885
/Volumes/methlab_data/HBN/EEG-ET/NDARZK709KEY/NDARZK709KEY_Video-TP_Samples_ET.mat, Present, 60, 4560828001, 4764096075, 203268074
/Volumes/methlab_data/HBN/EEG-ET/NDARZK732FZ0/NDARZK732FZ0_Video1_Samples_ET.mat, Diary, 60, 3289847438, 3407247464, 117400026
/Volumes/methlab_data/HBN/EEG-ET/NDARZK732FZ0/NDARZK732FZ0_Video3_Samples_ET.mat, Despicable, 60, 2847521458, 3018073497, 170552039
/Volumes/methlab_data/HBN/EEG-ET/NDARZK745JGG/NDARZK745JGG_Video-DM_Samples_ET.mat, Despicable, 120, 5435600466, 5606147899, 170547433
/Volumes/methlab_data/HBN/EEG-ET/NDARZK745JGG/NDARZK745JGG_Video-FF_Samples_ET.mat, Fractals, 120, 4526311612, 4689296725, 162985113
/Volumes/methlab_data/HBN/EEG-ET/NDARZK745JGG/NDARZK745JGG_Video-TP_Samples_ET.mat, Present, 120, 6505324011, 6708391037, 203067026
/Volumes/methlab_data/HBN/EEG-ET/NDARZK745JGG/NDARZK745JGG_Video-WK_Samples_ET.mat, Diary, 120, 5813619463, 5931016122, 117396659
/Volumes/methlab_data/HBN/EEG-ET/NDARZK753WGR/NDARZK753WGR_Video1_Samples_ET.mat, Diary, 30, 3455308196, 3572701568, 117393372
/Volumes/methlab_data/HBN/EEG-ET/NDARZK753WGR/NDARZK753WGR_Video3_Samples_ET.mat, Despicable, 30, 2975271374, 3145813475, 170542101
/Volumes/methlab_data/HBN/EEG-ET/NDARZK753WGR/NDARZK753WGR_Video4_Samples_ET.mat, Present, 30, 3903393350, 4106464559, 203071209
/Volumes/methlab_data/HBN/EEG-ET/NDARZK891FTB/NDARZK891FTB_Video-DM_Samples_ET.mat, Despicable, 120, 4315590117, 4486146501, 170556384
/Volumes/methlab_data/HBN/EEG-ET/NDARZK891FTB/NDARZK891FTB_Video-FF_Samples_ET.mat, Fractals, 120, 3626063719, 3789061675, 162997956
/Volumes/methlab_data/HBN/EEG-ET/NDARZK891FTB/NDARZK891FTB_Video-TP_Samples_ET.mat, Present, 120, 5467522448, 5670589828, 203067380
/Volumes/methlab_data/HBN/EEG-ET/NDARZK891FTB/NDARZK891FTB_Video-WK_Samples_ET.mat, Diary, 120, 4808556612, 4925953884, 117397272
/Volumes/methlab_data/HBN/EEG-ET/NDARZL113CU0/NDARZL113CU0_Video-DM_Samples_ET.mat, Despicable, 120, 4814696670, 4985243165, 170546495
/Volumes/methlab_data/HBN/EEG-ET/NDARZL113CU0/NDARZL113CU0_Video-FF_Samples_ET.mat, Fractals, 120, 4249039119, 4412023123, 162984004
/Volumes/methlab_data/HBN/EEG-ET/NDARZL113CU0/NDARZL113CU0_Video-TP_Samples_ET.mat, Present, 120, 6163447813, 6366513810, 203065997
/Volumes/methlab_data/HBN/EEG-ET/NDARZL113CU0/NDARZL113CU0_Video-WK_Samples_ET.mat, Diary, 120, 5384091276, 5501485122, 117393846
/Volumes/methlab_data/HBN/EEG-ET/NDARZL683VNX/NDARZL683VNX_Video-DM_Samples_ET.mat, Despicable, 120, 4133649721, 4304197158, 170547437
/Volumes/methlab_data/HBN/EEG-ET/NDARZL683VNX/NDARZL683VNX_Video-FF_Samples_ET.mat, Fractals, 120, 3306969749, 3469955118, 162985369
/Volumes/methlab_data/HBN/EEG-ET/NDARZL683VNX/NDARZL683VNX_Video-TP_Samples_ET.mat, Present, 120, 5297141914, 5500208355, 203066441
/Volumes/methlab_data/HBN/EEG-ET/NDARZL683VNX/NDARZL683VNX_Video-WK_Samples_ET.mat, Diary, 120, 4729335498, 4846733533, 117398035
/Volumes/methlab_data/HBN/EEG-ET/NDARZL724HAX/NDARZL724HAX_Video1_Samples_ET.mat, Diary, 60, 3172315179, 3289711085, 117395906
/Volumes/methlab_data/HBN/EEG-ET/NDARZL724HAX/NDARZL724HAX_Video3_Samples_ET.mat, Despicable, 60, 2752302673, 2922844097, 170541424
/Volumes/methlab_data/HBN/EEG-ET/NDARZL799MFW/NDARZL799MFW_Video-DM_Samples_ET.mat, Despicable, 120, 5223684171, 5394231224, 170547053
/Volumes/methlab_data/HBN/EEG-ET/NDARZL799MFW/NDARZL799MFW_Video-FF_Samples_ET.mat, Fractals, 120, 4714315976, 4877303290, 162987314
/Volumes/methlab_data/HBN/EEG-ET/NDARZL799MFW/NDARZL799MFW_Video-TP_Samples_ET.mat, Present, 120, 5965729188, 6168795744, 203066556
/Volumes/methlab_data/HBN/EEG-ET/NDARZL799MFW/NDARZL799MFW_Video-WK_Samples_ET.mat, Diary, 120, 3602573928, 3719970293, 117396365
/Volumes/methlab_data/HBN/EEG-ET/NDARZL855WVA/NDARZL855WVA_Video1_Samples_ET.mat, Diary, 60, 4889180484, 5006569504, 117389020
/Volumes/methlab_data/HBN/EEG-ET/NDARZL855WVA/NDARZL855WVA_Video3_Samples_ET.mat, Despicable, 60, 4435348639, 4605895230, 170546591
/Volumes/methlab_data/HBN/EEG-ET/NDARZM314GAX/NDARZM314GAX_Video-DM_Samples_ET.mat, Despicable, 60, 6393563168, 6564101966, 170538798
/Volumes/methlab_data/HBN/EEG-ET/NDARZM314GAX/NDARZM314GAX_Video-FF_Samples_ET.mat, Fractals, 60, 5954828389, 6117817857, 162989468
/Volumes/methlab_data/HBN/EEG-ET/NDARZM314GAX/NDARZM314GAX_Video-TP_Samples_ET.mat, Present, 60, 6905536796, 7108597667, 203060871
/Volumes/methlab_data/HBN/EEG-ET/NDARZM314GAX/NDARZM314GAX_Video-WK_Samples_ET.mat, Diary, 60, 5229235403, 5346622590, 117387187
/Volumes/methlab_data/HBN/EEG-ET/NDARZM580BG2/NDARZM580BG2_Video-DM_Samples_ET.mat, Despicable, 60, 5097064303, 5267610004, 170545701
/Volumes/methlab_data/HBN/EEG-ET/NDARZM580BG2/NDARZM580BG2_Video-FF_Samples_ET.mat, Fractals, 60, 4408927369, 4571913717, 162986348
/Volumes/methlab_data/HBN/EEG-ET/NDARZM580BG2/NDARZM580BG2_Video-TP_Samples_ET.mat, Present, 60, 5967635343, 6170693210, 203057867
/Volumes/methlab_data/HBN/EEG-ET/NDARZM580BG2/NDARZM580BG2_Video-WK_Samples_ET.mat, Diary, 60, 5544040611, 5661441707, 117401096
/Volumes/methlab_data/HBN/EEG-ET/NDARZM865KE8/NDARZM865KE8_Video-DM_Samples_ET.mat, Despicable, 60, 3903059277, 4073602123, 170542846
/Volumes/methlab_data/HBN/EEG-ET/NDARZM865KE8/NDARZM865KE8_Video-FF_Samples_ET.mat, Fractals, 60, 3408861232, 3571849688, 162988456
/Volumes/methlab_data/HBN/EEG-ET/NDARZM865KE8/NDARZM865KE8_Video-TP_Samples_ET.mat, Present, 60, 4392189764, 4595257624, 203067860
/Volumes/methlab_data/HBN/EEG-ET/NDARZM865KE8/NDARZM865KE8_Video-WK_Samples_ET.mat, Diary, 60, 2896356208, 3013744363, 117388155
/Volumes/methlab_data/HBN/EEG-ET/NDARZM903TNL/NDARZM903TNL_Video1_Samples_ET.mat, Diary, 120, 2291198540, 2408594057, 117395517
/Volumes/methlab_data/HBN/EEG-ET/NDARZM903TNL/NDARZM903TNL_Video2_Samples_ET.mat, Fractals, 120, 3110012034, 3273009304, 162997270
/Volumes/methlab_data/HBN/EEG-ET/NDARZM903TNL/NDARZM903TNL_Video3_Samples_ET.mat, Despicable, 120, 3585313271, 3755856896, 170543625
/Volumes/methlab_data/HBN/EEG-ET/NDARZM903TNL/NDARZM903TNL_Video4_Samples_ET.mat, Present, 120, 4254666484, 4457732791, 203066307
/Volumes/methlab_data/HBN/EEG-ET/NDARZN148PMN/NDARZN148PMN_Video-DM_Samples_ET.mat, Despicable, 120, 5368723196, 5539270070, 170546874
/Volumes/methlab_data/HBN/EEG-ET/NDARZN148PMN/NDARZN148PMN_Video-FF_Samples_ET.mat, Fractals, 120, 4991305057, 5154292480, 162987423
/Volumes/methlab_data/HBN/EEG-ET/NDARZN148PMN/NDARZN148PMN_Video-TP_Samples_ET.mat, Present, 120, 6094868952, 6297935474, 203066522
/Volumes/methlab_data/HBN/EEG-ET/NDARZN148PMN/NDARZN148PMN_Video-WK_Samples_ET.mat, Diary, 120, 3892684409, 4010079870, 117395461
/Volumes/methlab_data/HBN/EEG-ET/NDARZN217XJW/NDARZN217XJW_Video-DM_Samples_ET.mat, Despicable, 60, 3857530879, 4028070279, 170539400
/Volumes/methlab_data/HBN/EEG-ET/NDARZN217XJW/NDARZN217XJW_Video-TP_Samples_ET.mat, Present, 60, 4780025094, 4983300624, 203275530
/Volumes/methlab_data/HBN/EEG-ET/NDARZN217XJW/NDARZN217XJW_Video-WK_Samples_ET.mat, Diary, 60, 4339907391, 4457296288, 117388897
/Volumes/methlab_data/HBN/EEG-ET/NDARZN277NR6/NDARZN277NR6_Video1_Samples_ET.mat, Diary, 60, 3659885236, 3777276497, 117391261
/Volumes/methlab_data/HBN/EEG-ET/NDARZN277NR6/NDARZN277NR6_Video3_Samples_ET.mat, Despicable, 60, 4071171849, 4241720847, 170548998
/Volumes/methlab_data/HBN/EEG-ET/NDARZN578YDP/NDARZN578YDP_Video-DM_Samples_ET.mat, Despicable, 120, 5654378275, 5824924225, 170545950
/Volumes/methlab_data/HBN/EEG-ET/NDARZN578YDP/NDARZN578YDP_Video-FF_Samples_ET.mat, Fractals, 120, 5068940614, 5231927693, 162987079
/Volumes/methlab_data/HBN/EEG-ET/NDARZN578YDP/NDARZN578YDP_Video-TP_Samples_ET.mat, Present, 120, 6355954195, 6559019410, 203065215
/Volumes/methlab_data/HBN/EEG-ET/NDARZN578YDP/NDARZN578YDP_Video-WK_Samples_ET.mat, Diary, 120, 4105067848, 4222464384, 117396536
/Volumes/methlab_data/HBN/EEG-ET/NDARZN610GTY/NDARZN610GTY_Video-DM_Samples_ET.mat, Despicable, 60, 3727981060, 3898524662, 170543602
/Volumes/methlab_data/HBN/EEG-ET/NDARZN610GTY/NDARZN610GTY_Video-FF_Samples_ET.mat, Fractals, 60, 3954043884, 4168625676, 214581792
/Volumes/methlab_data/HBN/EEG-ET/NDARZN610GTY/NDARZN610GTY_Video-TP_Samples_ET.mat, Present, 60, 4419655070, 4622718723, 203063653
/Volumes/methlab_data/HBN/EEG-ET/NDARZN610GTY/NDARZN610GTY_Video-WK_Samples_ET.mat, Diary, 60, 4223073103, 4340467117, 117394014
/Volumes/methlab_data/HBN/EEG-ET/NDARZN677EYE/NDARZN677EYE_Video1_Samples_ET.mat, Fractals, 120, 3010218799, 3173204200, 162985401
/Volumes/methlab_data/HBN/EEG-ET/NDARZN677EYE/NDARZN677EYE_Video2_Samples_ET.mat, Despicable, 120, 4371216855, 4541757950, 170541095
/Volumes/methlab_data/HBN/EEG-ET/NDARZN677EYE/NDARZN677EYE_Video3_Samples_ET.mat, Diary, 120, 4848816264, 4966213549, 117397285
/Volumes/methlab_data/HBN/EEG-ET/NDARZN677EYE/NDARZN677EYE_Video4_Samples_ET.mat, Present, 120, 5404773493, 5607841053, 203067560
/Volumes/methlab_data/HBN/EEG-ET/NDARZN914GPB/NDARZN914GPB_Video-DM_Samples_ET.mat, Despicable, 120, 2817942196, 2988488567, 170546371
/Volumes/methlab_data/HBN/EEG-ET/NDARZN914GPB/NDARZN914GPB_Video-FF_Samples_ET.mat, Fractals, 120, 2182565379, 2345555782, 162990403
/Volumes/methlab_data/HBN/EEG-ET/NDARZN914GPB/NDARZN914GPB_Video-TP_Samples_ET.mat, Present, 120, 4109514103, 4312581399, 203067296
/Volumes/methlab_data/HBN/EEG-ET/NDARZN914GPB/NDARZN914GPB_Video-WK_Samples_ET.mat, Diary, 120, 3514317537, 3631715238, 117397701
/Volumes/methlab_data/HBN/EEG-ET/NDARZP065VGY/NDARZP065VGY_Video-DM_Samples_ET.mat, Despicable, 60, 4586228872, 4756773477, 170544605
/Volumes/methlab_data/HBN/EEG-ET/NDARZP065VGY/NDARZP065VGY_Video-FF_Samples_ET.mat, Fractals, 60, 4144795808, 4307778077, 162982269
/Volumes/methlab_data/HBN/EEG-ET/NDARZP065VGY/NDARZP065VGY_Video-TP_Samples_ET.mat, Present, 60, 5149708258, 5352780859, 203072601
/Volumes/methlab_data/HBN/EEG-ET/NDARZP065VGY/NDARZP065VGY_Video-WK_Samples_ET.mat, Diary, 60, 3587284628, 3704677644, 117393016
/Volumes/methlab_data/HBN/EEG-ET/NDARZP564MHU/NDARZP564MHU_Video1_Samples_ET.mat, Diary, 60, 2881808315, 2999201206, 117392891
/Volumes/methlab_data/HBN/EEG-ET/NDARZP564MHU/NDARZP564MHU_Video3_Samples_ET.mat, Despicable, 60, 3291632619, 3462174090, 170541471
/Volumes/methlab_data/HBN/EEG-ET/NDARZP599GRG/NDARZP599GRG_Video-DM_Samples_ET.mat, Despicable, 60, 3816181868, 3986733507, 170551639
/Volumes/methlab_data/HBN/EEG-ET/NDARZP599GRG/NDARZP599GRG_Video-FF_Samples_ET.mat, Fractals, 60, 3383929158, 3546921442, 162992284
/Volumes/methlab_data/HBN/EEG-ET/NDARZP599GRG/NDARZP599GRG_Video-TP_Samples_ET.mat, Present, 60, 4300698532, 4503767183, 203068651
/Volumes/methlab_data/HBN/EEG-ET/NDARZP599GRG/NDARZP599GRG_Video-WK_Samples_ET.mat, Diary, 60, 2743587246, 2860976303, 117389057
/Volumes/methlab_data/HBN/EEG-ET/NDARZP630WYL/NDARZP630WYL_Video1_Samples_ET.mat, Diary, 60, 1187159973, 1304548810, 117388837
/Volumes/methlab_data/HBN/EEG-ET/NDARZP630WYL/NDARZP630WYL_Video3_Samples_ET.mat, Despicable, 60, 977475011, 1148016380, 170541369
/Volumes/methlab_data/HBN/EEG-ET/NDARZR180BM6/NDARZR180BM6_Video-DM_Samples_ET.mat, Despicable, 30, 3958667770, 4129205356, 170537586
/Volumes/methlab_data/HBN/EEG-ET/NDARZR180BM6/NDARZR180BM6_Video-TP_Samples_ET.mat, Present, 30, 4458274997, 4661542729, 203267732
/Volumes/methlab_data/HBN/EEG-ET/NDARZR180BM6/NDARZR180BM6_Video-WK_Samples_ET.mat, Diary, 30, 3541562876, 3658951903, 117389027
/Volumes/methlab_data/HBN/EEG-ET/NDARZR412TBP/NDARZR412TBP_Video1_Samples_ET.mat, Diary, 60, 4263847009, 4381241902, 117394893
/Volumes/methlab_data/HBN/EEG-ET/NDARZR412TBP/NDARZR412TBP_Video3_Samples_ET.mat, Despicable, 60, 3836636425, 4007183825, 170547400
/Volumes/methlab_data/HBN/EEG-ET/NDARZR529EJ1/NDARZR529EJ1_Video-DM_Samples_ET.mat, Despicable, 60, 3665573449, 3836117993, 170544544
/Volumes/methlab_data/HBN/EEG-ET/NDARZR529EJ1/NDARZR529EJ1_Video-FF_Samples_ET.mat, Fractals, 60, 3218990881, 3381980089, 162989208
/Volumes/methlab_data/HBN/EEG-ET/NDARZR529EJ1/NDARZR529EJ1_Video-TP_Samples_ET.mat, Present, 60, 4152763723, 4355837252, 203073529
/Volumes/methlab_data/HBN/EEG-ET/NDARZR529EJ1/NDARZR529EJ1_Video-WK_Samples_ET.mat, Diary, 60, 2496734564, 2614128484, 117393920
/Volumes/methlab_data/HBN/EEG-ET/NDARZR968TLL/NDARZR968TLL_Video-DM_Samples_ET.mat, Despicable, 30, 2635558352, 2806105648, 170547296
/Volumes/methlab_data/HBN/EEG-ET/NDARZR968TLL/NDARZR968TLL_Video-WK_Samples_ET.mat, Diary, 30, 3063053828, 3180441662, 117387834
/Volumes/methlab_data/HBN/EEG-ET/NDARZT096AUP/NDARZT096AUP_Video1_Samples_ET.mat, Diary, 120, 6053762826, 6171158491, 117395665
/Volumes/methlab_data/HBN/EEG-ET/NDARZT096AUP/NDARZT096AUP_Video2_Samples_ET.mat, Fractals, 120, 6973962991, 7136954488, 162991497
/Volumes/methlab_data/HBN/EEG-ET/NDARZT096AUP/NDARZT096AUP_Video3_Samples_ET.mat, Despicable, 120, 7520223524, 7690770882, 170547358
/Volumes/methlab_data/HBN/EEG-ET/NDARZT096AUP/NDARZT096AUP_Video4_Samples_ET.mat, Present, 120, 8201198396, 8404266282, 203067886
/Volumes/methlab_data/HBN/EEG-ET/NDARZT199MF6/NDARZT199MF6_Video1_Samples_ET.mat, Diary, 60, 2558165190, 2675561234, 117396044
/Volumes/methlab_data/HBN/EEG-ET/NDARZT199MF6/NDARZT199MF6_Video2_Samples_ET.mat, Fractals, 60, 3304842109, 3467834351, 162992242
/Volumes/methlab_data/HBN/EEG-ET/NDARZT199MF6/NDARZT199MF6_Video3_Samples_ET.mat, Despicable, 60, 3745518667, 3916058247, 170539580
/Volumes/methlab_data/HBN/EEG-ET/NDARZT199MF6/NDARZT199MF6_Video4_Samples_ET.mat, Present, 60, 4246257672, 4449329276, 203071604
/Volumes/methlab_data/HBN/EEG-ET/NDARZT581RNV/NDARZT581RNV_Video-DM_Samples_ET.mat, Despicable, 30, 4187839497, 4358377078, 170537581
/Volumes/methlab_data/HBN/EEG-ET/NDARZT581RNV/NDARZT581RNV_Video-TP_Samples_ET.mat, Present, 30, 5105521289, 5308798024, 203276735
/Volumes/methlab_data/HBN/EEG-ET/NDARZT581RNV/NDARZT581RNV_Video-WK_Samples_ET.mat, Diary, 30, 4669434971, 4786820985, 117386014
/Volumes/methlab_data/HBN/EEG-ET/NDARZT772PU4/NDARZT772PU4_Video1_Samples_ET.mat, Diary, 60, 2353172627, 2470568736, 117396109
/Volumes/methlab_data/HBN/EEG-ET/NDARZT772PU4/NDARZT772PU4_Video3_Samples_ET.mat, Despicable, 60, 3851386798, 4021939529, 170552731
/Volumes/methlab_data/HBN/EEG-ET/NDARZT940RZG/NDARZT940RZG_Video1_Samples_ET.mat, Diary, 120, 3111210371, 3228607100, 117396729
/Volumes/methlab_data/HBN/EEG-ET/NDARZT940RZG/NDARZT940RZG_Video2_Samples_ET.mat, Fractals, 120, 3994323980, 4157311730, 162987750
/Volumes/methlab_data/HBN/EEG-ET/NDARZT940RZG/NDARZT940RZG_Video3_Samples_ET.mat, Despicable, 120, 4502911536, 4673458981, 170547445
/Volumes/methlab_data/HBN/EEG-ET/NDARZT940RZG/NDARZT940RZG_Video4_Samples_ET.mat, Present, 120, 5184578045, 5387645313, 203067268
/Volumes/methlab_data/HBN/EEG-ET/NDARZT957CWG/NDARZT957CWG_Video1_Samples_ET.mat, Fractals, 120, 3941748043, 4104744351, 162996308
/Volumes/methlab_data/HBN/EEG-ET/NDARZT957CWG/NDARZT957CWG_Video2_Samples_ET.mat, Diary, 120, 5136609169, 5254006396, 117397227
/Volumes/methlab_data/HBN/EEG-ET/NDARZT957CWG/NDARZT957CWG_Video3_Samples_ET.mat, Despicable, 120, 5548687477, 5719233858, 170546381
/Volumes/methlab_data/HBN/EEG-ET/NDARZT957CWG/NDARZT957CWG_Video4_Samples_ET.mat, Present, 120, 6194192737, 6397260056, 203067319
/Volumes/methlab_data/HBN/EEG-ET/NDARZU391KB0/NDARZU391KB0_Video-DM_Samples_ET.mat, Despicable, 30, 5700679957, 5871217330, 170537373
/Volumes/methlab_data/HBN/EEG-ET/NDARZU391KB0/NDARZU391KB0_Video-TP_Samples_ET.mat, Present, 30, 6232043886, 6435311315, 203267429
/Volumes/methlab_data/HBN/EEG-ET/NDARZU401RCU/NDARZU401RCU_Video-TP_Samples_ET.mat, Present, 60, 2289359078, 2492637832, 203278754
/Volumes/methlab_data/HBN/EEG-ET/NDARZU401RCU/NDARZU401RCU_Video-WK_Samples_ET.mat, Diary, 60, 2120131432, 2237519448, 117388016
/Volumes/methlab_data/HBN/EEG-ET/NDARZU822WN3/NDARZU822WN3_Video1_Samples_ET.mat, Diary, 60, 5493920359, 5611313708, 117393349
/Volumes/methlab_data/HBN/EEG-ET/NDARZU822WN3/NDARZU822WN3_Video3_Samples_ET.mat, Despicable, 60, 5909839534, 6080379614, 170540080
/Volumes/methlab_data/HBN/EEG-ET/NDARZV132DRG/NDARZV132DRG_Video-DM_Samples_ET.mat, Despicable, 60, 5121683465, 5292223395, 170539930
/Volumes/methlab_data/HBN/EEG-ET/NDARZV132DRG/NDARZV132DRG_Video-FF_Samples_ET.mat, Fractals, 60, 4680014292, 4843007883, 162993591
/Volumes/methlab_data/HBN/EEG-ET/NDARZV132DRG/NDARZV132DRG_Video-TP_Samples_ET.mat, Present, 60, 5742491645, 5945550664, 203059019
/Volumes/methlab_data/HBN/EEG-ET/NDARZV132DRG/NDARZV132DRG_Video-WK_Samples_ET.mat, Diary, 60, 4084241855, 4201637123, 117395268
/Volumes/methlab_data/HBN/EEG-ET/NDARZV421TCZ/NDARZV421TCZ_Video-DM_Samples_ET.mat, Despicable, 120, 4551078915, 4721626617, 170547702
/Volumes/methlab_data/HBN/EEG-ET/NDARZV421TCZ/NDARZV421TCZ_Video-FF_Samples_ET.mat, Fractals, 120, 3679885625, 3842881926, 162996301
/Volumes/methlab_data/HBN/EEG-ET/NDARZV421TCZ/NDARZV421TCZ_Video-TP_Samples_ET.mat, Present, 120, 5723822909, 5926890269, 203067360
/Volumes/methlab_data/HBN/EEG-ET/NDARZV421TCZ/NDARZV421TCZ_Video-WK_Samples_ET.mat, Diary, 120, 5114525430, 5231923837, 117398407
/Volumes/methlab_data/HBN/EEG-ET/NDARZV608BL8/NDARZV608BL8_Video1_Samples_ET.mat, Diary, 120, 3049446648, 3166833812, 117387164
/Volumes/methlab_data/HBN/EEG-ET/NDARZV608BL8/NDARZV608BL8_Video2_Samples_ET.mat, Despicable, 120, 4509824853, 4680372071, 170547218
/Volumes/methlab_data/HBN/EEG-ET/NDARZV608BL8/NDARZV608BL8_Video3_Samples_ET.mat, Fractals, 120, 5002466595, 5165450079, 162983484
/Volumes/methlab_data/HBN/EEG-ET/NDARZV608BL8/NDARZV608BL8_Video4_Samples_ET.mat, Present, 120, 5644757583, 5847824611, 203067028
/Volumes/methlab_data/HBN/EEG-ET/NDARZV749GAP/NDARZV749GAP_Video-DM_Samples_ET.mat, Despicable, 120, 3233003810, 3403550850, 170547040
/Volumes/methlab_data/HBN/EEG-ET/NDARZV749GAP/NDARZV749GAP_Video-FF_Samples_ET.mat, Fractals, 120, 2529698971, 2692695155, 162996184
/Volumes/methlab_data/HBN/EEG-ET/NDARZV749GAP/NDARZV749GAP_Video-TP_Samples_ET.mat, Present, 120, 4302587274, 4505653571, 203066297
/Volumes/methlab_data/HBN/EEG-ET/NDARZV749GAP/NDARZV749GAP_Video-WK_Samples_ET.mat, Diary, 120, 3684931540, 3802328730, 117397190
/Volumes/methlab_data/HBN/EEG-ET/NDARZV766YXP/NDARZV766YXP_Video2_Samples_ET.mat, Despicable, 120, 6289302249, 6459846956, 170544707
/Volumes/methlab_data/HBN/EEG-ET/NDARZV766YXP/NDARZV766YXP_Video3_Samples_ET.mat, Diary, 120, 6922518835, 7039916839, 117398004
/Volumes/methlab_data/HBN/EEG-ET/NDARZV895RZ5/NDARZV895RZ5_Video-DM_Samples_ET.mat, Despicable, 60, 4344209644, 4514753074, 170543430
/Volumes/methlab_data/HBN/EEG-ET/NDARZV895RZ5/NDARZV895RZ5_Video-FF_Samples_ET.mat, Fractals, 60, 3290586859, 3453566926, 162980067
/Volumes/methlab_data/HBN/EEG-ET/NDARZV895RZ5/NDARZV895RZ5_Video-TP_Samples_ET.mat, Present, 60, 4829274073, 5032333462, 203059389
/Volumes/methlab_data/HBN/EEG-ET/NDARZV895RZ5/NDARZV895RZ5_Video-WK_Samples_ET.mat, Diary, 60, 3848817933, 3966208837, 117390904
/Volumes/methlab_data/HBN/EEG-ET/NDARZV983XK9/NDARZV983XK9_Video-FF_Samples_ET.mat, Fractals, 120, 3128902450, 3291890685, 162988235
/Volumes/methlab_data/HBN/EEG-ET/NDARZW013RUH/NDARZW013RUH_Video1_Samples_ET.mat, Diary, 60, 2542953170, 2660348905, 117395735
/Volumes/methlab_data/HBN/EEG-ET/NDARZW013RUH/NDARZW013RUH_Video3_Samples_ET.mat, Despicable, 60, 4160374778, 4330918973, 170544195
/Volumes/methlab_data/HBN/EEG-ET/NDARZW262ZLV/NDARZW262ZLV_Video1_Samples_ET.mat, Diary, 60, 93778031586, 93895429693, 117398107
/Volumes/methlab_data/HBN/EEG-ET/NDARZW262ZLV/NDARZW262ZLV_Video2_Samples_ET.mat, Fractals, 60, 94196609769, 94359589160, 162979391
/Volumes/methlab_data/HBN/EEG-ET/NDARZW262ZLV/NDARZW262ZLV_Video3_Samples_ET.mat, Despicable, 60, 94406998669, 94577543362, 170544693
/Volumes/methlab_data/HBN/EEG-ET/NDARZW262ZLV/NDARZW262ZLV_Video4_Samples_ET.mat, Present, 60, 94675021327, 94878081051, 203059724
/Volumes/methlab_data/HBN/EEG-ET/NDARZW363UGM/NDARZW363UGM_Video-DM_Samples_ET.mat, Despicable, 120, 2948675134, 3119220721, 170545587
/Volumes/methlab_data/HBN/EEG-ET/NDARZW363UGM/NDARZW363UGM_Video-FF_Samples_ET.mat, Fractals, 120, 3166561725, 3329549325, 162987600
/Volumes/methlab_data/HBN/EEG-ET/NDARZW363UGM/NDARZW363UGM_Video-TP_Samples_ET.mat, Present, 120, 3640729732, 3843795746, 203066014
/Volumes/methlab_data/HBN/EEG-ET/NDARZW363UGM/NDARZW363UGM_Video-WK_Samples_ET.mat, Diary, 120, 3446133378, 3563521904, 117388526
/Volumes/methlab_data/HBN/EEG-ET/NDARZW472CCF/NDARZW472CCF_Video1_Samples_ET.mat, Diary, 60, 3115356691, 3232748757, 117392066
/Volumes/methlab_data/HBN/EEG-ET/NDARZW472CCF/NDARZW472CCF_Video2_Samples_ET.mat, Fractals, 60, 3697680750, 3860669102, 162988352
/Volumes/methlab_data/HBN/EEG-ET/NDARZW472CCF/NDARZW472CCF_Video3_Samples_ET.mat, Despicable, 60, 4120370848, 4290921566, 170550718
/Volumes/methlab_data/HBN/EEG-ET/NDARZW472CCF/NDARZW472CCF_Video4_Samples_ET.mat, Present, 60, 4627616811, 4830759570, 203142759
/Volumes/methlab_data/HBN/EEG-ET/NDARZW662UK6/NDARZW662UK6_Video-DM_Samples_ET.mat, Despicable, 60, 4548827136, 4719377704, 170550568
/Volumes/methlab_data/HBN/EEG-ET/NDARZW662UK6/NDARZW662UK6_Video-FF_Samples_ET.mat, Fractals, 60, 4058465637, 4221447830, 162982193
/Volumes/methlab_data/HBN/EEG-ET/NDARZW662UK6/NDARZW662UK6_Video-TP_Samples_ET.mat, Present, 60, 5067449742, 5270510144, 203060402
/Volumes/methlab_data/HBN/EEG-ET/NDARZW662UK6/NDARZW662UK6_Video-WK_Samples_ET.mat, Diary, 60, 3492270548, 3609667506, 117396958
/Volumes/methlab_data/HBN/EEG-ET/NDARZW854BH0/NDARZW854BH0_Video-DM_Samples_ET.mat, Despicable, 60, 4561237741, 4731776382, 170538641
/Volumes/methlab_data/HBN/EEG-ET/NDARZW854BH0/NDARZW854BH0_Video-FF_Samples_ET.mat, Fractals, 60, 4293052066, 4456042377, 162990311
/Volumes/methlab_data/HBN/EEG-ET/NDARZW854BH0/NDARZW854BH0_Video-TP_Samples_ET.mat, Present, 60, 4782307097, 4985374722, 203067625
/Volumes/methlab_data/HBN/EEG-ET/NDARZW854BH0/NDARZW854BH0_Video-WK_Samples_ET.mat, Diary, 60, 3968670637, 4086060685, 117390048
/Volumes/methlab_data/HBN/EEG-ET/NDARZW873DN3/NDARZW873DN3_Video1_Samples_ET.mat, Diary, 120, 4036089374, 4153485919, 117396545
/Volumes/methlab_data/HBN/EEG-ET/NDARZW873DN3/NDARZW873DN3_Video2_Samples_ET.mat, Fractals, 120, 4929442244, 5092440230, 162997986
/Volumes/methlab_data/HBN/EEG-ET/NDARZW873DN3/NDARZW873DN3_Video3_Samples_ET.mat, Despicable, 120, 5464640112, 5635186570, 170546458
/Volumes/methlab_data/HBN/EEG-ET/NDARZW873DN3/NDARZW873DN3_Video4_Samples_ET.mat, Present, 120, 6157173441, 6360239067, 203065626
/Volumes/methlab_data/HBN/EEG-ET/NDARZW930MF2/NDARZW930MF2_Video1_Samples_ET.mat, Diary, 120, 2623815189, 2741212402, 117397213
/Volumes/methlab_data/HBN/EEG-ET/NDARZW930MF2/NDARZW930MF2_Video2_Samples_ET.mat, Fractals, 120, 4137275402, 4300263410, 162988008
/Volumes/methlab_data/HBN/EEG-ET/NDARZW930MF2/NDARZW930MF2_Video3_Samples_ET.mat, Despicable, 120, 4817412018, 4987958943, 170546925
/Volumes/methlab_data/HBN/EEG-ET/NDARZW930MF2/NDARZW930MF2_Video4_Samples_ET.mat, Present, 120, 5523594533, 5726662087, 203067554
/Volumes/methlab_data/HBN/EEG-ET/NDARZW980YF9/NDARZW980YF9_Video-DM_Samples_ET.mat, Despicable, 30, 3865829192, 4036365406, 170536214
/Volumes/methlab_data/HBN/EEG-ET/NDARZW980YF9/NDARZW980YF9_Video-TP_Samples_ET.mat, Present, 30, 4453715603, 4656978918, 203263315
/Volumes/methlab_data/HBN/EEG-ET/NDARZW980YF9/NDARZW980YF9_Video-WK_Samples_ET.mat, Diary, 30, 2697403495, 2814793276, 117389781
/Volumes/methlab_data/HBN/EEG-ET/NDARZX163EWC/NDARZX163EWC_Video-DM_Samples_ET.mat, Despicable, 60, 14639056058, 14809604830, 170548772
/Volumes/methlab_data/HBN/EEG-ET/NDARZX163EWC/NDARZX163EWC_Video-FF_Samples_ET.mat, Fractals, 60, 14203800900, 14366791326, 162990426
/Volumes/methlab_data/HBN/EEG-ET/NDARZX163EWC/NDARZX163EWC_Video-TP_Samples_ET.mat, Present, 60, 15125169251, 15328229070, 203059819
/Volumes/methlab_data/HBN/EEG-ET/NDARZX163EWC/NDARZX163EWC_Video-WK_Samples_ET.mat, Diary, 60, 13517117741, 13634504880, 117387139
/Volumes/methlab_data/HBN/EEG-ET/NDARZX561DR9/NDARZX561DR9_Video1_Samples_ET.mat, Diary, 60, 4523000856, 4640393802, 117392946
/Volumes/methlab_data/HBN/EEG-ET/NDARZX561DR9/NDARZX561DR9_Video3_Samples_ET.mat, Despicable, 60, 3708756755, 3879299229, 170542474
/Volumes/methlab_data/HBN/EEG-ET/NDARZX827NWT/NDARZX827NWT_Video-DM_Samples_ET.mat, Despicable, 30, 3403516602, 3574053352, 170536750
/Volumes/methlab_data/HBN/EEG-ET/NDARZX827NWT/NDARZX827NWT_Video-TP_Samples_ET.mat, Present, 30, 5356727437, 5559994376, 203266939
/Volumes/methlab_data/HBN/EEG-ET/NDARZX827NWT/NDARZX827NWT_Video-WK_Samples_ET.mat, Diary, 30, 4312117866, 4429505996, 117388130
/Volumes/methlab_data/HBN/EEG-ET/NDARZY101JNB/NDARZY101JNB_Video1_Samples_ET.mat, Despicable, 120, 3020736646, 3191284641, 170547995
/Volumes/methlab_data/HBN/EEG-ET/NDARZY101JNB/NDARZY101JNB_Video2_Samples_ET.mat, Diary, 120, 3901220940, 4018618751, 117397811
/Volumes/methlab_data/HBN/EEG-ET/NDARZY101JNB/NDARZY101JNB_Video3_Samples_ET.mat, Fractals, 120, 4404779694, 4567765658, 162985964
/Volumes/methlab_data/HBN/EEG-ET/NDARZY101JNB/NDARZY101JNB_Video4_Samples_ET.mat, Present, 120, 5069195794, 5272262134, 203066340
/Volumes/methlab_data/HBN/EEG-ET/NDARZZ007YMP/NDARZZ007YMP_Video-DM_Samples_ET.mat, Despicable, 120, 9123450130, 9293997339, 170547209
/Volumes/methlab_data/HBN/EEG-ET/NDARZZ007YMP/NDARZZ007YMP_Video-FF_Samples_ET.mat, Fractals, 120, 8527143400, 8690131088, 162987688
/Volumes/methlab_data/HBN/EEG-ET/NDARZZ007YMP/NDARZZ007YMP_Video-TP_Samples_ET.mat, Present, 120, 9767897633, 9970961373, 203063740
/Volumes/methlab_data/HBN/EEG-ET/NDARZZ007YMP/NDARZZ007YMP_Video-WK_Samples_ET.mat, Diary, 120, 5171177086, 5288574835, 117397749
/Volumes/methlab_data/HBN/EEG-ET/NDARZZ404ZPN/NDARZZ404ZPN_Video-DM_Samples_ET.mat, Despicable, 30, 4231684393, 4402222700, 170538307
/Volumes/methlab_data/HBN/EEG-ET/NDARZZ404ZPN/NDARZZ404ZPN_Video-TP_Samples_ET.mat, Present, 30, 5246431317, 5449700972, 203269655
/Volumes/methlab_data/HBN/EEG-ET/NDARZZ404ZPN/NDARZZ404ZPN_Video-WK_Samples_ET.mat, Diary, 30, 4693983282, 4811371820, 117388538
/Volumes/methlab_data/HBN/EEG-ET/NDARZZ740MLM/NDARZZ740MLM_Video1_Samples_ET.mat, Diary, 60, 163261870628, 163379265611, 117394983
/Volumes/methlab_data/HBN/EEG-ET/NDARZZ740MLM/NDARZZ740MLM_Video2_Samples_ET.mat, Fractals, 60, 163749194989, 163912185191, 162990202
/Volumes/methlab_data/HBN/EEG-ET/NDARZZ740MLM/NDARZZ740MLM_Video3_Samples_ET.mat, Despicable, 60, 164215668620, 164386212169, 170543549
/Volumes/methlab_data/HBN/EEG-ET/NDARZZ740MLM/NDARZZ740MLM_Video4_Samples_ET.mat, Present, 60, 164873425425, 165076496951, 203071526
/Volumes/methlab_data/HBN/EEG-ET/NDARZZ741VJE/NDARZZ741VJE_Video-DM_Samples_ET.mat, Despicable, 30, 3616177431, 3786716846, 170539415
/Volumes/methlab_data/HBN/EEG-ET/NDARZZ810LVF/NDARZZ810LVF_Video-DM_Samples_ET.mat, Despicable, 60, 4580280107, 4750827344, 170547237
/Volumes/methlab_data/HBN/EEG-ET/NDARZZ810LVF/NDARZZ810LVF_Video-TP_Samples_ET.mat, Present, 60, 5447840688, 5651105006, 203264318
/Volumes/methlab_data/HBN/EEG-ET/NDARZZ810LVF/NDARZZ810LVF_Video-WK_Samples_ET.mat, Diary, 60, 5032324782, 5149712546, 117387764
/Volumes/methlab_data/HBN/EEG-ET/NDARZZ830JM7/NDARZZ830JM7_Video-DM_Samples_ET.mat, Despicable, 120, 4016392828, 4186940706, 170547878
/Volumes/methlab_data/HBN/EEG-ET/NDARZZ830JM7/NDARZZ830JM7_Video-FF_Samples_ET.mat, Fractals, 120, 3515820563, 3678817211, 162996648
/Volumes/methlab_data/HBN/EEG-ET/NDARZZ830JM7/NDARZZ830JM7_Video-TP_Samples_ET.mat, Present, 120, 4628693960, 4831761068, 203067108
/Volumes/methlab_data/HBN/EEG-ET/NDARZZ830JM7/NDARZZ830JM7_Video-WK_Samples_ET.mat, Diary, 120, 2873024513, 2990410888, 117386375
/Volumes/methlab_data/HBN/EEG-ET/NDARZZ993CEV/NDARZZ993CEV_Video-DM_Samples_ET.mat, Despicable, 30, 2863666226, 3034200405, 170534179
/Volumes/methlab_data/HBN/EEG-ET/NDARZZ993CEV/NDARZZ993CEV_Video-TP_Samples_ET.mat, Present, 30, 3352926958, 3556191193, 203264235
/Volumes/methlab_data/HBN/EEG-ET/NDARZZ993CEV/NDARZZ993CEV_Video-WK_Samples_ET.mat, Diary, 30, 1681348179, 1798745909, 117397730
